E : n, ¾ËÆÄºª ´Ù¼¸¹øÂ° ¹®ÀÚ
E, & O, E : x, errors and omissions excepted¿À±â¿Í ´©¶ôÀº º°µµ
E, and P, : x, extraordinary and plenipotentiary Æ¯¸í Àü±ÇÀÇ
E, B, : x, Encyclop(a)edia Britannica
E, C, : x, East Central(LondonÀÇ ¿ìÆí±¸ÀÇ ÇÏ³ª), Established Church
E, C, U, : x, English Church Union
E, coli : x, (¼¼±Õ)´ëÀå±Õ
E, D, : x, Doctor of Engineering, Efficiency Decoration, election district, extra duty
E, D, D, : x, English Dialect Dictionary
E, D, T, : x, Eastern daylight time(¹Ì)µ¿ºÎ ¼­¸Ó Å¸ÀÓ
E, E, : x, errors exceptedÆ²¸° °ÍÀº º°µµ·Î Ä¡°í, Early English, electrical engineer
E, E, & M, P, : x, Envoy Extraordinary and Minister Plenipotentiary Æ¯¸í Àü±Ç °ø»ç
E, E, T, S, : x, Early English Text Society ÃÊ±â ¿µ¾î ÅØ½ºÆ® ÇùÈ¸
e, g, : x, (L exempligratia)=for example ¿¹¸¦ µé¸é
E, H, F, : x, extremely high frequency (Åë½Å)¸¶ÀÌÅ©·ÎÆÄ
E, I, : x, East Indies
E, I, S, : x, Educational INstitute of Scotland
E, L, D, O, : x, European Launcher Development OrganizationÀ¯·´ ¿ìÁÖ ·ÎÄÏ °³¹ß Áö±¸
E, long, : x, east longitude
E, M, U, : x, electromagnetic units
e, o, : x, ex officioÁ÷±Ç»ó
e, o, m, : x, (ÁÖ·Î »ó)end of (the) month
E, P, : x, electroplate
E, P, B, : x, Economic Planning Board °æÁ¦ ±âÈ¹¿ø, (¿µ)Environmental Proection Board
E, P, D, : x, Excess Profits Duty ÃÊ°ú ÀÌµæ¼¼, Export Promotion Depathment
E, P, N, S, : x, electroplated nickel silver Àü±â µµ±İ ¾çÀº
E, P, T, : x, excess profits tax
E, P, U, : x, European Payment Union À¯·´ °áÁ¦ µ¿¸Í
E, Q, : x, deicational quotient(½É)±³À° Áö¼ö
E, R, : x, East Riding, Eduardus Rex, emergency room
E, R, A, : equal rights amendment ¹Ì±¹ Çå¹ı ³²Á® µ¿±Ç ¼öÁ¤ Á¶Çâ, earned run avearge(Åõ¼öÀÇ)¹æ¾îÀ², Emergency relief
E, R, V, : x, English Revised Version
E, S, : x, enginesized
e, s, u, : x, electrostatic unit(s)Á¤Àü ´ÜÀ§
E, T, U, : x, Electrical Trades Union
E, U, : x, Evangelical Union
E, W, O, : x, Essential Work Order
E/D card : x, ÃâÀÔ±¹ Ä«µå
ea : x, each
EA : x, educational age(±³À°)±³À° ¿¬·É, enemy aircraft
EAC : x, East Africam Community µ¿¾ÆÇÁ¸®Ä« °øµ¿Ã¼
EACE : x, European Atomic Energy Community, East African Economic Community µ¿¾ÆÇÁ¸®Ä« °æÁ¦ °øµ¿Ã¼
each : a, ad, °¢°¢ÀÇ, Á¦°¢±âÀÇ(each other ¼­·Î, °¢°¢¿¡ ´ëÇØ¼­)
eager : a, ¿­½ÉÀÎ, ¿­¸ÁÇÏ¿©(for, about, ofter, to do)
eager beaver : x, ÀÏ¹ú·¹, ³ë·Â°¡
eagerly : ad, ¿­¸ÁÇÏ¿©, ¿­½ÉÈ÷, °£ÀıÈ÷
eagerness : n, ¿­½É, ¿­ÀÇ, ¿­¸Á
eagle : n, ¼ö¸®, ¼ö¸®Ç¥, µ¶¼ö¸®ÀÚ¸®
eagle day : x, (¹Ì±º¼Ó)ºÀ±Ş³¯
Eagle defense : x, ÀÌ±Û µğÆæ½º(¼öºñ ´ëÇüÀÇ ÇÏ³ª)
eagle eye : x, ³¯Ä«·Î¿î ´«, ´«ÀÌ ³¯Ä«·Î¿î »ç¶÷, Å½Á¤
eagleeyed : a, ´«ÀÌ ³¯Ä«·Î¿î
eagle freak : x, (¹Ì¼Ó)(Á¾Á¾ °æ¸êÀû)ÀÚ¿¬(È¯°æ) º¸È£ÁÖÀÇÀÚ, ¾ß»ıµ¿¹° º¸È£ÁÖÀÇÀÚ, (Æ¯È÷ Ãµ¿¬ÀÚ¿ø µîÀÇ)º¸È£·ĞÀÚ
eaglehawk : n, (Á¶)¼ö¸®¸Å(³²¹Ì»ê)
eagle owl : x, (Á¶)¼ö¸®ºÎ¾ûÀÌ(À¯·´»ê)
eagle ray : n, ¸Å °¡¿À¸®
eagle scout : x, (¹Ì)21°³ ÀÌ»óÀÇ °øÈÆ ¹èÁö¸¦ ¹ŞÀº º¸ÀÌ½ºÄ«¿ìÆ® ´Ü¿ø
eaglet : n, »õ³¢¼ö¸®
eagre : n, ÇØ¼Ò(Æ¯È÷ ¿µ±¹ Humber, Trent, Severn°­ ÇÏ±¸ÀÇ)
EAL : x, Eastern Air Lines(¹Ì)µ¿ºÎ Ç×°ø»ç
Eames chair : x, (¹Ì±¹ÀÇ µğÀÚÀÌ³Ê Charles EamesÀÇ ÀÌ¸§¿¡¼­)(ÇÕÆÇ, ÇÃ¶ó½ºÆ½Á¦ÀÇ)¸ö¿¡ ¸Â°Ô µğÀÚÀÎµÈ ÀÇÀÚ
ear : n, ±Í, ±Ó¹ÙÄû, ±Í²ÃÀÇ ¹°°Ç(¼ÕÀâÀÌ µî), Ã»°¢, °æÃ»(about one's ears ÁÖÀ§¿¡, be all ears ¿­½ÉÈ÷ µè´Ù)
ear : n, º¸¸® µûÀ§ÀÇ ÀÌ»è, ¿Á¼ö¼ö ¿­¸Å(in the ear ÀÌ»èÀÌ ÆĞ¾î¼­)
earache : n, ±Í¾ÎÀÌ
earbash : vt, vi, (¿À½º¼Ó)...¿¡°Ô °è¼Ó Áö²¬¿© ´ë´Ù, °è¼ÓÇØ¼­ Áö²¬ÀÌ´Ù
earbender : n, (¹Ì±¸)½¯»õ¾øÀÌ Áö²¬ÀÌ´Â »ç¶÷, ¼ö´ÙÀïÀÌ
earcap : n, (¿µ)(¹æÇÑ¿ë)±Íµ¤°³
earcatcher : n, ¼Ò¸®·Î ³²ÀÇ ÁÖÀÇ¸¦ ²ô´Â °Í, ¿Ü±â ½¬¿î °î(°¡»ç)
eardeafening : a, ±ÍÃ»ÀÌ ¶³¾îÁú°Í °°Àº
eardrop : n, ±Í°í¸®
eardrum : n, °í¸·, ±ÍÃ»
eared : a, (Á¾Á¾ º¹ÇÕ¾î¸¦ ÀÌ·ç¾î)±Í(¸ğ¾çÀÇ °ÍÀÌ)ÀÖ´Â, ±Í°¡ ´Ş¸°, ...ÀÇ ±Í°¡ ÀÖ´Â
eared : a, (Á¾Á¾ º¹ÇÕ¾î¸¦ ÀÌ·ç¾î)ÀÌ»èÀÌ ÆÒ, ...ÀÇ ÀÌ»èÀÌ ÀÖ´Â
earflap : n, ±Íµ¤°³
earful : n, (±¸)ÇãÇ³, ±ôÂ¦ ³î¶ö ¸¸ÇÑ ¼Ò½Ä, ÀÜ¼Ò¸®
earhole : n, ±Ó±¸¸Û, ÀÌµµ
earing : n, (ÇØ)µÀÀÇ À­±Í¸¦ È°´ë¿¡ Àâ¾Æ¸Å´Â °¡´Â ¹åÁÙ
earl : n, ¹éÀÛ(¿µ±¹ÀÌ¿ÜÀÇ ¿Ü±¹ÀÇ count¿¡ ÇØ´ç)
Earl : n, ³²ÀÚ ÀÌ¸§
earlap : n, ±ÓºÒ
earldom : n, ¹éÀÛÀÇ ½ÅºĞ
earless : a, ±Í¾ø´Â, ÀÌ»è¾ø´Â
earliness : n, ÀÌ¸§, ºü¸§, Á¶±â
Earl Marshal : x, (¿µ±¹ÀÇ)¹®Àå¿ø ÃÑÀç(ÇöÀç´Â Norfolk °øÀÛ Áı¾ÈÀÇ ¼¼½ÀÁ÷)
earlobe : n, ±ÓºÒ
early : ÀÌ¸¥, ÃÊ±âÀÇ, ÀÏµÇ´Â, ¸º¹°ÀÇ, ¾î¸±¶§ÀÇ, °¡±î¿î Àå·¡ÀÇ(at an early date ±İ¸í¤©°£¿¡, ¸ÓÁö ¾Ê¾Æ, keep early hours ÀÏÂïÀÚ°í ÀÏÂï ÀÏ¾î³ª´Ù, ÀÏÂï, ÀÌ¸¥ ¶§¿¡, ÃÊ±â¿¡
early bird : x, ÀÏÂï ÀÏ¾î³ª´Â »ç¶÷, Á¤ÇÑ ½Ã°¢º¸´Ù ÀÏÂï ¿À´Â »ç¶÷
Early Bird : x, ¹Ì±¹ÀÇ »ó¾÷ Åë½Å À§¼º(ºÏ¹Ì¿Í À¯·´°£ÀÇ)
earlybird : a, (±¸)ÀÌ¸¥ ¾ÆÄ§ÀÇ, ÀÏÂï ¿À´Â »ç¶÷À» À§ÇÑ
early closing : x, °³Á¡ ½Ã°£ ´ÜÃà(ÀÏ)
early door : x, Æ¯º° ÃâÀÔ±¸(Æ¯º° ¿ä±İÀ¸·Î Á¤°¢º¸´Ù »¡¸® ÀÔÀå½ÃÅ°´Â ¹®)
Early English : x, ÃÊ±â ¿µ¾î
Early English style : x, ÃÊ±â ¿µ±¹ÀÇ °ÇÃà ¾ç½Ä
early leaver : x, (¿µ)(ÇĞ±³ÀÇ)Áßµµ ÅğÇĞÀÚ, ³«¿ÀÀÚ
Early Modern English : x, ÃÊ±â ±Ù´ë ¿µ¾î
earlytobedder : n, ÀÏÂï ÀÚ´Â »ç¶÷
earlyVictorian : a, n, ºòÅä¸®¾Æ ¿ÕÁ¶ ÃÊ±âÀÇ(»ç¶÷(ÀÛ°¡)), ±¸½ÄÀÇ(»ç¶÷)
early warning : x, (¹æ°ø µîÀÇ)Á¶±â °æº¸
earlywarning radar : x, ÇÙ°ø°İ¿¡ ´ëÇÑ Á¶±â °æº¸ ·¹ÀÌ´õ
earlywarning system : x, (±º)(ÇÙ°ø°İ¿¡ ´ëÇÑ)Á¶±â °æº¸ Á¶Á÷
earmark : n, vt, ¼ÒÀ¯ÀÚ¸¦ Ç¥½ÃÇÏ´Â ¾çÀÇ ±ÍÇ¥¸¦ ÇÏ´Ù, ÆäÀÌÁö ¸ğ¼­¸®ÀÇ Á¢Èû, ÀÚ±İÀÇ ¿ëµµ¸¦ ÁöÁ¤ÇÏ´Ù
earminded : a, (½É)Ã»°¢ÇüÀÇ
earmuffs : n, ±Í½Î°³
earn : vt, ¹ú´Ù, ÀÏÇÏ¿© ¾ò´Ù, ¼Õ¿¡³Ö´Ù, Â÷ÁöÇÏ´Ù, ¹Ş´Ù, ¾ò´Ù, °¨»ç µûÀ§¸¦ ¹ŞÀ» ¸¸ÇÏ´Ù
earned income : x, ±Ù·Î ¼Òµæ
earned run : x, (¾ß±¸)(Åõ¼öÀÇ)ÀÚÃ¥Á¡, ¾ğµå·±
earned run average : x, (¾ß±¸)(Åõ¼öÀÇ)¹æ¾îÀ²
earnest : a, n, ¼º½ÇÇÑ, ÁøÁöÇÑ, ¿­½ÉÀÎ, Áß´ëÇÑ, ¾ö¼÷ÇÑ, ¼º½Ç, Áø½É, ÁøÁö, Á¤½Ä(in earnest ¼º½ÇÇÏ°Ô, Áø½ÉÀ¸·Î)
earnest : n, º¸Áõ(pledge)=money Âø¼ö±İ
earnestly : ad, ÁøÁöÇÏ°Ô, ÁøÁ¤À¸·Î
earnest money : x, °è¾à±İ, ¾àÁ¶±İ
earning power : x, (°æ)¼öÀÍ(´É)·Â
earnings : n, ¹úÀÌ, ¼Òµæ, ¼öÀÔ
earnings per share : x, (Áõ±Ç)ÁÖ´ç ¼øÀÍ(¼øÀÌÀÍÀ» ¹ßÇàµÈ Æò±Õ ÁÖ¼Ò·Î ³ª´«°Í)
earningsrelated : a, ¼Òµæ¿¡ µû¸¥, ¼Òµæ¾× ºñ·Ê Áö±Ş ¿¬±İ
Earnings Related Supplement : x, (¿µ)º¸Çè ±ŞºÎ±İ(¿µ±¹ÀÇ »çÈ¸º¸ÀåÁ¦µµ¿¡¼­ 6°³¿ù°£ ½Ç¾÷ÀÚ(È¯ÀÚ)¿¡°Ô Àü³âµµ ¼Òµæ¿¡ µû¶ó Áö±ŞµÊ)
earnings yield : x, (Áõ±Ç)ÀÌÀ²(ÁÖ´ç ¼øÀÍÀ» ÁÖ°¡·Î ³ª´² ¾ò¾îÁö´Â ÀÌÀÍ·ü)
EAROM : n, (Àü»ê)±â¾ïµÇ¾î ÀÖ´Â µ¥ÀÌÅÍ¸¦ Àü±âÀûÀ¸·Î ¹Ù²ã ½á ³ÖÀ» ¼ö ÀÖ´Â ·Ò(ROM)
earphone : n, ÀÌ¾îÆù
earpick : n, ±ÍÀÌ°³
earpiece : n, =EARPLLONE
earpiercing : a, ±ÍÃ»ÀÌ Âõ¾îÁú °Í °°Àº(ºñ¸í)
earplug : n, ±Í¸¶°³
EARREACH : n, =earshot
earring : n, ÀÌ¾î¸µ, ±Í°í¸®
ear shell : n, Àüº¹
earshot : n, µé¸®´Â °Å¸®
ear specialist : x, ÀÌ°ú Àü¹®ÀÇ
earsplitting : a, ±ÍÃ»ÀÌ ÅÍÁúµíÇÑ
earth : Áö±¸, ÀÌ¼¼»ó, »çÆÄ¼¼°è, À°Áö, Áö¸é(come back   to earth ²Ş¿¡¼­Çö½Ã·Î µ¹¾Æ¿À´Ù, Á¦Á¤½ÅÀÌ µé´Ù), Èë	¼Ó¿¡ ÆÄ¹¯´Ù, »Ñ¸®  µûÀ§¿¡ ÈëÀ» µ¤´Ù..., À» Á¢ÁöÇÏ´Ù
earth art : x, (¹Ì)¾î½º ¾ÆÆ® (ÁöÇü, °æ°ü µîÀ» ¼ÒÀç·Î ÇÑ °ø°£ ¿¹¼ú)
earth bag : x, ¸ğ·¡ ÁÖ¸Ó´Ï
earthborn : a, ¶¥À§¿¡ ÅÂ¾î³­, ÀÎ°£ÀûÀÎ, ¼¼¼ÓÀÇ
earthbound : a, ¶¥¿¡ °íÂøÇÑ, ¼¼¼ÓÀûÀÎ, Áö±¸·ÎÇâÇÏ´Â
earthbred : a, Áö»ó¿¡¼­ ÀÚ¶õ, ÃµÇÑ
earth closet : x, (¿µ)Åä»ç »ìÆ÷½Ä º¯¼Ò, ³ëÃµ º¯¼Ò(ÀüÀïÅÍ¿¡¼­ »ç¿ë)
earth current : x, ÁöÀü·ù
Earth Day : x, Áö±¸ÀÇ ³¯(È¯°æ º¸È£ÀÇ³¯, 4¿ù 22ÀÏ)
earthday : n, Áö±¸ÀÏ(´Ù¸¥ ÃµÃ¼»óÀÇ ½Ã°£À» È¯»êÇÏ´Â µ¥¿¡ ¾²ÀÌ´Â Áö±¸»óÀÇ 24½Ã°£ÀÇ ÇÏ·ç)
earthen : a, ÈëÀÇ, ÈëÀ¸·Î ¸¸µç, ¿ÀÁö·Î ¸¸µç
earthenware : n, Áú±×¸©, ¿ÀÁö±×¸©
earth god : x, ½Ä¹°°ú ºñ¿ÁÀÇ ½Å
earth goddess : x, ½Ä¹°°ú ºñ¿ÁÀÇ ¿©½Å
earth house : x, ÈëÁı, ¶¥ ¼ÓÀÇ Áı
earthian : n, a, Áö±¸ÀÎ, Áö±¸ÀÇ
earthiness : n, ÅäÁú, Åä¼º, ¼ÓÃë, ¼Ó¾Ç
earthlight : n, (Ãµ)=EARTHSHINE
earthliness : n, Áö±¸»óÀÇ °ÍÀ¸·Î¼­ÀÇ ¼ºÁú, Çö¼¼(¼¼¼Ó)ÀûÀÓ, ¼ÓµÊ
earthling : n, ¾È°£, ¼ÓÀÎ
earthlubber : n, Áö±¸ ¹ÛÀ¸·Î ³ª°¡ º»(¿ìÁÖ ºñÇàÀ» ÇÑ)ÀûÀÌ ¾ø´Â »ç¶÷, (¿ìÁÖ¿¡¼­ º»)Áö»ó »ıÈ°ÀÚ, ¿ìÁÖ ºñÇà»ç°¡ ¾Æ´Ñ »ç¶÷
earthly : a, Áö±¸ÀÇ, ¼¼¼ÓÀÇ
earthlyminded : a, (°í)¼Ó¼¼ÀûÀÎ
earthman : n, Áö±¸ÀÇ, Áö±¸ÀÎ, ÁÖ¹Î
earthmother : n, ¶¥ÀÇ ¿äÁ¤, °ü´ÉÀûÀÎ ¿©ÀÚ
earthmover : n, ¶¥Â÷, Åä¸ñ±â°è
earthnut : n, ³«È­»ı, ¶¥Äá
earth orbital velocity : x, Áö±¸ ±Ëµµ ¼Óµµ
earth pillar : x, (ÁÖÀ§ÀÇ ÈëÀÇ Ä§½Ä¿¡ ÀÇÇØ »ı±â´Â)Èë±âµÕ
earthquake : n, ÁöÁø, ´ëº¯µ¿
earthquake center : x, Áø¾Ó, Áø¿øÁö
earthquake insurancd : x, ÁöÁøº¸Çè
earthquake intensity : x, Áøµµ
earthquake lights : x, ÁöÁø½ÃÀÇ ¹ß±¤ Çö»ó(ÁöÁø ¶§ ÇÏ´ÃÀÌ ¹à°Ô ºû³ª´Â Çö»ó
earthquakeproof : a, ³»ÁøÀÇ
earthquake sea wave : x, ÇØÀÏ
earthquake shock : x, ÁöÁø(ÀÇ Áøµ¿)
earthquake sounds : x, =EARTH SOUNDS
earth resources satellite : x, Áö±¸ ÀÚ¿ø Å½»ç À§¼º
earthrise : n, Áö±¸ÀÇ ¶°¿À¸§
earthsatellite : n, ÀÎ°øÀ§¼º
earthscape : n, (¹Ì)(¿ìÁÖ¼± µî¿¡¼­ º»)Áö±¸ÀÇ ¸ğ½À(°æ°ü)
earth science : x, ÁöÇĞ
earthshaking : a, ¼¼°è¸¦ ¶°µé½âÇÏ°Ô ÇÏ´Â, ±ØÈ÷ Áß´ëÇÑ 
earthshine : n, (Ãµ)(´ŞÀÇ ¾îµÎ¿î ºÎºĞÀ» ¿¯°Ô ºñÃß´Â)Áö±¸ÀÇ ¹İ»ç±¤
earthshock : n, Áöº¯, ÃµÀç Áöº¯(ÁöÁø, È­»ê Æø¹ß, ±â»ó ÀÌº¯ µî)
Earth Shoes : x, µŞÃàÀÌ ¾ÕÃàº¸´Ù ³·Àº ±¸µÎ(¹ßÀÌ ÇÇ·ÎÇÏÁö ¾Ê°í ÆíÇÏ´Ù°í ÇÔ, »óÇ¥¸í)
earth sounds : x, ¶¥¿ï¸²
earth station : x, Áö»ó±¹(À§¼º, ¿ìÁÖ Åë½Å¿ë)
earth table : x, (°Ç)±Ù¼®(°Ç¹°ÀÇ Åä´ëÁß¿¡¼­ ¶¥ Ç¥¸éÀ¸·Î ³ª¿Â ºÎºĞ)
earth time : x, Áö±¸½Ã(°£)(ÃµÃ¼ Çö»óÀ» Áö±¸»ó¿¡¼­ °üÃøÇÏ´Â µ¥ »ç¿ë, Áö±¸ ÀÚÀüÀÇ ½Ã°£ÀÌ ±âÁØÀÌ µÊ)
earth tremor : x, ¾àÇÑ ÁöÁø
earthward : ad, a, ¶¥(Áö±¸)ÂÊÀ¸·Î(ÇâÇÑ)
earthwards : ad, =EARTHWARD
Earthwatch : n, Áö±¸ °¨½Ã¸Á(¼¼°èÀû ±Ô¸ğ·Î È¯°æ ¿À¿°À» °¨½ÃÇÏ±â À§ÇØ ¸¸µé¾îÁø °Í)
Earth Week : x, Áö±¸(º¸È£)ÁÖ°£(È¯°æ º¸È£ÀÇ ÁÖ°£, 1971³â 4¿ù 18-24ÀÏ¿¡ ½Ç½Ã)
earthwork : n, ¹æ¾î¿ë ÈëµÏ, Åä¸ñ°ø»ç, ´ëÁö ¿¹¼ú(Èë, µ¹, ¸ğ·¡, ¾óÀ½ µî ÀÚ¿¬¹°À» ¼ÒÀç·Î ÇÔ)
earthworm : n, Áö··ÀÌ
earthy : a, ÈëÀÇ, Èë°°Àº, ¼¼¼ÓÀÇ, ¾ßºñÇÑ, ÇÏÄ¡ÀÇ
earthyear : n, Áö±¸³â(1³âÀ» 365ÀÏ ±âÁØÀ¸·Î ÇÑ ½Ã°£)
ear trumpet : x, º¸Ã»±â
ear trumpet : x, ³ªÆÈ²Ã º¸Ã»±â
earwax : n, ±Í¿¡Áö
earwig : n, Áı°Ô¹ú·¹
earwitness : n, ³²ÀÌ ÇÏ´Â ÀÌ¾ß±â¸¦ µè´Â(º¸°íÇÏ´Â)»ç¶÷, (¹ı)Àü¹® ÁõÀÎ
ease : Æí¾È, ¾È¶ô, ½¬¿ò, ¿©À¯, ³Ë³ËÇÔ, Æí¾ÈÈ÷, ¸¶À½³õ°í, ¾È½ÉÇÏ´Ù, ºÒ¾ÈÇÏ¿©, ¸¶À½³õÀÌÁö ¾Ê¾Æ, ±äÀåÇÏ ¿©, ¸¶À½À» ÆíÈ÷ÇÏ´Ù, ¾È½É½ÃÅ°´Ù, ´ú´Ù, ´ÊÃß´Ù
easeful : a, ¸¶À½ ÆíÇÑ, ¾È¶ôÇÑ
easel : n, È­°¡
easeless : a, ¸¶À½ÀÌ ÆíÄ¡ ¾ÊÀº, ½É½ÅÀÌ ¾ÈÁ¤µÇÁö ¾ÊÀº, ºÒ¾ÈÇÑ
easel painting : x, È­°¡¿¡ ¾ñ¾î¼­ ±×¸®±â¿¡ ¾Ë¸Â´Â(Å©±âÀÇ)±×¸²
easement : n, °íÅë µûÀ§ÀÇ ¿ÏÈ­, Áö¿ª±Ç(³²ÀÇ ¶¥À» ÅëÇàÇÏ´Â ±Ç¸® µî)
eashsoutheast : n, a, ad, µ¿³²µ¿, µ¿³²µ¿ÀÇ, µ¿³²µ¿À¸·Î, µ¿³²µ¿À¸·ÎºÎÅÍ
easily : ad, Æí¾ÈÈ÷, ½±»ç¸®, ½±°Ô
easiness : n, ¿ëÀÌÇÔ, ½¬¿ò, ÆòÀÌ(plainness), ÆòÁ¤
east : n, a, ad, µ¿ÂÊ, µ¿¾ç, ¹Ì±¹µ¿ºÎÀÇ ¿©·¯ ÁÖ(east by north µµ¹ÌºÏ, in the east of ...ÀÇ µ¿ºÎ), µ¿ÂÊÀÇ µ¿¹«ÀÇ, µ¿Á·À¸·Î¿¡
East Asia : x, µ¿¾Æ½Ã¾Æ
East Berlin : x, µ¿º£¸¦¸°(µ¿µ¶ÀÇ ¼öµµ)
East Bloc : x, µ¿±¸ °ø»ê±Ç(¹Ù¸£»ş¹Ù Á¶¾à±â±¸)¿¡ °¡¸ÍÇÑ ¼Ò·Ã°ú µ¿±¸ ¿©·¯ ³ª¶ó)
eastbound : a, µ¿ÂÊÀ¸·Î°¡´Â
East Central : n, (·±´ø½ÃÀÇ)Áß¾Ó µ¿ºÎ ¿ìÆí±¸)
East China Sea : n, µ¿Áö³ªÇØ
East End : x, ·±´ø µ¿Á· ³¡(ÀÌÀüÀÇ ºó¹Î°¡)
easter : n, µ¿Ç³, (Æ¯È÷)µ¿ÂÊ¿¡¼­ ºÒ¾î¿À´Â ÆøÇ³(°­Ç³)
Easter : n, ºÎÈ°Àı
Easter card : x, ºÎÈ°Àı Ä«µå
Easter cycle : x, ºÎÈ°Àı ¼øÈ¯±â
Easter Day : x, =EASTER SUNDAY
Easter dues : x, =EASTER OFFERINGS
easter egg : x, ºÎÈ°ÀıÀÇ Ã¤»ö´Ş°¿
easter eve : x, ºÎÈ°Àı Àü¾ß
easter lily : x, ¹éÇÕ
easterling : n, µ¿ÂÊ ³ª¶óÀÇ ±¹¹Î
easterly : a, n, ad, µ¿ÂÊ¿¡ Ä¡¿ìÄ£, µ¿ÂÊ¿¡¼­ ºÎ´Â, µ¿Ç³
Easter Monday : x, ºÎÈ°ÀıÀÇ ´ÙÀ½³¯
eastern : a, µ¿ÂÊÀÇ, µ¿¾çÀÇ, µ¿ºÎÁö¹æÀÇ
Eastern Air Lines : x, ÀÌ½ºÅÏ Ç×°ø(¹Ì±¹ÀÇ Ç×°øÈ¸»ç)
Eastern Church : x, µ¿¹æ ±³È¸(±×¸®½º Á¤±³È¸)
Easterner : n, (¹Ì)µ¿¾ç »ç¶÷, µ¿ºÎÁö¹æ(Á¦ÁÖ)ÀÇ ÁÖ¹Î(Ãâ½Å)
Eastern Establishment : x, µ¿ÇØ¾È ÁÖ·ùÆÄ(ÇÏ¹öµå, ¿¹ÀÏ, Äİ·³ºñ¾Æ ´ëÇĞ µî µ¿ÇØ¾ÈÀÇ ¸í¹®±³ Ãâ½ÅÀ¸·Î Á¤Ä¡, Àç°èÀÇ ÁßÃß¸¦ ÀÌ·ç´Â ÀÎ¸Æ)
eastern hemisphere : x, µ¿¹æ±³È¸
Eastern hemisphere : x, µ¿¹İ±¸
easternmost : a, °¡Àå µ¿ÂÊÀÇ
Eastern Orthodox Church : x, µ¿¹æ Á¤±³È¸)
Eastern Rite Church : x, µ¿¹æ Àü·Ê ±³È¸(±×¸®½º, ½Ã¸®¾Æ µîÀÇ Ä«Åç¸¯ ±³È¸, ¼ºÁ÷ÀÚ°¡ °¡Á¤À» °¡Áú ¼ö ÀÖÀ½)
Eastern Roman Empire : x, µ¿·Î¸¶ Á¦±¹
Eastern Standard time : x, µ¿ºÎ Ç¥ÁØ½Ã(Ä³³ª´Ù µ¿ºÎ, ¹Ì±¹ µ¿ºÎ, ¿À½ºÆ®·¹ÀÏ¸®¾Æ µ¿¹«)
Eastern state : x, (¹Ì)µ¿ºÎÀÇ ¿©·¯ ÁÖ
Easter offerings : x, ºÎÈ°ÀıÀÇ Çå±İ
easter sunday : x, ºÎÈ°ÁÖÀÏ
Easter Sunday : x, ºÎÈ° ÁÖÀÏ(=EAsterday)
Easter Term : x, (¿µ¹ı)4¿ù 15ÀÏ ÈÄ ¾à 3ÁÖ°£ÀÇ °³Á¤±â, (¿µ´ëÇĞ)º½ÇĞ±â, Å©¸®½º¸¶½ººÎÅÍ ºÎÈ°Àı±îÁöÀÇ ÇĞ±â
Eastertide : n, ºÎÈ°ÀıºÎÅÍ °­¸³Àı±îÁöÀÇ 50ÀÏ°£=EASTERWEER
Easter Week : x, ºÎÈ°Àı·Î ½ÃÀÛµÇ´Â 1ÁÖÀÏ
East Germanic : x, (¾ğ)µ¿°Ô¸£¸¸¾î(±º)
East Germany : n, µ¿µ¶(¼öµµ Berlin)
East India Company : x, µ¿ÀÎµµ È¸»ç(¿µ±¹ÀÌ 1600³â¿¡ ¼³¸³, 1874³â ÇØ»ê)
East Indian : x, µ¿ÀÎµµÀÇ(ÅäÀÎ, ÁÖ¹Î)
East Indies : n, µ¿ÀÎµµ
easting : n, µ¿Ç×, Æíµ¿Ç×Çà, (ÃµÃ¼ÀÇ)µ¿Áø, (¹Ù¶÷ ¹æÇâÀÇ)µ¿Çâ, µ¿Çâ, µ¿¹æÀ§
Eastman : n, ÀÌ½ºÆ®¸Õ
eastnortheast : n, a, ad, µ¿ºÏµ¿, µ¿ºÏµ¿, µ¿ºÏµ¿À¸·Î(¿¡¼­)
East Pakistan : n, µ¿ÆÄÅ°½ºÅº(1971³â¸» µ¶¸³ÇÏ¿© Bangladesh°¡ µÊ)
East Side : x, ´º¿å Manhattan¼¶ µ¿ºÎÀÇ ÇÏÃş ÀÌ¹Î Áö±¸
East Sussex : n, À×±Û·£µå ³²µ¿ºÎÀÇ ÁÖ
eastward : n, a, ad, µ¿ÂÊ, µ¿ÂÊÀÇ
eastward : ad, a, µ¿ÂÊÀ¸·Î(ÀÇ)
eastwards : ad, =EASTWARD
easy : a, ad, n, ½¬¿î, ¾È¶ôÇÑ, Æí¾ÈÇÑ, ´Ù·ç±â ½¬¿î, ÆòÀÌÇÑ, °ÔÀ¸¸¥, ºÎµå·¯¿î, °ü´ëÇÑ ´ÙÅõ±â ½¬¿î, ¸»À» Àß µè´Â, ¹®Ã¼°¡ ÆòÀÌÇÑ, ±î´Ù·ÓÁö ¾ÊÀº
easy chair : x, ¾È¶ô ÀÇÀÚ
easydoesit : a, ¸¶À½ÆíÇÑ
easygoing : a, ÅÂÆòÇÑ, ´ÜÁ¤Ä¡ ¸øÇÑ, ´À¸° °ÉÀ½ÀÇ
easy make : x, (¼Ó)=EASY MARK, ½±°Ô ¸öÀ» Çã¶ôÇÏ´Â ¿©ÀÚ
easy mark : x, È£ÀÎ
easy meat : x, (±¸)½±°Ô ¼Ó´Â(ÀÌ¿ë´çÇÏ´Â)»ç¶÷, ¼Õ ½¬¿î°Í
easy money : x, ¼ö¿ùÇĞ ¹ø µ·, ºÎÁ¤ ÇÑ µ·
easy street : x, (±¸)À¯º¹ÇÑ ½ÅºĞ, ÀçÁ¤Àû µ¶¸³
easy virtue : x, ¸ö°¡ÁüÀÌ ÇìÇÄ, ºÎÁ¤
eat : ¸Ô´Ù, ¸Ô¾î  µé¾î°¡´Ù, Ä§½ÄÇÏ´Ù, ÆÄ±«ÇÏ´Ù, ½Ä»çÇÏ´Ù, ¸ÔÀ» ¼ö ÀÖ´Ù, ¸ÔÀÌ µé¾î°¡´Ù, ºÎ½ÄÇÏ´Ù, ½½ÇÄ¿¡ Àá±â´Ù
EATA : x, East Asia Travel ASSOCIATION
eatable : a, n, ¸ÔÀ» ¼ö ÀÖ´Â, ½Ä·áÇ°
eaten : v, EATÀÇ °ú°ÅºĞ»ç
eater : n, ¸Ô´Â »ç¶÷, ºÎ½Ä¹°(Á¦), ³¯·Î ¸ÔÀ» ¼ö ÀÖ´Â °úÀÏ
eatery : n, (±¸)°£ÀÌ ½Ä´ç
eatin : (1960³â´ë¿¡)ÈæÀÎÀÌ ÀÎÁ¾ Â÷º° ½Ä´ç¿¡ ¸ô·Á°¡¼­  ½Ä»ç¸¦ ÇÏ´Â Â÷º° Ç×ÀÇ¿îµ¿, (¹Ì±¸)(1980³â´ë¿¡)°Ë¼ÒÇÑ È¸½ÄÀ» ÇÏ°í ±× È¸ºñÀÇ ÀÏºÎ¸¦ ÁÁÀº ÀÏ¿¡ ±âºÎÇÏ´Â ¿îµ¿, (¹Ì¼Ó)¿À·²¼½½º¸¦ ÇÏ´Â ³­ÀâÇÑ ÆÄÆ¼
eating : n, a, ¸Ô±â, ½ÄÇ°, Á»¸Ô¾î µé¾î°¡´Â, ½Ä¿ëÀÇ
eating house : x, ½Ä´ç
Eaton agent : x, (ÀÇ)ÀÌÆ° ÀÎÀÚ
eau : n, ¹°
eau de Cologne : x, ¿ÀµåÄİ·Ğ(Çâ¼ö)
eau de Nil : n, (F (³ªÀÏ°­ÀÇ ¹°)ÀÌ¶õ ¶æ¿¡¼­), ¾Ï³ì»ö
eau de vie : x, ºê·£µğ
eau sucree : n, (F)¼³ÅÁ¹°
eaveadropping : n, ¿³µè±â
eaves : n, Ã³¸¶
eavesdrop : v, ¿³µè´Ù
Eb : x, (È­)erbium
EB : x, eastbound
ebb : n, vi, ½ä¹°, °£Á¶, ¼èÅğ(ebb and flow ½ä¹°), ¼º¼è, ±â¿ï´Ù
ebb tide : x, ½ä¹°, ¼èÅğ±â
EBCDIC : n, (Àü»ê)È®Àå 2ÁøÈ­ 10Áø ÄÚµå
Ebenezer : n, ³²ÀÚÀÌ¸§
EBF : x, Encyclop(a)edia Britannica Film(´ë¿µ ¹é°ú »çÀüÀ» ±âÃÊ·Î ÇÑ ±³À° ¿µÈ­)
Eblaite : n, a, ¿¡ºí¶ó¾î(¾î)(ºÏ½Ã¸®¾Æ¿¡¼­ ¹ß°ßµÈ ¼¼°è ÃÖ°íÀÇ ¼À¾îÁ· ¾ğ¾î), ¿¡ºí¶ó¾îÀÇ, ¿¡ºí¶ó ¿Õ±¹ÀÇ
Eblan : a, =EBLAITE
EbN : x, east by north µ¿¹ÌºÏ
Eboat : n, Á¦1Â÷´ëÀü¶§ÀÇ µ¶ÀÏ Äè¼Ó ¾î·ÚÁ¤
Ebolavirus : x, °í¿­°ú ³»ÃâÇ÷À» ÀÏÀ¸Å°´Â ¿­´ë Àü¿°º´ ¹ÙÀÌ·¯½º, Ebola´Â ÀÚÀÌ¸£ ºÏºÎÀÇ °­
ebon : n, a, (°í, ½Ã)=EBONY
ebonite : n, ¿¡º¸³ªÀÌÆ®
ebonize : vt, Èæ´Ü ºñ½ÁÇÏ°Ô (Âø»ö)ÇÏ´Ù
ebony : n, a, Èæ´Ü, Ä¥ÈëÀÇ
Ebor, : x, Eboracensis(L=of York, Archbishop of York°¡ ¼­¸í¿¡ »ç¿ë, Cantuar)
EBR : x, Experimental Breeder Reactor ½ÇÇè¿ë Áõ½Ä·Î
ebriety : n, =INEBRIETY
EbS : x, east by south µ¿¹Ì³²
ebullience : n, (¹®¾î)ºñµî, (°¨Á¤ µîÀÇ)°İ¹ß, °İÁ¤ÀÇ ¹ß·Î
ebullient : a, ÆÈÆÈ²ú´Â, ³ÑÃÄÈå¸£´Â, ¿­±¤ÀûÀÎ
ebullism : n, (ÀÇ)(±Ş¼ÓÇÑ ±â¾Ğ°­ÇÏ·Î ÀÎÇÑ Ã¼¾× ºñµî
ebullition : n, ºñµî, µ¹¹ß, °İ¹ß, ºĞÃâ
E by N : x, east by north
E by S : x, east by south
ec : n, °æÁ¦ÇĞ
EC, E, C, : x, European CommunityÀ¯·´ °øµ¿Ã¼
ec- : x, (¿¬°áÇü)(¼¼´ë, °æÁ¦)ÀÇ ¶æ(¸ğÀ½ ¾Õ¿¡¼­´Â ec-)
ec- : x, (¿¬°áÇü)(È¯°æ, »ıÅÂ)ÀÇ ¶æ(¸ğÀ½ ¾Õ¿¡¼­´Â ec-)
ECA : x, Economic Commission for Africa(±¹Á¦¿¬ÇÕ)¾ÆÇÁ¸®Ä« °æÁ¦ À§¿øÈ¸, Economic Cooperation Administration(¹Ì)°æÁ¦ Çù·Â±¹(MSAÀÇ ±¸Äª
ecad : n, ¾î¶²ÇüÅÂ°¡ À¯ÀüÀÌ ¾Æ´Ï°í, ¿ÜºÎÈ¯°æ¿¡ ÀÇÇÑ º¯È­ÇüÅÂ¶ó°í ÀÎÁ¤µÇ´Â°Í
ECAFE : x, Economic Commission for Asia and Far East
ecarte : n, ¿¡Ä«ÇÁÅ×(32ÀåÀ» °¡Áö°í µÎ »ç¶÷ÀÌ ÇÏ´Â Ä«µå³îÀÌ)
ecbolic : a, n, ³«ÅÂ, À¯»ê½ÃÅ°´Â, ºĞ¸¸À» ÃËÁø½ÃÅ°´Â
ECC : x, Economic Cooperation Committee
eccehomo : n, °¡½Ã¸é·ù°üÀ» ¾´ ±×¸®½ºµµÀÇ ÃÊ»ó
eccentric : a, n, Æí½ÉÀÇ, Æí½ÉÀûÀÎ, º°³­, ±«Â¥ÀÇ, ±«Â¥, º°³­»ç¶÷, Æí½É·Ğ, Æí½É·û
eccentricity : n, º°³², ±«º®
ecchymosis : n, (º´¸®)(Å¸¹Ú¿¡ ÀÇÇÑ)¹İ»óÃâÇ÷
Eccl(es), : x, Ecclesiastes
eccl, : x, ecclesiastical(ly)
ecclesia : n, °í´ë ±×¸®½ºÀÇ ±¹¹ÎÈ¸ÀÇ
ecclesiastes : n, Àüµµ¼­
ecclesiastic : n, a, ¸ñ»ç, ±³È¸ÀÇ, ¼ºÁ÷ÀÇ
ecclesiastical : a, ±³È¸ÀÇ, ¼ºÁ÷ÀÇ
ecclesiasticism : n, ±âµ¶±³È¸ÀÇ ÁÖÀÇ(°üÇà, Á¤½Å, ÀüÅë), ±³È¸(Áß½É)ÁÖÀÇ
Ecclesiasticus : n, ÁıÈ¸ÀÇ¼­
ecclesiological : a, ±³È¸ÇĞ»óÀÇ, ±³È¸ °ÇÃàÇĞÀûÀÎ
ecclesiology : n, ±³È¸ÇĞ, ±³È¸ °ÇÃàÇĞ
Ecclus, : x, Ecclesiasticus
ECCM : x, electronic countercountermeasures(±º)´ëÀüÀÚ ´ëÃ¥(ÀüÀÚ ´ëÃ¥(ECM)¿¡ ´ëÇÑ ´ëÇ× ¼ö´ÜÀÇ ÃÑÄª)
eccrine : a, (»ı¸®)¿ÜºĞºñ(¼±)ÀÇ, ´©Ãâ ºĞºñÀÇ
eccrinology : n, (»ı¸®)ºĞºñ¼±ÇĞ
ecdysiast : n, (¹Ì, ÀÍ»è)=STRIPTEASER
ecdysis : n, Å»ÇÇ, Çã¹°
ecdysone : n, (»ıÈ­)(°ïÃæ µîÀÇ)Å»ÇÇ È£¸£¸ó
ECE : x, Economic Commission for Europe(±¹Á¦¿¬ÇÕ) À¯·´ °æÁ¦ À§¿øÈ¸
ECG : x, electrocardiogram
ech, : x, echelon
echelon : n, vi, »ç´Ù¸®²ÃÆí´ë
echidna : n, ¹Ù´ÃµÎ´õÁö
echin- : x, (¿¬°áÇü)(°¡½Ã, ¼¶°Ô)ÀÇ ¶æ(¸ğÀ½ ¾Õ¿¡¼­´Â echin-)
echinate : a, °¡½Ã°¡ ¸¹Àº, À¯±ØÀÇ
echinoderm : n, ±ØÇÇµ¿¹°(¼¶°Ô, ºÒ°¡¸®, ÇØ»ï µûÀ§)
echinoid : n, a, (µ¿)¼¶°Ô(°°Àº)
echinus : n, (µ¿)¼¶°Ô, (°Ç)¸¸µÎÇü(µµ¸®¾Æ½Ä °ÇÃà ¾ç½ÄÀÇ ÁÖ°üÀ» ÀÌ·ç´Â ¾ÆÄ¡Çü)
echo : ¸Ş¾Æ¸®, ¹İÇâ, Èä³»³»±â, ¸ğ¹æ, ½£ÀÇ¿äÁ¤(Narcissus¿¡ ´ëÇÑ »ç¶ûÀ»  ÀÌ·çÁö ¸øÇÏ¿© ¸»¶óÁÖ¾î¼­ ¼Ò¸®¸¸ ³²¾ÒÀ½), ¸Ş¾Æ¸®Ä¡´Ù, ¹İÇâÇÏ´Ù, ±×´ë·Î µÇÇ®ÀÌÇÏ¿© ´ë´äÇÏ´Ù, ¸ğ¹æÇÏ´Ù
ECHO : n, (ÀÇ)ÃÊÀ½ÆÄ °Ë»ç¹ı(Ã¼³» Àå±âÀÇ ÀÌ»óÀ» Á¶»çÇÏ´Â ¹æ¹ı, Á¾¾ç, µ¹ °ËÃâ¿¡ À¯¿ë)
echocardiogram : n, (ÀÇ)ÃÊÀ½ÆÄ ½ÉÀå Áø´Üµµ
echo cardiography : x, (ÀÇ)ÃÊÀ½ÆÄ ½ÉÀå °ËÁø(¹ı)
echo chamber : x, (¹æ¼Û)ÀÜÇâ½Ç(¿¬Ãâ»ó ÇÊ¿äÇÑ ¿¡ÄÚ È¿°ú¸¦ ¸¸µé¾î ³»´Â ¹æ)
echo effect : x, ¸Ş¾Æ¸® È¿°ú(¾î¶² ÀÏÀÌ µÚ´Ê°Ô µÇÇ®ÀÌ µÇ°Å³ª, ±× °á°ú°¡ ´Ê°Ô ³ªÅ¸³ª´Â µîÀÇ Çö»ó)
echoencephalography : n, (ÀÇ)ÃÊÀ½ÆÄ ³ú°Ë»ç(¹ı)
echogram : n, (ÇØ)À½Çâ Ãø½É ±â·Ïµµ, (ÀÇ)¿¡ÄÚµµ(¿À½Ç·Î½ºÄÚÇÁÀÇ ½ºÅ©¸°¿¡ ³ªÅ¸³ª´Â È¯ºÎ Á¶Á÷ÀÇ)
echoic : a, ¹İÇâÀÇ, ¹İÇâ ÀåÄ¡ÀÇ, (¾ğ)ÀÇÀ½(ÀÇ¼º)ÀÇ
echolalia : n, (½É)¹İÇâ¾ğ¾î(³²ÀÇ ¸»À» ±×´ë·Î Èä³»³»´Â Çàµ¿), (À¯¾Æ±âÀÇ)À½¼º ¸ğ¹æ
echolocate : vt, ...À» À½ÆÄ Å½ÁöÇÏ´Ù, À½ÆÄ Å½Áö ±â´ÉÀ» °®´Ù
echolocation : n, ¹İÇâÁ¤À§)¹ÚÁãµîÀÌ ÃÊÀ½ÆÄ¸¦ ³»¾î ±× ¹İ»ç·Î ¹°Ã¼ÀÇ À§Ä¡¸¦ ¾Æ´Â °Í)
echo machine : x, (Àü)¹İÇâ ÀåÄ¡(Å×ÀÌÇÁ ¸®ÄÚ´õ µîÀ» ÀÌ¿ëÇÏ¿© ÀÎ°øÀûÀ¸·Î ¹İÇâÀ½À» ¸¸µé¾î ³»´Â ÀåÄ¡)
echo sounder : x, À½Çâ Ãø½É±â
echo sounding : x, (ÇØ)À½Çâ Ãø½É
echovirus : n, ¿¡ÄÚ¹ÙÀÌ·¯½º(ÀÎÃ¼ÀÇ Àå³»¿¡ ¹ø½ÄÇÏ¸ç ¼ö¸·¿° µîÀ» ÀÏÀÇÅ´)
ecize : vi, (»ıÅÂ)(Æ¯È÷ ÀÌÁÖ¼º »ı¹°ÀÌ)»õ·Î¿î È¯°æ¿¡ Á¤Âø, ¼øÀÀÇÏ´Ù
ECLA : x, Economic Commission for Latin America(±¹Á¦¿¬ÇÕ)¶óÆ¾¾Æ¸Ş¸®Ä« °æÁ¦ À§¿øÈ¸
eclair : n, ¿¡Å¬·¹¾î(ÀÎÃ¼ÀÇ Àå³»¿¡ ¹ø½ÄÇÏ¸ç ¼ö¸·¿° µîÀ» ÀÏÀÇÅ´)
eclair : n, ¿¡Å¬·¹¾î(°¡´Ã°í ±æÂßÇÑ ½´Å©¸²)
eclaircissement : n, (F)¼®¸í, ÇØ¸í, ¼³¸í
eclampsia : n, (º´¸®)°æ·Ã, (Æ¯È÷)ÀÚ°£, (¾î¸°ÀÌÀÇ)±Ş°£
eclat : n, ´ë¼º°ø, ´ë°¥Ã¤
eclectic : a, n, Ãë»ç¼±ÅÃÀûÀÎ, ÀıÃæÁÖÀÇÀÇ
eclecticism : n, 
Eclectic School : x, (Ã¶)ÀıÃæÇĞÆÄ, (¹Ì)ÀıÃæÈ­ÆÄ(16¼¼±â¸» ÀÌÅ»¸®¾ÆÀÇ º¼·Î³ÄÈ­ÆÄ, ¶Ç´Â 19¼¼±âÃÊ ÇÁ¶û½ºÈ­ÀÇ ÀÏÆÄ)
eclipse : n, vt, ½Ä, ½ÇÃß, ºûÀÇ ¼Ò¸ê, ´É°¡ÇÏ´Ù, ...ÀÇ ¸í¼ºÀ» »©¾Ñ´Ù
eclipsis : n, (¾ğ)(¹®Àå ÀÏºÎÀÇ)»ı·«, (¼±Çà¾îÀÇ ¿µÇâ¿¡ µû¸¥)¾îµÎ ÀÚÀ½ÀÇ À½¼º º¯È­
ecliptic : a, n, ½ÄÀÇ, È²µµÀÇ
ecliptical : a, =ECLIPTIC
eclogue : n, Àü¿ø½Ã
eclosion : n, ¿ìÈ­, ºÎÈ­
ECLSS : x, environmental control and life support system, È¯°æ Á¦¾î, »ı¸í À¯Áö ½Ã½ºÅÛ
ECM : x, European Common Market À¯·´ °øµ¿ ½ÃÀå, electronic countermeasures
ECNR : x, European Council of Nuclear Research
eco- : x, (¿¬°áÇü)=EC
eco- : x, (¿¬°áÇü)=EC
ecoactivist : n, È¯°æ¿îµ¿°¡
ecoactivity : n, »ıÅÂ°è º¸Àü È°µ¿, È¯°æ ¿À¿° ¹æÁö ¿îµ¿
ecocatastrophe : n, (È¯°æ ¿À¿°¿¡ ÀÇÇÑ)»ıÅÂ°èÀÇ ´ëº¯µ¿
ecocidal : a, 
ecocide : n, È¯°æÆÄ±«
ecoclimate : n, (»ıÅÂ)»ıÅÂ±âÈÄ(»ı½ÄÁöÀÇ ±âÈÄ ¿äÀÎÀÇ ÃÑÃ¼)
ecodevelopment : n, È¯°æ, °æÁ¦ÀÇ Á¶È­¸¦ À¯ÁöÇÏ´Â °³¹ß
ecodoom : n, »ıÅÂ°èÀÇ ´ë±Ô¸ğ ÆÄ±«
ecodoomster : n, ECODOOMÀ» ¿¹¾ğ(°æ°í)ÇÏ´Â »ç¶÷
ecofallow : n, (³ó)³óÁö ÈŞÇÑ ³ó¹ı
ecofreak : n, (¼Ó, °æ¸ê)¿­·ÄÇÑ È¯°æ º¸È£·ĞÀÚ, ÀÚ¿¬ º¸È£·Ğ ½ÅºÀÀÚ
ecogeographic : a, (»ıÅÂ)»ıÅÂ Áö¸®ÀûÀÎ(È¯°æÀÇ »ıÅÂÇĞÀûÀÎ ¸é°ú Áö¸®ÇĞÀûÀÎ ¸éÀÇ ¾ç ÂÊ¿¡ °ü·ÃµÇ´Â)
ecol, : x, ecological, ecology
ecole : n, (F)ÇĞ±³, ÇĞÆÄ
ecological : a, »ıÅÂÇĞÀÇ
ecological allergy : x, (ÀÇ)»ıÅÂÇĞÀû ¾Ë·¹¸£±â(È­ÇĞ ¹°Áú, ¼®À¯ Á¦Ç° µî¿¡ ÀÇÇÑ)
ecological art : x, È¯°æ ¿¹¼ú, »ıÅÂÇĞÀû ¿¹¼ú(ÀÚ¿¬ÀÇ Èë, ¸ğ·¡, ¾óÀ½ µîÀ» ¼ÒÀç·Î ÇÑ ¿¹¼ú)
ecological efficiency : x, (»ıÅÂ)»ıÅÂ È¿·Â, »ıÅÂÀû È¿À²(¹°Áú, ¿¡³ÊÁöÀÇ ÀüÀÌ È¿À²)
ecological pyramid : x, (»ıÅÂ)»ıÅÂÀû ÇÇ¶ó¹Ìµå
ecological succession : x, (»ıÅÂ)»ıÅÂ ÃµÀÌ
ecologist : n, »ıÅÂÇĞÀÚ
ecology : n, »ıÅÂÇĞ, È¯°æ, »çÈ¸ÇüÅÂÇĞ
ECOM : x, (Electronic Computer Originated Mail)(¹Ì)ÀüÀÚ ¿ìÆí ¼­ºñ½º
ecomone : n, (ÀÚ¿¬°èÀÇ ±ÕÇü¿¡ ¿µÇâÀ» ¹ÌÄ¡´Â)»ıÅÂ È£¸£¸ó
econ, : x, economic(s), economist, economy
econiche : n, »ıÅÂÀû ÁöÀ§
econobox : n, °æÁ¦Â÷(¿¬·á ¼Òºñ°¡ ÀûÀº »óÀÚÇü ÀÚµ¿Â÷ÀÇ º°¸í)
econometrics : n, °è·®°æÁ¦ÇĞ
economic : a, °æÁ¦ÇĞ»óÀÇ, °æÁ¦»óÀÇ, °æÁ¦ÀûÀÎ
economical : a, Àı¾àÇÏ´Â, °Ë¾àÇÑ, ½Ç¿ëÀûÀÎ
Economic and Social Council : x, =ECOSOC
economic animal : x, °æÁ¦ µ¿¹°(°æÁ¦ ´ë±¹À¸·Î¼­ÀÇ ÀÏº»À» ¾ßÀ¯ÇÏ´Â È£Äª)
economic blockade : x, °æÁ¦ ºÀ¼â
economic botany : x, ½Ç¿ë ½Ä¹°ÇĞ
economic crime : x, °æÁ¦ ¹üÁË(°ø±İ È¾·É, ¼öÈ¸, ¹Ğ¼ö, ºÎÁ¤ ÃàÀç µî)
Economic Decentralization : x, °æÁ¦·Â ÁıÁß ¹èÁ¦¹ı
economic development zone : x, (Áß°øÀÇ)°æÁ¦ °³¹ß±¸
economic growth rate : x, °æÁ¦ ¼ºÀå·ü
economic indicator : x, (°æ)°æÁ¦ ÁöÇ¥
economic man : x, (°æ)°æÁ¦ÀÎ
economic model : x, (°æ)°æÁ¦ ¸ğµ¨
Economic Planning Board : x, °æÁ¦ ±âÈ¹¿ø(ÇÑ±¹)
economic police : x, °æÁ¦ °æÂû
Economic Report : x, (¹Ì±¹ ´ëÅë·ÉÀÇ)°æÁ¦ º¸°í(¿¬ÃÊ¿¡ »óÇÏ ¾ç¿ø¿¡ º¸³¿)
economics : n, °æÁ¦ÇĞ
economic sanctions : x, °æÁ¦Àû Á¦Àç(ºÀ¼â)
economic zone : x, °æÁ¦ ¼ö¿ª
economism : n, °æÁ¦ÁÖÀÇ, °æÁ¦Áö»óÁÖÀÇ
economist : n, °æÁ¦ÇĞÀÚ, °Ë¾à°¡
economization : n, (±İÀü, ½Ã°£, ³ë·Â µîÀÇ)Àı¾à, °æÁ¦Àû »ç¿ë
economize : vt, vi, °æÁ¦ÀûÀ¸·Î »ç¿ëÇÏ´Ù, Àı¾àÇÏ´Ù
economizer : n, Àı¾à°¡, °æÁ¦°¡, °Ë¾à°¡, (È­·Â, ¿¬·á µîÀÇ)Àı¾à ÀåÄ¡
economy : n, °æÁ¦, °Ë¾à, Àı¾à, À¯±âÀû Á¶Á÷, ¼·¸®(practice economy ½Ä¹°Ã¼ÀÇ Á¶Á÷)
economy class : x, ÀÌµî
economysize : a, °ª½Î°í Æí¸®ÇÑ(ÀÛÀº)»çÀÌÁîÀÇ, º¸Åëº¸´Ù °ª½Î°í Å«
econut : n, (¼Ó)=ECOFREAK
ecophysiology : n, È¯°æ »ı¸®ÇĞ
ecopolitics : n, °æÁ¦ Á¤Ä¡ÇĞ, È¯°æ Á¤Ä¡(Á¤Ã¥)ÇĞ
ecopornography : n, È¯°æ ¹®Á¦¿¡ ´ëÇÑ ÀÏ¹İÀÇ °ü½ÉÀ» ÀÌ¿ëÇÑ ±¤°í
ECOSOC : n, Economic and Social Council
ecospecies : n, (»ıÅÂ)»ıÅÂÁ¾
ecosphere : n, (¿ìÁÖÀÇ)»ı¹° »ıÁ¸±Ç, (Æ¯È÷ Áö±¸ÀÇ)»ı¹°±Ç, »ıÅÂ±Ç
ecosystem : n, »ıÅÂ°è
ecotage : n, È¯°æ ¿À¿° ¹İ´ë ÆÄ¾÷(Æ¯È÷ È¯°æ ¿À¿°¿ø¿¡¼­ ÀÏÇÏ´Â »ç¶÷µéÀÇ)
ecotecture : n, È¯°æ ¿ì¼± °ÇÃà µğÀÚÀÎ(È¯°æ»óÀÇ ¿äÀÎÀ» ½Ç¿ëº¸´Ù Áß½ÃÇÏ´Â µğÀÚÀÎ)
ecotone : n, (»ıÅÂ)ÀÌÇà´ë, ÃßÀÌ´ë(ÀÎÁ¢ÇÏ´Â »ı¹° ±ºÁı°£ÀÇ ÀÌÇàºÎ)
ecotype : n, (»ıÅÂ)»ıÅÂÇü
ECOWAS : x, Economic Community of West African States¼­¾ÆÇÁ¸®Ä« Á¦±¹ °æÁ¦ °øµ¿Ã¼
ECR : x, electronic cash registerÀüÀÚ½Ä ±İÀü µî·Ï±â
ecru : n, a, (F)º£ÀÌÁö(»ö)(ÀÇ), ¿¯Àº °¥»ö(ÀÇ)
ECSC : n, European Col and Steel Community
ecstasize : vt, vi, È²È¦ÇÏ°Ô ÇÏ´Ù(ÇØÁö´Ù), ¹«¾Æ°æ¿¡ ÀÌ¸£°Ô ÇÏ´Ù(ÀÌ¸£´Ù)
ecstasy : n, ¹«¾Æ°æ, È²È¦, ¹ı¿­, ÀÇ½ÄÈ¥¹Ì»óÅÂ
ecstatic : a, Èñ¿­¿¡ ³ÑÄ£, ¿ÏÀüÈ÷ ¸¶À½ÀÌ ÆÈ¸°, È²È¦ÇÑ, ¹«¾Æ°æÀÇ
ECT, : x, electroconvulsive therapy Àü±â Ãæ°İ ¿ä¹ı
ect- : x, (¿¬°áÇü)(È¸(ºÎ)ÀÇ)¶æ, (¸ğÀ½ ¾Õ¿¡¼­´Â ect-)
ectoblast : n, (»ı)¿Ü¹è¿±
ectocrine : n, (»ıÈ­)¿¡ÅäÅ©¸°, ¿ÜºÎ ´ë»ç »ê¹°, ¿ÜºĞºñ(¹°)
ectoderm : n, ¿Ü¹è¿±
ectoenzyme : n, (»ıÈ­)Ã¼¿Ü È¿¼Ò, ¼¼Æ÷ÀÇ È¿¼Ò(Ã¼¿Ü¿¡ ºĞºñµÈ)
ectohormone : n, (»ıÈ­)¿ÜºĞºñ(¿¢Åä)È£¸£¸ó
ectomorph : n, (½É)¿Ü¹è¿±Çü(¸¶¸£°í Å°°¡ Å« Çü)ÀÇ »ç¶÷, Çã¾à Ã¼ÁúÀÚ
ectomorphic : a, (½É)¿Ü¹è¿±ÇüÀÇ, Çã¾àÇÑ
ectomorphy : n, (½É)¿Ü¹è¿±Çü
ectomy : x, (¿¬°áÇü)(...ÀıÁ¦(¼ú))ÀÇ ¶æ
ectoparasite : n, (µ¿)Ã¼¿Ü ±â»ıÃæ(Áøµå±â µî)
ectopic : a, (º´¸®)Á¤±Ô Àå¼Ò ¹ÛÀÇ
ectoplasm : n, (¿ø»ı µ¿¹°ÀÇ)¿ÜÁú, ¿µ¸ÅÃ¼·ÎºÎÅÍÀÇ ¹ß»ê ¹°Áú, ¿µ±â
ectype : n, Àç»ı¹°, ¸ğÇüº¹»ç
ecu : n, Currency Unit À¯·´ ÅëÈ­ ´ÜÀ§, ¿¡Å¥
ECU : x, electrical control unit Àü·Â Á¦¾î À¯´Ö
Ecua, : x, Ecuador
Ecuador : n, ¿¡ÄâÅä¸£(³²¾Æ¸Ş¸®Ä«ÀÇ °øÈ­±¹)
Ecuadorian : n, a, ¿¡Äâµµ¸£ »ç¶÷(ÀÇ)
ecumenical : a, Àü¹İÀûÀÎ, Àü±âµ¶±³ÀÇ
ecumenical patriarch : x, ÃÑ´ëÁÖ±³(µ¿¹æ ±³È¸ÀÇ)
ecumenism : n, (±³°ú¸¦ ÃÊ¿ùÇÑ)¼¼°è ±³È¸ÁÖÀÇ
ecumenopolis : n, ¼¼°èµµ½Ã
ECWA : x, Economic Commission for Western Asia (À¯¿£)¼­¾Æ½Ã¾Æ °æÁ¦ À§¿øÈ¸
eczema : n, ½ÀÁø
eczemaed : suf, ...À» ÇÑ, ...À» °¡Áø
Ed : x, ³²ÀÚ ÀÌ¸§
ED : x, effectove dpse.(¾àÀÇ)À¯È¿·®, environmental disruption È¯°æ ÆÄ±«
ed : a, ±ÔÄ¢µ¿»çÀÇ °ú°Å, °ú°Åµ¿»ç, ...À» °¡Áø, À» °®Ãá, ¿¡ °É¸°
ed, : x, edited, edition, editor, educater
Ed, B : x, Bachelor of Education
ed, cit, : x, the edition citedÀÎ¿ë(ÂüÁ¶)ÆÇ
Ed, D, : x, Doctor of Education
Ed, M, : x, Master of Education±³À°ÇĞ ¼®»ç
edacious : a, (¹®¾î, ÀÍ»ì)Å½½ÄÇÏ´Â, ´ë½ÄÀÇ
edacity : n, (¹®¾î, ÀÍ»ì)¿Õ¼ºÇÑ ½Ä¿å, ´ë½Ä
Edam cheese : n, ºÓÀº °øº¸¾çÀÇ Ä¡Áî
edaphic : a, (½Ä)Åä¾çÀÇ, Åä¾ç¿¡ °ü·ÃµÈ, (±âÈÄº¸´Ù´Â)Åä¾çÀÇ ¿µÇâÀ»¹Ş´Â, ÅäÂøÀÇ
EDay : n, (¿µ±¹ÀÇ)EC°¡ÀÔ ±â³äÀÏ(1973³â 1¿ù 1ÀÏ)
EDB : x, ethylene dibromide 2ÃëÈ­¿¡Æ¿·»(»ìÃæÁ¦)
edbiz : n, (¹Ì¼Ó)±³À° »ê¾÷
EDC : x, European Defence Community
Edda : n, ¿¡´õ(°í´ë ¾ÆÀÌ½½¶õµåÀÇ ½ÅÈ­ ½ÃÁı)
Eddie : n, ³²ÀÚ ÀÌ¸§
Eddington('s) limit : x, (Ãµ)¿¡µùÅÏ ÇÑ°è ±¤µµ(ÀÏÁ¤ Áú·®ÀÇ ÃµÃ¼°¡ ³¾ ¼ö ÀÖ´Â ºûÀÇ ÃÖ´ëÇÑÀÇ ¹à±â)
eddy : n, vi, ¼Ò¿ëµ¹ÀÌ
eddy current : x, (Àü)¿Í»ó Àü·ù(ÀÚÀåÀ» º¯µ¿½ÃÅ³ ¶§, µµÃ¼ ¾È¿¡ »ı±è)
edectroform : vt, ...À» Àü±â ÁÖÁ¶ÇÏ´Ù
edelweiss : n, ¿¡µ¨¹ÙÀÌ½º, ¿Ö¼Ù´Ù¸®(°í»ê ½Ä¹°)
edema : n, ºÎÁ¾, ¼öÁ¾
Eden : n, vt, vi, ¿¡µ§µ¿»ê, ³«¿ø
Eden : n, Sir Robert Anthony(1897~)¿µ±¹ÀÇ Á¤Ä¡°¡, ¼ö»ó(1955~1957)
edentate : a, ÀÌ°¡ ¾ø´Â, (µ¿)(¾Õ´Ï¿Í ¼Û°÷´Ï°¡ ¾ø´Â)ºóÄ¡·ùÀÇ
EDF : x, European Development Fund
Edgar : n, ³²ÀÚ ÀÌ¸§, ¿¡µå°Å»ó
edge : ³¯, °¡ÀåÀÚ¸®, ³¯Ä«·Î¿ò, °Å³ªÇÏ°Ô ÃëÇÔ, ÈïºĞÇØ ÀÖ´Ù, ÈïÀ»±ú´Ù, ³¯Ä«·Ó°Ô ÇÏ´Ù, ºñ½ºµëÈ÷ ³ª¾Æ°¡´Ù, ÃµÃµÈ÷ ¿òÁ÷ÀÌ´Ù
edgebone : n, =AITCHBONE
edged : a, ³¯ÀÌ ÀÖ´Â, Åë·ÄÇÑ(Ç³ÀÚ µî), °¡ÀåÀÚ¸®°¡ ÀÖ´Â, °Å³ªÇÏ°Ô ÃëÇÑ
edgeless : a, ³¯ÀÌ ¾ø´Â, ¹«µò, °¡ÀåÀÚ¸®(¸ğ¼­¸®)°¡ ¾ø´Â
edgeoftheseat : a, ÀÚ½Åµµ ¸ğ¸£°Ô ÁÂ¼®¿¡¼­ ¸öÀ» ÀÏÀ¸Å³ Á¤µµÀÇ (±¤°æ µî)
edger : n, °¡¸¦ Àß¶ó³»´Â Åé, °¡ÀåÀÚ¸® ¸¶¹«¸®°ø
edge tool : x, Ä®ºÙÀÌ, ³¯ºÙÀÌ
edgeways : ad, ³¯(°¡ÀåÀÚ¸®, ³¡)À» ¹ÛÀ¸·Î ´ë°í, (µÎ ¹°°ÇÀÌ)³¡°ú ³¡À» ¸Â´ë°í
edging : n, °¡¼±, °¡ÀåÀÚ¸®ÀÇ Àå½Ä
edging shears : x, ÀÜµğ °¡À§
edgy : a, ³¯ÀÌ ³¯Ä«·Î¿î, (±¸)ÃÊÁ¶ÇÑ, ½Å¶öÇÑ, , (±×¸² µîÀÇ)À±°ûÀÌ ¶Ñ·ÇÇÑ
edh, : n, ¿¡µåÀÚ(°í´ë ¿µ¾î ÀÚ¸ğÀÇ ÇÏ³ª)
edibility : n, ½Ä¿ë¿¡ ¾Ë¸ÂÀ½, ¸ÔÀ» ¼ö ÀÖÀ½
edible : a, ¸ÔÀ»¼öÀÖ´Â, ½Ä·áÇ°
edict : n, Ä¢·É, ¹ı·É, Æ÷°í
edification : n, ±³È­
edifice : n, °Ç¹°, Á¶Á÷, Ã¼°è
edifice complex : x, °Å´ë °ÇÃà ÁöÇâ(ÇàÁ¤°èÈ¹ÀÌ³ª °ÇÃà°¡ÀÇ ±¸»ó µîÀÌ)
edify : vt, ±³È­ÇÏ´Ù, °³¹ßÇÏ´Ù
edifying : a, ±³ÈÆÀÌ µÇ´Â, À¯ÀÍÇÑ
edile : n, =AEDILE
Edin, : x, Edinburgh
Edinburgh : n, ¿¡µò¹ö·¯(½ºÄÚÆ²·£µåÀÇ ¼öµµ)
Edison : n, ¹Ì±¹ÀÇ¹ß¸í°¡
edit : vt, n, ÆíÁıÇÏ´Ù, »èÁ¦ÇÏ´Ù, ÇÊ¸§ÆíÁı, »ç¼³
edit, : x, edited, edition, deitor
Edith : n, ¿©ÀÚ ÀÌ¸§
editing terminal : x, (Àü»ê)ÆíÁı ´Ü¸» ÀåÄ¡(TextÆíÁı¿ë ÄÄÇ»ÅÍ ÀÔÃâ·Â ÀåÄ¡)
edition : n, È£È­ÆÇ
editionalize : vi, (½Å¹®À»)ÆÇÁ¦·Î ¹ßÇàÇÏ´Ù
edition binding : x, (Á¦º»)¹ÌÀå Á¦º»(Àå½ÄÀû Ã¼Á¦¸¦ Áß¿ä½ÃÇÔ)
edition de luxe : x, (F)È£È­ÆÇ
editio princeps : n, (L)ÃÊÆÇ
editiorialist : n, (½Å¹®ÀÇ)³í¼³À§¿ø
editor : n, ÆíÁıÀÚ(chief~ÆíÁı ÁÖ°£, ÁÖÇÊ)
editorial : n, a, »ç¼³, ³í¼³, ÆíÁıÀÚÀÇ(editorial staff ÆíÁıÁø)
editorial advertising : x, ±â»çÃ¼ ±¤°í
editorialization : n, 
editorialize : vt, ...»ç¼³·Î ¾²´Ù
editorially : ad, »ç¼³·Î
editorial matter : x, (±¤°í)ÆíÁı ±â»ç¸é
editorship : , ÆíÁıÀÚÀÇ ÁöÀ§
editress : n, EDITORÀÇ ¿©¼ºÇü
edly : suf, -ED·Î ³¡³ª´Â ´Ü¾îÀÇ ºÎ»ç ¾î¹Ì
Edm, : x, Edmond, Edmund
Edmond, : n, ³²ÀÚ ÀÌ¸§
Edna : n, ¿©ÀÚ ÀÌ¸§
EDP : x, electronic data processing
EDPM : x, electronic data processing machine ÀüÀÚ µ¥ÀÌÅÍ Ã³¸® ±â°è
EDPS : x, electronic data processing systemÀüÀÚ µ¥ÀÌÅÍ Ã³¸® Á¶Á÷
EDR : x, European Depository ReceiptÀ¯·´ ¿¹Å¹ Áõ±Ç
eds, : x, editors
EDTA : x, ethylenediaminetetra acetic acid(È­)¿¡Æ¿·»µğ¾Æ¹Î »çÃÊ»ê(Ç÷¾× ÀÀ°í ¹æÁöÁ¦)
educ, : x, educated, education, educational
educability : n, ±³À°ÀÇ °¡´É¼º
educable : a, ±³À°ÇÒ ¼ö ÀÖ´Â
educate : vt, ±³À°ÇÏ´Ù, ¾ç¼ºÇÏ´Ù, ÈÆ·ÃÇÏ´Ù
educated : a, ±³À°¹ŞÀº, ±³¾ç ÀÖ´Â, (±¸)Áö½Ä(°æÇè)¿¡ ÀÇÇÑ
educatee : n, ÇĞ»ı ÇÇ±³À°ÀÚ
education : n, ±³À°, ÈÆµµ, ¾çÀ°
educational : a, ±³À°»óÀÇ, ±³À°ÀûÀÎ, educationally, ad
educationalindustrial complex : v, ½ÅÇĞ ¿îµ¿
educational park : x, ÇĞ¿øµµ½Ã
educational psychology : x, ±³À° ½É¸®ÇĞ
educational technology : x, ±³À° °øÇĞ
educational television : x, (¹Ì)±³À° ÅÚ·¹ºñÁ¯(ÇÁ·Î)
educationese : n, ±³À° °ü°èÀÚ ¿ë¾î(¾î¹ı)
educationist : n, ±³À°°¡, ±³À°ÇĞÀÚ
education tax : x, =EIPLOMA TAX
educative : a, ±³À°ÀûÀÎ
educator : n, ±³À°ÀÚ(°¡), ±³»ç, (µ¿¹°À»)±æµéÀÌ´Â »ç¶÷
educatory : a, ±³À°¿¡ µµ¿òÀÌ µÇ´Â, ±³À°ÀûÀÎ, ±³À°(»ó)ÀÇ
educe : vt, »©¾î³»´Ù, Ãß·ĞÇÏ´Ù, ÃßÃâÇÏ´Ù
educible : a, ÃßÃâ(¿¬¿ª)ÇÒ ¼ö ÀÖ´Â, ÀÌ²ø¾î³¾ ¼ö ÀÖ´Â
educrat : n, (¹Ì)±³À° ÇàÁ¤°¡, ±³À° °ü·á
educt : n, ÃßÃâ¹°, (È­)À¯¸®Ã¼
eduction : n, ²ø¾î³¿, °è¹ß, Ãß´Ü, ¹èÃâ, ÃßÃâ, ÃßÃâ¹°
eduction pipe : x, (±â)¹è±â°ü
eduction valve : x, (±â)¹è±âÆÇ
eductive : a, ²ø¾î³»´Â, Ãß·Ğ(Ãß´Ü)ÇÏ´Â
edulcorate : vt, ½Å¸À(Â§¸À, ¶µÀº ¸À)À» »©´Ù, ¿ì·Á³»´Ù, ´Ş°ÔÇÏ´Ù, (È­)°¡¿ë¼º ¹°Áú(È¥ÇÕ¹°)À» ÃßÃâÇÏ´Ù
Edw, : x, Edward, Edwin
Edward : n, ³²ÀÚÀÌ¸§
Edwardian : a, n, È­·ÁÇÑ °í»óÇÔÀ» »Ì³½ ¿µ±¹ ¿¡µå¿öµå 7¼¼ ½Ã´ëÀÇ »ç¶÷
Edwards Air Force Base : x, (¹Ì)¿¡µå¿öµå °ø±º±âÁö(Ä¶¸®Æ÷´Ï¾ÆÁÖ ¼ÒÀç, Ç×°ø Å×½ºÆ® ¼¾ÅÍ°¡ ÀÖÀ½)
Edward the Confessor : n, ¿¡µå¿öµå ÂüÈ¸¿Õ
Edwin : n, ³²ÀÚ ÀÌ¸§
Edwina : n, ¿©ÀÚ ÀÌ¸§
ee : x, (¼Ó)YEÀÇ »ı·«Çü
ee : suf, ÇàÀ§ÀÚ¸¦ ³ªÅ¸³»´Â ¸í»ç ¾î¹ÌÀÇ -or¿¡ ´ëÇÏ¿© º¸Åë ±× ÀÛ¿ëÀ» (¹Ş´Â »ç¶÷)ÀÇ ¶æ
ee : suf, Áö¼ÒÀÚ  ¹Ì
EEC : x, European Economic Community(°æ)À¯·´ °æÁ¦ °øµ¿Ã¼, À¯·´ °øµ¿ ½ÃÀå
EEG : x, electroencephalogram(ÀÇ)³úÆÄµµ
eegetic : a, ÁÖ¼®»óÀÇ
eejay : n, =ELECTRONIC JOURNALISM
eek : int, ÀÌÅ©
eel : n, ¹ìÀå¾î, ºóÆ´¾ø´Â»ç¶÷
eel buck : x, (¿µ)¹ìÀå¾î Àâ´Â Åë¹ß
eelgrass : n, °Å¸Ó¸®¸»
eelpot : n, (¹Ì)=EEL BUCK
eelpout : n, ±«¶Ç¶óÁö
eelspear : n, ¹ìÀå¾î ÀÛ»ì
eelworm : n, (µ¿)¼±Ãæ(·ù)
eely : a, ¹ìÀå¾î °°Àº, ¹Ì²ö¹Ì²öÇÑ, ¿ä¸®Á¶¸® Àß ºüÁ®³ª°¡´Â, ºÙÀâÀ» ¼ö°¡ ¾ø´Â, ¸öÀ» ºñºñ ²¿´Â
een : ad, (½Ã)=EVEN
eenie meenie minie mie : int, ÀÌ´Ï ¹Ì´Ï ¸¶ÀÌ´Ï ¸ğ, ´©±¸·Î ÇÒ±î(¼ú·¡Àâ±â¿¡¼­ ¼ú·¡¸¦ Á¤ÇÒ ¶§ µî¿¡ ¾²´Â ¸»)
eensyweensy : a, (¼Ò¾Æ)Á¶±İ, ¾ó¸¶ ¾È µÇ´Â
EENT : x, eye, ear, nose and throat
EEOC : x, (¹Ì)Equal Employment Opportunity Commission
EER : x, energy efficiency ratio(Àü)¿¡³ÊÁö È¿À²ºñ
eer : ad, (¹®¾î)=EVER
eer : suf, (¸í»ç ¾î¹Ì, ¶§·Î °æ¸êÀû), (...°ü°èÀÚ, ...Ãë±ŞÀÚ)ÀÇ ¶æ, (µ¿»ç ¾î¹Ì)(...¿¡ Á¾»çÇÏ´Ù)ÀÇ ¶æ
eerie : a, ¹«½Ã¹«½ÃÇÑ, ¿ä±âÀÖ´Â
eerily : ad, ¹«½Ã¹«½ÃÇÏ°Ô, ¹«¼­¿öÇÏ¿©, ºÒ°¡»çÀÇÇÏ°Ô
eeriness : n, ±âºĞ ³ª»İ, ¹«½Ã¹«½ÃÇÔ
EEZ : x, exclusive economic zone Àü°ü °æÁ¦ ¼ö¿ª
ef : n, ¾ËÆÄºªÀÇ F
ef- : pref, =EX
efaculation : n, Àı±Ô, »çÃâ, »çÁ¤
eff : vt, vi, (¼Ó)¼º±³ÇÏ´Ù, 
eff, : x, efficiency
effable : a, (°í)¸»(¼³¸í)ÇÒ ¼ö ÀÖ´Â
efface : vt, Áö¿ì´Ù, »èÁ¦ÇÏ´Ù, Á¸Àç¸¦ Èñ¹ÌÇÏ°Ô ¸¸µé´Ù(efface oneself ´«¿¡ ¶çÁö ¾Ê°Ô ÇÏ´Ù, Ç¥¸é¿¡¼­ ¹°·¯³ª´Ù)
effacement : n, ¸»¼Ò, ¼Ò¸ê
effect : n, vt, °á°ú, ¿µÇâ, È¿°ú, À¯È¿, ´À³¦, ÀÎ»ó, ºû±òÀÇ ¹èÇÕ, ÃëÁö, ´ëÀÇ, ¿Ü°ü, °á°ú¸¦ °¡Á®¿À´Ù, , ´Ù, ¸ñÀûÀ» ÀÌ·ç´Ù
effecter : n, =EFFECTOR
effectivate : vt, ½Ç½ÃÇÏ´Ù
effective : a, n, À¯È¿ÇÑ, È¿°úÀûÀÎ, ÀÎ»óÀûÀÎ, »ç½Ç»óÀÇ, ½ÇÁ¦ÀÇ, È¿·ÂÀÖ´Â, µ¿¿ø°¡´ÉÇÑ, º´·Â, ´«¿¡ ¶ç´Â
effective aperture : x, (±¤)(·»ÁîÀÇ) À¯È¿ ±¸°æ
effective demand : x, (°æ)À¯È¿ ¼ö¿ä
effective exchange rate : x, (±İÀ¶)½ÇÈ¿ È¯½Ã¼¼(È¯À²)(±¹Á¦ÅëÈ­±â±İÀÌ ´çÇØ±¹°ú ´Ù¸¥ ÁÖ¿ä 20°³±¹ ÅëÈ­ÀÇ È¯½Ã¼¼¸¦ º¹ÇÕ½ÃÄÑ »êÃâÇÏ´Â Áö¼ö)
effectively : ad, À¯È¿ÇÏ°Ô, ½ÇÁ¦»ó
effective money (coin) : x, °æÈ­
effectiveness : n, À¯È¿(¼º), È¿°úÀûÀÓ
effective range : x, (°ø)À¯È¿ »ç°Å¸®(»çÁ¤)
effector : n, È¿°ú±â(½Å°æ ÀÚ±ØÀ» ¹Ù´Ù ÀÛ¿ëÇÏ´Â ¸»ÃÊ Á¶Á÷)
effectual : a, È¿°úÀûÀÎ, À¯È¿ÇÑ, À¯·ÂÇÑ
effectuate : a, À¯È¿ÇÏ°ÔÇÏ´Ù, ÀÌ·ç´Ù, ´Ş¼ºÇÏ´Ù
effectuation : n, ´Ş¼º, ¼öÇà, (¹ı·ü µîÀÇ)½Ç½Ã
Effel Tower : n, ¿¡ÆçÅ¾
effeminacy : n, ¿©ÀÚ °°À½, ³ª¾à, À¯¾à, ¿ìÀ¯ ºÎ´Ü
effeminate : a, ¿¬¾àÇÑ, ¿©ÀÚ°°Àº
effendi : n, Sir¿¡ ÇØ´çÇÏ´Â ÅÍÅ°ÀÇ °æÄª, ±×·¸°Ô ºÒ¸®¿ì´Â »ç¶÷(ÇĞÀÚ, ÀÇ»ç, °ü¸®µî)
efferent : a, n, (»ı¸®)(½Å°æÀÌ)¿ø½É¼ºÀÎ, (Ç÷°üÀÌ)¼öÃâ(µµÃâ)¼ºÀÎ, ¼öÃâ°ü, ¿ø½É¼º ½Å°æ, ¹æÁ×, È£¼ö µî¿¡¼­ ³ª¿À´Â ¹°ÁÙ±â
effervesce : vi, (Åº»ê¼ö µîÀÌ)ºÎ±ÛºÎ±Û °ÅÇ°ÀÌ ÀÏ´Ù, (°¡½º µîÀÌ)°ÅÇ°ÀÌ µÇ¾î ³ª¿À´Ù, (»ç¶÷ÀÌ)ÈïºĞÇÏ´Ù
effervesce : vi, °ÅÇ°ÀÌÀÏ´Ù, ºñµîÇÏ´Ù, µé¶ß´Ù, ÈïºĞÇÏ´Ù
effervescent : a, ºñµî¼ºÀÇ, °ÅÇ°ÀÌ ÀÌ´Â, ÈïºĞÇÑ, È°±â ÀÖ´Â
effete : a, ³ë¼èÇÑ, »ı»ê·ÂÀ» ÀÒÀº, ¹«·ÂÇØÁø
efficacious : a, À¯È¿ÇÑ
efficacy : n, È¿·Â
efficiency : n, ´É·ü, ´É·Â, È¿·Â, È¿À²
efficiency apartment : x, °£ÀÌ ¾ÆÆÄÆ®(ºÎ¾ı°ú °Å½Ç °â Ä§½Ç·Î µÈ)
efficiency engineer : x, °æ¿µ ´É·ü Àü¹®È­
efficient : a, È¿°úÀÖ´Â, À¯´ÉÇÑ, ´É·üÀûÀÎ
efficient market hypothesis : x, (Áõ±Ç)È¿À²Àû ½ÃÀå °¡¼³(»õ·Î¿î Á¤º¸ÀÇ ÁÖ°¡¿¡ÀÇ ¹İÀÀÀº µ¿½ÃÀûÀÌ¶õ °¡¼³)
Effie : n, ¿©ÀÚ ÀÌ¸§, ¿¡ÇÇ»ó(¹Ì±¹ ¸¶ÄÉÆÃ ÇùÈ¸°¡ ¸Å³â ¼±Á¤ÇÏ´Â ÃÖ¿ì¼ö ±¤°í»ó)
effigial : a, ÃÊ»ó(ÀÎÇü)ÀÇ, ÃÊ»ó(ÀÎÇü)À» ´àÀº
effigy : n, »ó, ÃÊ»ó(in effigy¾Æ¹«ÀÇ ÀÎÇüÀ» ¸¸µé¾î¼­ È­Çü¿¡ Ã»ÇÏ´Ù(¾ÇÀÎ µûÀ§¿¡ ´ëÇÑ ÀúÁÖ·Î))
efflor, : x, efflorescent
effloresce : vi, n, ²ÉÇÇ´Ù, ¹ø¿µÇÏ´Ù, Ç³È­ÇÏ´Ù, Ç¥¸é¿¡ ²É°ú °°Àº ¿°ºĞÀÌ »Õ¾î³ª¿À´Ù
efflorescence : n, °³È­±â, Ç³È­, ¹ßÁø
efflorescent : a, ²ÉÀÌ ÇÉ, (È­)Ç³È­¼ºÀÇ
effluence : n, (±¤¼±, Àü±â, ¾×Ã¼ µîÀÇ)³»»ÕÀ½, ¹ß»ê, ¹æÃâ, Èê·¯³ª¿È, À¯Ãâ(¹æÃâ)
effluent : a, n, À¯ÃâÇÏ´Â, À¯Ãâ¹°, À¯Ãâ, ¹æÃâ
effluvial : a, ¾ÇÃëÀÇ
effluvium : n, ¹ß»ê±â, µ¶±â, ¾ÇÃë
efflux : n, À¯Ãâ, ¹ß»ê, ½ÃÀÏÀÇ °æ°ú, ¸¸±â
effort : n, ³ë·Â, ¼ö°í, ³ë·ÂÀÇ ¼º°ú, ¿ªÀÛ, ÀÛ·Â, ÁÖ·Î ¸ğ±İ µîÀÇ ¿îµ¿
effortful : a, ³ë·ÂÀÌ ÇÊ¿äÇÑ, ¾ïÁö·Î ²Ù¹Î, ºÎÀÚ¿¬½º·±, effortfully, ad
effortless : a, ³ë·ÂÇÏÁö ¾Ê´Â, ÈûµéÁö ¾Ê´Â, ½¬¿î, effortlessly, ad, effortlessness, n
effrontery : n, »·»·½º·¯¿ò
effulgece : n, ±¤ÈÖ
effulgent : a, ºû³ª´Â
effuse : vt, vi, À¯ÃâÇÏ´Ù, Åä·ÎÇÏ´Ù
effusion : n, ¾×Ã¼, Çâ±â µûÀ§ÀÇ À¯Ãâ, ¹ß»ê, °¨Á¤ÀÇ Åä·Î, ¹ß·Î
effusive : n, ³ÑÄ¡´Â, ³ÑÄ¥ µíÇÑ, °¨Á¤À» °ÅÃ¢ÇÏ°Ô ³ªÅ¸³»´Â
eft : n, ¿µ¿ø
EFT(S) : x, electronic funds transfer (system) ÀüÀÚ½Ä ÀÚ±İ ÀÌµ¿(½Ã½ºÅÛ)
EFTA : x, European Free Trade Association À¯·´ ÀÚÀ¯ ¹«¿ª ¿¬ÇÕ
eftsoon : ad, ´Ù½Ã, ¾ó¸¶¾ÈÀÖ¾î, °¡²û
Eg, : x, Egypt, Egyptology
egad : int, (°í, ÀÍ»ì)Àú·±, ¾î¸Ó³ª, Á¤¸», ¹¹¶ó°í
egalit'e : n, (F)Æòµî
egalitarian : n, a, ÆòµîÁÖÀÇÀÚ, ÆòµîÁÖÀÇÀÇ
Egbert : n, ³²ÀÚ ÀÌ¸§, ¿¡±×¹öÆ®
egest : vt, (»ı¸®)...À»(Ã¼³»·Î ºÎÅÍ)¹è¼³(¹èÃâ)ÇÏ´Ù
egg : n, ¾Ë, ´Ş°¿=EGG CELL, (¼Ó)ÅõÇÏ ÆøÅº, ³ğ, ³à¼®
egg : vt, °İ·ÁÇÏ´Ù, ºÎÃß±â´Ù(urge)
egg alyer : x, Æø°İ±â
eggandspoon race : n, ½ºÇ¬·¹ÀÌ½º
egg apple : x, =EGGPLANT
eggar : n, ¼Ö³ª¹æ
eggbeater : n, ´Ş°¿ ±³¹İ±â, Çï¸®°öÅÍ
eggbound : a, (»õ, ¹°°í±â µîÀÌ)¾ËÀ» ¸ö¿¡¼­ ¶¿ ¼ö ¾ø´Â ¾Ë¿¡ ¾ô¸ÅÀÎ
egg cell : x, ³­¼¼Æ÷, ³­ÀÚ
egg container : x, (ÇÃ¶ó½ºÆ½Á¦ µîÀÇ)´Ş°¿ ¿ë±â, ´Ş°¿ ÆÇ(´ë¼Ò¸¦ ºÒ¹®ÇÑ ´Ş°¿ ¿ë±âÀÇ ÃÑÄª)
egg cozy : x, »îÀº ´Ş°¿ µ¤°³(º¸¿Â¿ë)
eggcrate : n, Ä­¸·ÀÌ ´Ş°¿ Æ÷Àå »óÀÚ, Àß°Ô ±¸È¹µÈ ¹Ì´Ã»ì(Àüµîºû ¹İ»ç¿ë)
egg cream : x, (¹Ì)¿ìÀ¯, Çâ·á, ½Ã·´, ¼Ò´Ù¸¦ ¼¯Àº À½·á
eggcup : n, »îÀº ´Ş°¿ ÄÅ
egg custard : x, ´Ş°¿, ¼³ÅÁ, ¿ìÀ¯·Î ¸¸µç °úÀÚ
egg dance : x, ´Ş°¿ Ãã(Èğ¾î ³õÀº ´Ş°¿ »çÀÌ¿¡¼­ ´«À» °¡¸®°í Ãß´Â Ãã), ¸Å¿ì ¾î·Á¿î ÀÏ
egger : x, =EGGAR
egg flip : x, =EGGNOG
egg foo yong : x, (¹Ì)ÁßÈ­¿ä¸®½Ä ¿À¹É·¿
egghead : n, ÀÎÅÚ¸®, Áö¼ºÀÎ, ´ë¸Ó¸®
eggheaded : a, (±¸)EGGHEAD°°Àº, eggheadedness, n
eggnog : n, ¿¡±×³ë±×(´Ş°¿, ¿ìÀ¯, ¼³ÅÁ¿¡ Æ÷µµÁÖ, ºê·£µğ¸¦ Åº À½·á)
egg plant : n, °¡Áö, ¿­¸Å
egg roll : x, (¿ä¸®)(ÁßÈ­¿ä¸®ÀÇ)¾ßÃ¤, °í±âÀÇ ´Ş°¿¸»ÀÌ
egg rolling : x, ºÎÈ°Àı¿¡ Easter eggs¸¦ ±¼¸®´Â ³î¸®(±úÁö ¾Ê°í ±¼¸®´Â ÀÚ°¡ ÀÌ±è)
egg separator : x, ³­È² ºĞ¸®±â
eggshaped : n, ¾Ë(´Ş°¿)²®Áú
eggshell : n, a, ´Ş°¿ ²®Áú, ±úÁö±â ½¬¿î °Í, ¾ã°í ºÎ¼­Áö±â ½¬¿î
egg slice : x, ¿À¹É·¿À» ¶ß°Å³ª µÚÁı´Â ±â±¸
eggs over light : x, (¿ä¸®)°è¶õ ÇÁ¶óÀÌÀÇ ÇÑ°¡Áö(¾ËÀÇ ³ë¸¥ÀÚÀ§¸¦ ±úÁö ¾Ê°í ¾ÕµÚ·Î µÚÁı¾î ÀÍÈù ÇÁ¶óÀÌ)
egg spoon : x, »îÀº ´Ş°¿À» ¸Ô´Â ÀÛÀº ¼ù°¡¶ô
eggs sunnyside up : x, (¿ä¸®)°è¶õ ÇÁ¶óÀÌÀÇ ÇÑ°¡Áö(¾ËÀ» µÚÁıÁö ¾Ê°í, ³ë¸¥ÀÚÀ§°¡ ¹İ¼÷ÀÌ µÇµµ·Ï ÀÍÈù ÇÁ¶óÀÌ)
egg stand : x, ´Ş°¿ ½ºÅÄµå
eggsucker : n, (¼Ó)¾ÆÃ·ÇØ¼­ ¼º°øÇÏ·Á´Â »ç¶÷, °£»ìÀïÀÌ, ¾ÆÃ·²Û
egg timer : x, ´Ş°¿ »î´Â ½Ã°£À» Àç´Â ¾à 3ºĞ Á¤µµÀÇ(¸ğ·¡)½Ã°è
egg tooth : x, ³­Ä¡(»õ, ÆÄÃæ·ùÀÇ »õ³¢°¡ ¾ËÀ» ±ú°í ³ª¿Ã ¶§¿¡ ¾²´Â ºÎ¸®ÀÇ ³¡)
egg transfer : x, (ÀÇ)³­ÀÚ ÀÌ½Ä(¼ö¼ú)
egg transfer baby : x, (ÀÇ)¼öÁ¤¶õ ÀÌ½Ä¾Æ
egg whisk : x, =EGGBEATER
egg white : x, ¿ä¸®¿ëÀÇ ´Ş°¿ ÈòÀÚÀ§
egis : n, =AEGIS
eglantine : n, µéÀå¹Ì
ego : n, ÀÚ¾Æ, ÀÚºÎ½É
egocentric : a, ÀÚ±âÁß½ÉÀÇ
ego ideal : x, ÀÚ¾Æ ÀÌ»ó
egoism : n, ÀÌ±âÁÖÀÇ, ÀÚºÎ
egoist : n, (À±)ÀÌ±âÁÖÀÇÀÚ, ÀÚ±â º»À§ÀÇ »ç¶÷, Á¦¸Ú´ë·Î ÇÏ´Â »ç¶÷, ÀÚºÎ½ÉÀÌ °­ÇÑ »ç¶÷
egoistic : a, ÀÌ±âÁÖÀÇÀÇ, ÀÚ±â º»À§ÀÇ, Á¦¸Ú´ë·ÎÀÇ ¾Æ¿åÀÌ °­ÇÑ, egoistically, ad
egoistic hedonism : x, (À±)°³ÀÎÀû Äè¶ô¼³(ÇàÀ§ °áÁ¤ÀÇ µ¿±â´Â ÁÖ°üÀû Äè¶ôÀÌ¶ó´Â ¼³)
egoistism : n, ÀÚ±âÁß½Éº®(È¸¿Í, ¹®ÀåÁß¿¡ I my me¿¬¹ßÇÏ´Â ¹ö¸©)
egomania : n, ÀÌ»óÀÚ±âÁß½Éº®, º´ÀûÀÚºÎ½É
egomaniac : n, º´Àû(±Ø´ÜÀû)À¸·Î ÀÚ±â Áß½ÉÀûÀÎ, »ç¶÷, ±Ø´ÜÀûÀ¸·Î ÀÚÁ¸½ÉÀÌ °­ÇÑ »ç¶÷
egosphere : n, ÀÚ¾Æ ¿µ¿ª
egostate : n, (½É)ÀÚ¾Æ »óÅÂ
egotism : n, ÀÚ±â Áß½Éº®, ÀÚ¸¸, ÀÚºÎ, ÀÌ±âÁÖÀÇ, ÀÚ±âº»À§
egotist : n, ÀÚ±â Áß½É ÁÖÀÇÀÚ, ÀÚÁ¸°¡
egotistic : a, ÀÚ±â Áß½É(º»À§)ÀÇ, µ¶¼±ÀûÀÎ, ÀÌ±âÀûÀÎ
egotize : vi, Á¦ÀÚ¶ûÇÏ´Ù, ÀÚ±â ÀÏ¸¸ ¸»ÇÏ´Ù
ego trip : x, (±¸)ÀÌ±âÀû(ÀÚ±â º»À§Àû)ÇàÀ§
egotrip : vi, Á¦¸Ú´ë·Î(ÀÚ±â Áß½ÉÀûÀ¸·Î)Çàµ¿ÇÏ´Ù
egregious : a, ÅÍ¹«´Ï¾ø´Â, Áöµ¶ÇÑ, ¾ûÅÍ¸®¾ø´Â
egress : n, ¿ÜÃâ, ¹ÛÀ¸·Î ³ª°¨, Ãâ±¸, ¹èÃâ±¸
egression : n, ¿ÜÃâ, (Ãµ)=EMERSION
egret : n, Å«ÇØ¿À¶ó±â
Egypt : n, ÀÌÁıÆ®
Egypt, : x, Egyptian
Egyptian : a, n, ÀÌÁıÆ®ÀÇ, ÀÌÁıÆ®»ç¶÷
Egyptian cotton : x, (½Ä)ÀÌÁıÆ®¸ñÈ­
Egyptianization : n, ÀÌÁıÆ®È­
Egyptianize : vt, ÀÌÁıÆ®È­ÇÏ´Ù, ÀÌÁıÆ®ÀÇ ±¹À¯·Î ÇÏ´Ù
Egyptology : n, °í´ëÀÌÁıÆ®ÇĞ
eh : int, ¹¹?, ¿§?, ±×·¸Áö¿ä?
EHP : x, effective horse power À¯È¿ ¸¶·Â, electrical horse power Àü±â ¸¶·Â
EHV : x, extra hogh voltage (Àü)ÃÊ°í¾Ğ
EIB(W) : x, Export Import Bank(of Washington)(¿ö½ÌÅÏ)¼öÃâÀÔ ÀºÇà
eider : n, ¾ÆÀÌ´õ ¿À¸®
eiderdown : ¼ØÅĞ(¾ÆÀÌ´õ ¿À¸®ÀÇ), 
eidetic : a, n, Á÷°üÀûÀÎ, Á÷°ü»óÀÌ º¸ÀÌ´Â »ç¶÷
eidograph : n, ½ÅÃà Ãàµµ±â(¿øÈ­¸¦ ÀÓÀÇ·Î È®´ë, Ãà¼ÒÇÒ ¼ö ÀÖÀ½)
eidolon : n, À¯·É, Çã±úºñ, È¯¿µ, ÀÌ»ó(»ó), ÀÌ»óÈ­µÈ ÀÎ¹°
eigen- : x, (G)(¿¬°áÇü)(°íÀ¯ÀÇ, µ¶Æ¯ÇÑ)ÀÇ ¶æ
eigenvalue : n, °íÀ¯Ä¡
eight : n, a, 8, ¿¡ÀÌÆ®
eight ball : x, 8ÀÌ¶ó°í ¾´ °ËÀº °ø, ¹«ÁöÇâ½Ä±¸Çü ¸¶ÀÌÅ©, ¹Ùº¸, ¾î·Á¿î ÀÔÀå¿¡¼­
eight bit computer : x, (Àü»ê)8ºñÆ® ÄÄÇ»ÅÍ
eighteen : a, 18(°³, ¸í)ÀÇ, 18¼¼ÀÇ
eighteenth : n, a, 18ºĞÀÇ1
eighteenwheeler : n, (¹Ì¼Ó)Æ®·¹ÀÏ·¯ Æ®·°
eighteight : n, (°ÇÀÇ ÃÑ¼ö°¡ 88°³ÀÎ µ¥¼­)(¹Ì¼Ó)ÇÇ¾Æ³ë
eightfold : a, ad, 8¹èÀÇ
eightfold way : x, (¹°)ÆÈµµ¼³(¼ÒÀÔÀÚ ºĞ·ù¹ıÀÇ ÇÏ³ª)
eightfour : a, (¹Ì±³À°)8-4Á¦ÀÇ(ÃÊµî ±³À° 8³â, Áßµî ±³À° 4³âÀÇ)
eighth : n, a, Á¦8ÀÇ, 8ºĞÀÇ 1ÀÇ
eighth note : x, 8ºĞÀ½Ç¥
eighthour : a, 8½Ã°£Á¦ÀÇ
eightieth : a, n, Á¦80ÀÇ, 80ºĞÀÇ1
eightpence : n, (¿µ±¹ÀÇ)8Ææ½º
eightpenny : a, 8Ææ½ºÀÇ
eight rest : x, (¾Ç)8ºĞ ½°Ç¥
eights : n, (¹Ì¼Ó)ÅëÈ­ ³¡
eightscore : n, 160
eightsome : n, 8»ç¶÷ÀÌ Ãß´Â Ãã, ±× ÃãÀ» Ãß´Â 8ÀÎÁ¶
eighttrack : n, 8Æ®·¢ ³ìÀ½ Å×ÀÌÇÁ
eighty : n, a, 80, 80³â´ë
eightyfold : a, ad, 80¹èÀÇ(·Î)
eightysix : vt, (¹Ì¼Ó)(½Ä´ç, ¹Ù µî¿¡¼­ ¼Õ´Ô¿¡°Ô)½Ä»ç, À½·áÀÇ Á¦°øÀ» °ÅÀıÇÏ´Ù, ¼­ºñ½ºÇÏÁö ¾Ê´Ù, (»ç¶÷À»)¹èÃ´ÇÏ´Ù, ¹«½ÃÇÏ´Ù
eikon : n, =ICON
Eileen : n, ¿©ÀÚ ÀÌ¸§
Einstein : n, Albert(1879, 1955)»ó´ë¼º ÀÌ·ĞÀ» Ã¢¼³ÇÑ µ¶ÀÏ ÅÂ»ıÀÇ ¹Ì±¹ ¹°¸®ÇĞÀÚ
Einstein equation : x, (¹°)¾ÆÀÎ½´Å¸ÀÎ ¹æÁ¤½Ä(Áú·®°ú ¿¡³ÊÁö¿ÍÀÇ ¹æÁ¤½Ä)
Einsteinian : a, ¾ÆÀÎ½´Å¸ÀÎ(·ù)ÀÇ, »ó´ë¼º ¿ø¸®ÀÇ
Einstein theory : x, ¾ÆÀÎ½¶Å¸ÀÎÀÇ »ó´ë¼º ¿ø¸®
einstenium : n, ¾ÆÀÎ½´Å¸ÀÌ´½(¹æ»ç¼º ¿ø¼Ò, ±âÈ£ Es)
Eire : n, ¿¡ÀÌ·¹(Republic ofIRELANK µıÀÌ¸§, ±¸Äª)
eirenic : a, ÆòÈ­¸¦ ÃËÁøÇÏ´Â(ÀÌ¹ÙÁöÇÏ´Â), ÁßÀçÀÇ, ÇùÁ¶ÀûÀÎ
eirenicon : n, ÆòÈ­(ÁßÀç)Á¦ÀÇ(Æ¯È÷ Á¾±³»ó ºĞÀï¿¡ ´ëÇÑ)
eisegesis : n, (Æ¯È÷ ¼º¼­ ¿ø¹®¿¡ °üÇÑ)ÀÚ±â ÇØ¼®(ÀÚ½ÅÀÇ »ç»óÀ» °³ÀÔ½ÃÅ² ÇØ¼® µî)
Eisenhower : n, Dwight(1890, 1969)¹Ì±¹ Á¦ 34´ë ´ëÅë·É(1952, 61)¿¡Äª Ike)
eisteddfod : n, ¿µ±¹ WalesÀÇ ¿¹¼úÁ¦
either : a, ad, ¾î´À°ÍÀÎ°¡, ¾î´À°ÍÀÌµçÁö...ÀÌµç°¡ ¶Ç´Â ...ÀÌµç°¡...µµ ¶ÇÇÑ
eitheror : a, ¾çÀÚÅÃÀÏÀÇ
eithteenmo : n, 18Àı(ÆÇ)
ejaculate : vt, vi, °©ÀÚ±â¼Ò¸®Áö¸£´Ù, ¾×Ã¼¸¦ »çÃâÇÏ´Ù
ejaculator : n, °©ÀÚ±â ¿ÜÄ¡´Â »ç¶÷, (ÇØ)»çÃâ±Ù, »çÁ¤±Ù
ejaculatorium : n, (Á¤ÀÚ ÀºÇàÀÇ)Á¤ÀÚ Ã¤Ãë½Ç, »çÁ¤½Ç
ejaculatory : a, 
eject : vt, ºĞÃâÇÏ´Ù, ÅäÇØ³»´Ù, ÂÑ¾Æ³»´Ù
ejecta : n, È­»ê µîÀÇ ºĞÃâ¹°
ejection : n, ¹æÃâ, ºĞÃâ, ¹èÃâ, ¹æÃâ¹°, (¹ı)(ÅäÁö, °¡¿Á¿¡¼­ÀÇ)¹æÃà, Åğ°Å
ejection capsule : x, ·ÎÄÏÀÇ ¹æÃâ Ä¸½¶
ejection seat : x, ±ä±Ş Å»Ãâ¿ë »çÃâ ÁÂ¼®
ejective : a, ¹æÃâÇÏ´Â, ¹æ»çÇÏ´Â, ¸ô¾Æ³»´Â, (À½¼º)¹æÃâÀ½ÀÇ
ejectment : n, ¹æÃâ, Ãß¹æ, ¹æÃà, ¸ô¾Æ³¿, (¹ı)ºÎµ¿»ê Á¡À¯ È¸º¹ ¼Ò¼Û
ejector : n, ejectÇÏ´Â »ç¶÷, ¹èÃâ±â°ü
ejector seat : x, =EJECTION SEAT
eka- : x, (¿¬°áÇü)(È­)(¹ÌÁöÀÇ ¿ø¼Ò¸í¿¡ »ç¿ëÇÏ¿©)(ÁÖ±âÀ²Ç¥ÀÇ µ¿Á·³­¿¡¼­...ÀÇ ¹Ø¿¡ ¿Í¾ß ÇÒ ¿ø¼Ò)ÀÇ ¶æ
eke : vt, ad, º¸ÃæÇÏ´Ù, ²Ù·Á³ª°¡´Ù...µµ ¶ÇÇÑ, ±×¸®°í ¶Ç
EKG : x, Electrokardiogramme(G=electrocardiogram)
ekistics : n, »ıÈ°µµ½Ã°èÈ¹ÇĞ
Ekman layer : x, (ÇØ¾ç)¿¡Å©¸¸(ÇØ·ù)Ãş(ÇØ¾çÀÇ Èå¸£´Â ¹æÇâÀÌ Ç³Çâ°ú 90µµ¸¦ ÀÌ·ç´Â Ãş)
el : n, LÀÚ, °í°¡ Ã¶µµ
el, : x, elected, elevation
elaborate : a, vt, °øµéÀÎ, ¸é¹ĞÇÑ, ÈûµéÀÎ, ¾Ö½á¼­ ¸¸µé¾î³»´Ù, Åğ°íÇÏ´Ù, Á¤¼ºµé¿©, ¸é¹ĞÇÏ°Ô
elaborately : ad, Á¤¼ºµé¿©, ¸é¹ĞÇÏ°Ô
elaboration : n, ¸é¹ĞÇÑ ¸¶¹«¸®, Åğ°í, ¿ªÀÛ
elaborative : a, °øµéÀÎ
elaborator : n, °í½ÉÇÏ¿©(Á¤¼ºµé¿©)¸¸µå´Â »ç¶÷, (¹®ÀåÀ»)Åğ°íÇÏ´Â »ç¶÷
elaeometer : n, Áö¹æ ºñÁß°è, ¿Ã¸®ºêÀ¯°è
Elaine : n, ¿©ÀÚ ÀÌ¸§
EL AL(Israel Airlines) : x, ¿¤¾ËÀÌ½º¶ó¿¤ Ç×°ø(ÀÌ½º¶ó¿¤ Ç×°ø È¸»ç)
Elam : n, ¿¤¶÷(Æä¸£½Ã¾Æ¸¸ ºÏÂÊÀÇ Áö¿ª¸í, ±×°÷¿¡ ÀÖ¾ú´ø °í´ë ¿Õ±¹)
Elamite : a, n, ¿¤¶÷ÀÇ, ¿¤¶÷»ç¶÷(¸»)ÀÇ, ¿¤¶÷ »ç¶÷, ¿¤¶÷ ¸»
elan : n, ¿­ÀÇ, ¿¹±â, ¾àÁø
eland : n, ¾ÆÇÁ¸®Ä« Å«¿µ¾ç
elan vital : n, (F)(Ã¶)»ı¸íÀÇ ºñ¾à, »ıÀÇ ¾àµ¿
elapid : a, n, (µ¿)ÄÚºê¶ó°úÀÇ(µ¶»ç)
elapse : vi, °æ°úÇÏ´Ù
elapsed time : x, °æ°ú ½Ã°£(Å¸ÀÓ)(º¸Æ®³ª ÀÚµ¿Â÷ÀÇ ÀÏÁ¤ ÄÚ½ºÀÇ ÁÖÇà ½Ã°£)
elasmobranch : n, a, (¾î)ÆÇ»õ·ù(ÀÇ), ¿¬°ñ¾î·ù(ÀÇ)(»ó¾î, °¡¿À¸® µî)
elastic : a, n, Åº·ÂÀÖ´Â, ³¶Ã¢ÇÑ, °æÄèÇÑ, ¹àÀº, À¶Åë¼ºÀÖ´Â, °í¹«ÁÙ
elastic band : x, (¿µ)°í¹« ¹êµå
elastic clause : x, (¹ÌÇå¹ı)½ÅÃà(Åº·Â)Á¶Ç×(ÀÇÈ¸ÀÇ ÀáÀçÀû ±ÇÇÑÀ» ±ÔÁ¤ÇÏ´Â °Í)
elasticity : n, Åº·Â, ½ÅÃà¼º, (¹°)Åº¼º, ºÒÇà¿¡¼­ ÀÏ¾î¼­´Â Èû, À¶Åë¼º, ¼øÀÀ¼º, ÄèÈ°ÇÔ
elasticize : vt, (°í¹«ÁÙ µîÀ» ³Ö¾î¼­)...¿¡ Åº¼º(½ÅÃà¼º)À» °®°Ô ÇÏ´Ù, elasticized, a
elastic limit : x, (¹°)Åº¼º ÇÑ°è
elastic modulus : x, (¹°)Åº¼º·ü
elastic sides : x, (¿¾³¯ °í¹« ÀåÈ­ÀÇ)¾çÂÊÀÇ(´ÜÃß³ª ²ö ´ë½Å¿¡ ´Ü)°í¹« Ãµ, °í¹« ÀåÈ­
elastin : n, ¿¤¶ó½ºÆ¾, Åº·Â¼Ò(´Ü¹éÁúÀÇ ÀÏÁ¾)
elastohydrodynamics : n, À¯Ã¼Åº¼º ¿ªÇĞ, °¡¾Ğ¾×Ã¼ Åº¼ºÇĞ
elastomer : n, Åº¼º¹°Áú
elastometer : n, Åº·Â°è
Elastoplast : n, (¿µ)±¸±Ş¿ë ¹İÃ¢°íÀÇ ÀÏÁ¾(»óÇ¥¸í)
elate : vt, ±â¿îÀ»ºÏµ¸¿ì´Ù, ÀÇ±â¾ç¾çÇÏ°Ô¸¸µé´Ù
elated : a, ÀÇ±â ¾ç¾çÇÑ(in high spirits)½É¸íÀÌ ³­
elater : n, (½Ä)(Æ÷ÀÚ¸¦ Æ¢°Ü ³»´Â)Åº»ç, ¹æ¾Æ¹ú·¹
elation : n, ÀÇ±â ¾ç¾ç
E layer : x, EÃş(Áö»ó 80, 150 Å³·ÎÀÇ ÇÏÃş Àü¸®Ãş)
Elba : n, ¿¤¹Ù(¼¶)(ÀÌÅ»¸®¾ÆÀÇ ÀÛÀº ¼¶)
Elbe : n, ¿¤º£(°­)(ºÏÇØ·Î Èê·¯µå´Â µ¶ÀÏÀÇ °­)
Elbert : n, ³²ÀÚ ÀÌ¸§
Elberta : n, ¿©ÀÚ ÀÌ¸§
elbow : n, vt, vi, ÆÈ²ŞÄ¡, LÀÚ¸ğ¾çÀÇ ±¼°î, ±â¿ªÀÚ °ü, ÀÇº¹ÀÌ ÆÈ²ŞÄ¡°¡ ¶Õ¾îÁ®, °¡³­ÇÏ¿©, ¸ôµÎÇÏ¿©, ºĞÁÖÇÏ¿©, ÆÈ²ŞÄ¡·Î Âî¸£´Ù
elbowbender : n, (¹Ì±¸)¼úÀ» ¸¶½Ã´Â »ç¶÷, ¼ú²Û, (¹Ì¼Ó)»ç±³ÀûÀÎ(ÄèÈ°ÇÑ)»ç¶÷
elbow bending : x, (±¸)À½ÁÖ
elbowbending : a, (±¸)°úÀ½ÇÏ´Â
elbowboard : n, (ÆÈ²ŞÄ¡¸¦ ±® ¼ö ÀÖ´Â)Ã¢¹® ÅÎ
elbow chair : n, ÆÈ°ÉÀÌÀÇÀÚ
elbow grease : , ÈûµçÀ°Ã¼³ëµ¿
elbowroom : n, ÆÈ²ŞÄ¡¸¦ ÀÚÀ¯·Ó°Ô ³î¸± ¼ö ÀÖ´Â ¿©À¯, È°µ¿ÀÇ ¿©Áö
el cheapo : a, (¹Ì¼Ó)ÇÏÂúÀº, °ª½Ñ
eld : n, (¿µ¹æ)¿¬·É, ³ªÀÌ, (°í, ½Ã)³ë³â, ¿¾³¯
eld, : x, eldest
elder : a, n, ¼ÕÀ§ÀÇ, ¿¬ÀåÀÇ, °íÂüÀÇ, ÀÌÀüÀÇ(elder brother Çü, ´©ÀÌ), ¿¬ÀåÀÚ, °íÂü, Àå·Î, ¿ø·Î
elder : n, ¾çµüÃÑ³ª¹«
elderberry : n, ¾çµüÃÑ³ª¹«ÀÇ ¿­¸Å
elderberry wine : x, ELDERBERRY¿­¸Å·Î ´ã±Ù ¼ú
elder brother : x, (¿µ)¼ö·Î ¾È³» ÇùÈ¸ÀÇ °£ºÎ È¸¿ø
eldercare : n, (¹Ì)³·Àº ¿ä±İÀÇ ³ëÀÎ ÀÇ·á °èÈ¹, ³ëÀÎ ¿¹¹æ Áø·á °èÈ¹(ÀÇ·á º¸Çè Á¦µµÀÇ º¸¿ÏÃ¥)
elder hand : x, =ELDEST HAND
elderly : a, ³ªÀÌ Áö±ßÇÑ, Áß³âÀÇ, ÃÊ·ÎÀÇ
elderly dependency ratio : x, ³ë·ÉÀÚ(ÇÇ)ºÎ¾ç·ü
eldership : n, ¿¬ÀåÀÇ ½ÅºĞ, (Àå·Î ±³È¸ÀÇ)Àå·Î½Ä
elder statesman : x, (Á¤°èÀÇ)¿ø·Î, Àå·Î, (Á¶Á÷, Áı´ÜÀÇ)À¯·ÂÀÚ, ÁßÁø
eldest : a, °¡Àå³ªÀÌ¸¹Àº
eldest hand : x, (Ä«µå³îÀÌ)(ÆĞ µµ¸£´Â »ç¶÷ÀÇ ¿ŞÂÊ¿¡ ÀÖ´Â)Ä«µå¸¦ Ã¹¹øÂ°·Î ¹Ş´Â »ç¶÷
EL Dorado : n, È²±İÀÇ ³ª¶ó, º¸¹°»ê
Eldred : n, ³²ÀÚ ÀÌ¸§
eldritch : a, (½ºÄÚ)¹«½Ã¹«½ÃÇÑ, ¼Ò¸§ÀÌ ³¢Ä¡´Â, ¼¶¶àÇÑ
Eleanor : n, ¿©ÀÚ ÀÌ¸§
Eleatic : n, (Ã¶)¿¤·¹¾Æ ÇĞÆÄÀÇ(»ç¶÷)
elec, : x, electric(al), electrician, electricity, electuary
elecampane : n, (½Ä)¸ñÇâ(¾û°Å½Ã°úÀÇ ½Ä¹°), ¸ñÇâ °úÀÚ(¸ñÇâ³ª¹«¿¡¼­ »ÌÀº Çâ·á·Î ¸¸µê)
elecpowered : a, Àüµ¿ÀÇ
elect : vt, a, »Ì´Ù, ¼±°ÅÇÏ´Ù, »ÌÈù, ´ç¼±µÈ(bride elect ¾àÈ¥ÀÚ(fiancee), president elect (¾ÆÁ÷ ÃëÀÓÇÏÁö ¾ÊÀº)´ç¼± ´ëÅë·É)
electable : a, ¼±Ãâ µÉ ¼ö ÀÖ´Â, ¼±Ãâ(¼±ÅÃ)µÉ ¸¸ÇÑ
electee : n, ¼±Ãâ(¼±ÅÃ)µÈ »ç¶÷
electic blue : x, °­Ã»»ö(¹à°í ±İ¼ÓÀûÀÎ(Â÷°¡¿î)´À³¦ÀÇ Ã»»ö)
election : n, ¼±ÅÃ, ¼±Á¤, ¼±°Å, ¼±ÀÓ
election administration committee : x, ¼±°Å °ü¸® À§¿øÈ¸
election campaign : x, ¼±°Å ¿îµ¿
Election Day : , Á¤ºÎÅë·É ¼±°ÅÀÏ(11¿ù Ã¹Â° ¿ù¿äÀÏ ´ÙÀ½ÀÇ È­¿äÀÏ), ¼±°ÅÀÏ
election district : x, ¼±°Å±¸
electioneerer : n, =ELECTIONEER
electioneering : n, a, ¼±°Å ¿îµ¿, ¼±°Å ¿îµ¿ÀÇ
election law violation : x, ¼±°Å¹ı À§¹İ
election returns : x, ¼±°Å °³Ç¥ º¸°í(¼­)
elective : a, n, ¼±°ÅÇÏ´Â, ¼±°Å¿¡ ÀÇÇÑ, ¼±ÀÓÀÇ(opp, appointive), (ÇÏ°ú°¡)¼±ÅÃÀÇ
elective affinity : x, (È­)(¼±ÅÃ)Ä£È­·Â
elector : n, ¼±°ÅÀÎ, À¯±ÇÀÚ, Á¤ºÎ Åë·É ¼±°Å À§¿ø, ¼±Á¦ÈÄ
electoral : a, ¼±°ÅÀÇ, ¼±Á¦ÈÄÀÇ
electoral college : x, Á¤ºÎÅë·É¼±°ÅÀ§¿øÈ¸
electoral roll(register) : x, ¼±°ÅÀÎ ¸íºÎ
electoral vote : x, °¢ ÁÖ¿¡¼­ ¼±ÃâµÈ ´ëÅë·É ¼±°ÅÀÎ´Ü¿¡ ÀÇÇÑÁ¤ºÎÅë·Ä ¼±°Å
electorate : n, À¯±ÇÀÚ, ¼±°Å¹Î, ¼±Á¦ÈÄ·É
electr, : x, electric(al), electrician, electricity
electr- : x, (¿¬°áÇü)(Àü±âÀÇ, Àü±â¿¡ ÀÇÇÑ)ÀÇ ¶æ(¸ğÀ½ ¾Õ¿¡¼­´Â electr-)
Electra : n, Agamemnon°ú ClytemnestraÀÇ µş(µ¿»ı OrestesÀÇ µµ¿òÀ¸·Î ºÎÁ¤ÇÑ ¾î¸Ó´Ï¿Í ±× Á¤ºÎ¸¦ Á×¿´À½)
Electra complex : x, ¿¤·ºÆ®¶ó ÄŞÇÃ·º½º
electress : n, ¿©¼ºÀ¯±ÇÀÚ
electric : a, Àü±âÀÇ, Àü±â ÀåÄ¡ÀÇ, µÎ±Ù°Å¸®´Â
electrical : a, Àü±âÀÇ, °­·ÄÇÑ
electrical engineer : x, Àü±â(°øÇĞ)±â»ç, Àü±â ±â¼úÀÚ
electrical engineering : x, Àü±â °øÇĞ
electrically : ad, Àü±â(ÀÛ¿ëÀ¸)·Î, Àü±âÇĞ»ó(À¸·Î), Àü°İÀûÀ¸·Î
electrical precipitator : x, Àü±â ÁıÁø ÀåÄ¡
electrical scanning : x, (ÀüÀÚ)Àü±âÀû ÁÖ»ç
electrical storm : x, =ELECTRIC STORM
electrical transcription : x, ³ìÀ½ ¹æ¼Û¿ä(·¹ÄÚµå, Å×ÀÌÇÁ), ³ìÀ½
electric blanket : x, Àü±â ´ã¿ä
electric car : x, Àü±â ÀÚµ¿Â÷
electric chair : x, »çÇü¿ë Àü±â ÀÇÀÚ, Àü±â »çÇü
electric charge : x, ÀüÈ­
electric circuit : x, Àü±â È¸·Î
electric current : x, Àü·ù
electric eel : x, Àü±â¹ìÀå¾î
electric eye : x, ±¤ÀüÁö, ±¤Àü°ü
electric eye camers : x, ÀÚµ¿ ³ëÃâ Ä«¸Ş¶ó
electric field : x, Àü°è
electric fire : x, (¿µ)Àü±â ¹é¿­ È÷ÅÍ
electric furnace : x, Àü±â·Î
electric guitar : x, Àü±â ±âÅ¸
electric hare : x, Àüµ¿½Ä ¸ğÇü Åä³¢(°³ °æÁÖ¿¡¼­ »ç¿ë)
electric heater : x, Àü±â ½ºÅäºê, Àü¿­±â
electrician : n, Àü±â±â¼úÀÚ
electricity : n, Àü±â, Àü·ù, ±ØµµÀÇ
electric light : x, Àü±¤, Àüµî
electric needle : x, Àü±âÄ§
electric news tape : x, Àü±¤ ´º½º
electric organ : x, Àü±â ¿À¸£°£, (Àü±â ¹ìÀå¾î µûÀ§ÀÇ)¹ßÀü±â
electric potential : x, ÀüÀ§
electric power : x, Àü·Â
electric ray : x, ½Ã²ö°¡¿À¸®
electric rocket : x, (·ÎÄÏ)Àü±â ÃßÁø ·ÎÄÏ
electric shaver : x, Àü±â ¸éµµ±â
electric shock : x, °¨Àü, Àü·Â
electric shock therapy : x, (Á¤ÀÇ)Àü±â ¼îÅ©¿ä¹ı
electric steel : x, Àü·Î°­
electric storm : x, ³ú¿ì
electric teeth : x, (¹Ì¼Ó)°æÂû, ÀÚµ¿Â÷ ¼Óµµ ÃøÁ¤ ÀåÄ¡
electric torch : x, È¸ÁßÀüµî
electric towel : x, Àü±â ¿ÂÇ³ °ÇÁ¶±â(È­Àå½Ç µî¿¡¼­ Á¥Àº ¼Õ, ¾ó±¼À» ¸»¸®±â À§ÇÑ °Í)
electric wave : x, ÀüÆÄ
electric wire : x, Àü¼±
electrification : n, 
electrify : vt, Àü±â¸¦ ÅëÇÏ´Ù, °¨Àü ½ÃÅ°´Ù, ÀüÈ­ÇÏ´Ù, ³î¶ó°Ô ÇÏ´Ù, °¨µ¿½ÃÅ°´Ù
electrization : n, =ELECTRIFICATION
electrize : vt, =ELECTRIFY
electro : n, =electrotype, eelectroplate
electro- : x, (¿¬°áÇü), ELECTR-
electroacoustics : n, Àü±â À½ÇâÇĞ
electroacupuncture : n, Àü±â Ä§¼ú(¿ë¹ı), Àü±â Ä§
electroanalysis : n, Àü±âºĞÇØ
electrobath : n, ÀüÁ¶, ÀüÇØÁ¶, Àü¾×(Àü±â µµ±İ¿ë)
electrocardiogram : n, ½ÉÀüµµ
electrocardiograph : n, ½ÉÀü°è
electrocardiography : n, (ÀÇ)½ÉÀüµµ ±â·Ï(°Ë»ç)(¹ı)
electrochemical : a, Àü±â È­ÇĞÀÇ, electrochemically, ad
electrochemist : n, Àü±â È­ÇĞÀÚ
electrochemistry : n, Àü±âÈ­ÇĞ
electrochronograph : n, Àü±â ±â·Ï ½Ã°è
electroconvulsive : a, (Á¤ÀÇ)Àü±â °æ·ÃÀÇ(¿¡ °üÇÑ, À» ¼ö¹İÇÏ´Â)
electroconvulsive therapy : x, =ELECTROSHOCK THERAPY
electrocorticogram : n, ³úÆÄµµ
electrocorticography : n, (ÀÇ)³úÆÄ ÃøÁ¤¹ı(´ë³ú ÇÇÁú¿¡ Á÷Á¢ Àü±ØÀ» Á¢ÃË½ÃÅ°´Â)
electrocute : vt, Àü±â»çÇü¿¡ Ã³ÇÏ´Ù
electrocution : n, °¨Àü»ç, Àü±â »óÇü
electrode : n, Àü±Ø
electrodelic : a, Àü±¤¿¡ ÀÇÇØ È¯°¢ÀûÀÎ È¿°ú¸¦ ³»´Â
electrodeposit : vt, n, (È­)ÀüÂø½ÃÅ°´Ù, ÀüÂø¹°
electrodeposition : n, (È­)ÀüÂø, ÀüÇØ ¼®Ãâ
electrodynamic : a, Àü±â ¿ªÇĞÀÇ
electrodynamics : n, Àü±â ¿ªÇĞ
electrodynamometer : n, Àü±âµ¿·Â°è
electroencephalogram : n, ³úÆÄ, ³úÆÄ±â·ÏÀåÄ¡
electroencephalograph : n, (ÀÇ)³úÆÄ ÀüÀ§ ±â·Ï ÀåÄ¡
electroencephalography : n, (ÀÇ)³úÆÄ ÀüÀ§ ±â·Ï¼ú
electrofishing : n, (¼ö»ê)Àü·ù ¾î¹ı(Á÷·ù Àü¿øÀÇ Áı¾î È¿°ú¸¦ ÀÌ¿ëÇÑ °Í)
electrogasdynamics : n, Àü±â À¯Ã¼ ¿ªÇĞ
electrogenesis : n, Àü±â ¹ß»ı(»ıÃ¼ÀÇ ¼¼Æ÷ Á¶Á÷¿¡¼­ÀÇ ¹ßÀü È°µ¿)
electrogram : n, (ÀÇ)Àü±â ±â·Ïµµ(°î¼±µµ)(½ÅÃ¼ Á¶Á÷ ¼Ó¿¡ Àü±ØÀ» ³Ö¾î ÀÛ¼ºÇÏ´Â È°µ¿ ÀüÀ§µµ)
electrograph : n, ÀüÀ§±â·ÏÀåÄ¡, ÀüÀ§ÆÇ, Á¶°¢±â, »çÁøÀü¼Û±â
electrographic : a, 
electrographically : ad, 
electrography : n, ÀüÀ§ ±â·Ï(Àü±âÆÇ Á¶°¢, »çÁø Àü¼Û)¼ú
electrohydraulics : n, Àü±â ¼ö·ÂÇĞ
electrojet : n, °íÃşÀü·ù(»óÃş ´ë±âÀÇ ÀÌ¿ÂÀÇ Èå¸§)
electrokinetic : a, (µ¿)Àü±âÀûÀÎ, µ¿Àü±â»óÀÇ
electrokinetics : n, µ¿Àü±âÇĞ
electrokymograph : n, (ÀÇ)(½ÉÀå)µ¿ÅÂ±â·Ï±â(ÃÔ¿µ ÀåÄ¡)
electrolier : n, ²ÉÀüµî
electroluminescence : n, ÀüÀÚ¹ß±¤
electrolysis : n, ÀüÇØ
electrolyte : n, ÀüÇØ¾×, ÀüÇØÁú
electrolytic : a, ÀüÇØ(Áú)ÀÇ
electrolyzation : n, (È­)ÀüÇØ, Àü±â ºĞÇØ, (ÀÇ)Àü±â ºĞÇØ¹ı Ä¡·á
electrolyzer : n, (¹°, È­)ÀüÇØÁ¶
electromagnet : n, ÀüÀÚ¼®
electromagnetic : a, ÀüÀÚ±âÀÇ
electromagnetic induction : x, (Àü)ÀüÀÚ À¯µµ
electromagnetic interference : x, (Àü)ÀüÀÚ ¹æÇØ(´Ù¸¥ ±â±â¸¦ ¹æÇØÇÏ´Â ÀüÀÚ Á¦Ç°ÀÇ ÀâÀ½)
electromagnetic pulse : x, (Àü)ÀüÀÚ ÆŞ½º(ÇÙÆø¹ß¿¡ ÀÇÇØ »ı±ä °í³óµµÀÇ ÀüÀÚ ¹æ»ç)
electromagnetics : n, ÀüÀÚ±âÇĞ
electromagnetism : n, ÀüÀÚ±âÇĞ
electrometallurgy : n, Àü±â ¾ß±İÇĞ
electrometer : n, ÀüÀ§°è
electromobile : n, Àü±â ÀÚµ¿Â÷(¼®À¯ Àı¾à, ¹«°øÇØÀÇ ÀÚµ¿Â÷)
electromoter : n, ¹ßÀü±â
electromotive : n, Àüµ¿ÀÇ, Àü±â±â°üÂ÷
electromotive force : x, µ¿Àü·Â
electromyogram : n, ±ÙÀüµµ
electromyography : n, (ÀÇ)±ÙÀüµµ °Ë»ç(±â·Ï)¹ı
electron : n, ÀüÀÚ
electron affinity : n, (¹°)ÀüÀÚ Ä£È­·Â
electronarcosis : n, (ÀÇ)Àü±â ¸¶Ãë(¿ä)¹ı
electron beam : x, (¹°)ÀüÀÚ ºö(Àü°è, ÀÚ°è¿¡¼­ ÇÑ ¹æÇâÀ¸·Î ¸ğ¾ÆÁ® Èå¸£´Â ÀüÀÚÀÇ Èå¸§)
electron beam melting : x, (±İ¼Ó)ÀüÀÚºö ¿ëÇØ¹ı
electron bomb : x, ÀÏ·ºÆ®·Ğ ¼ÒÀÌÅº
electronegative : a, À½Àü±âÀÇ, À½¼ºÀÇ
electron gas : x, (¹°)ÀüÀÚ ±âÃ¼(°¡½º)
electron gun : , ÀüÀÚÃÑ(ºê¶ó¿î°üÀÇ ÀÜÀÚ·ù ÁıÁß°ü)
electronic : n, ÀüÀÚÀÇ
electronic art : x, ÀüÀÚ ¿¹¼ú(¼¶±¤, ¿òÁ÷ÀÌ´Â ¶óÀÌÆ® µîÀ» »ç¿ëÇÑ ¿¹¼ú ¾ç½Ä)
electronic banking : x, ÀüÀÚÈ­µÈ ÀºÇà ¾÷¹«
electronic brain : x, ÀüÀÚ µÎ³ú(ÀüÀÚ °è»ê±â µûÀ§)
electronic caculator : x, ÀüÀÚ °è»ê±â
electronic churchman : x, ÅÚ·¹ºñÁ¯, ¶óµğ¿À µîÀ» ÀÌ¿ëÇÏ¿© ÀÏ¹İ ´ëÁß¿¡°Ô ¼³±³ÇÏ´Â ¼ºÁ÷ÀÚ
Electronic Computer Originated Mail : x, (¹Ì)ÄÄÇ»ÅÍ ¹ß½ÅÇü ÀüÀÚ ¿ìÆí
electronic cottage : x, ÀüÀÚ ±â±â¸¦ ¿ÏºñÇÑ ÁÖÅÃ
electronic countermeasure : x, (±º)(Àû¹Ì»çÀÏÀÇ)À¯µµ ¹æÇâ ÀüÈ¯ ÀüÀÚ ÀåÄ¡)
electronic data processing : x, ÀüÀÚ Á¤º¸ Ã³¸®
electronic engineering : x, ÀüÀß °øÇĞ
electronic file : x, ÀüÀÚ ÆÄÀÏ(´ë·®ÀÇ ¹®¼­, ÀÚ·á µîÀ» Àü±â ½ÅÈ£ÀÇ ÇüÅÂ·Î º¸°üÇÏ´Â ÀåÄ¡)
electronic flash : x, ½ºÆ®·Îºê(¹æ±¤ ÀåÄ¡)
electronic funds transfer : x, ÀüÀÚ½Ä ÀÚ±İ ÀÌÃ¼(ÀÌÇà °áÁ¦)
electronic game : x, ÀüÀÚ °ÔÀÓ, ºñµğ¿À °ÔÀÓ
electronic journalism : x, (Æ¯È÷ ¹Ì)ÅÚ·¹ºñÁ¯ º¸µµ, (ÁıÇÕÀû)¹æ¼Û ±âÀÚ
electronic learning : x, ÀüÀÚ ÇĞ½À(ÄÄÇ»ÅÍ¸¦ »ç¿ëÇÑ ÇĞ½À)
electronic mail : x, ÀüÀÚ ¿ìÆí
electronic media : x, ÀüÀÚ ¹Ìµğ¾î(ÀüÀÚ, Åë½Å ±â¼úÀ» ÀÀ¿ëÇÑ Á¤º¸ Àü´Ş ¸ÅÃ¼ÀÇ ÃÑÄª)
electronic meeting : x, ÀüÀÚ È¸ÀÇ
electronic music : x, ÀüÀÚ À½¾Ç
electronic office : x, ÀüÀÚ½Ä »ç¹«½Ç(ÀüÀÚ ±â±â¿¡ ÀÇÇØ »ç¹« Ã³¸®°¡ ÀÚµ¿È­µÈ)
electronic organ : x, ÀüÀÚ ¿À¸£°£
electronic publishing : x, ÀüÀÚ ÃâÆÇ
electronics : n, ÀüÀÚ°øÇĞ
electronic shopping : x, =TELESHOPPING
electronic smog : x, ÀüÆÄ ½º¸ğ±×(°¢Á¾ ÀüÆÄ, Àü±â ±â±â·ÎºÎÅÍ ¹ß»ıÇÑ ´ë±â ÁßÀÇ ÀüÀÚÆÄ)
electronic surveillance : x, ÀüÀÚ °¨½Ã(Á¤º¸ ¼öÁı)
electronic transfer : x, ÀüÀÚ½Ä ±İÀü Ãâ³³
electronic video recorder : x, ÀüÀÚ½Ä ³ìÈ­±â
electronic warfare : x, ÀüÀÚÀü
Electronic Yellow Pages : x, ÀüÀÚ½Ä Á÷¾÷ ÀüÈ­ºÎ(Æ¯Á¤ Á÷¾÷º° ÀüÈ­ºÎÀÇ Á¤º¸¸¦ ¿Â¶óÀÎÀ¸·Î Á¦°øÇÏ´Â µî)
electroniture : n, ÀüÀÚ ±â±â »ç¿ë¿¡ ¾Ë¸Âµµ·Ï Á¦ÀÛµÈ »ç¹«¿ë Áı±â
electron lens : x, ÀüÀÚ ·»Áî
electron microseope : x, ÀüÀÚ Çö¹Ì°æ
electronograph : x, ÀüÀÚ »çÁø
electronography : n, (ÀÎ)ÀüÀÚ Àü»ç¹ı(ÀüÀÚÀûÀ¸·Î ¹®ÀÚ, È­»óÀ» Á¾ÀÌ¿¡ Àü»çÇÏ´Â), (±¤)ÀüÀÚ Çö¹Ì°æ »ó
electron optics : x, ÀüÀÚ °øÇĞ
electron spin resonance : x, (¹°)ÀüÀÚ ½ºÇÉ °ø¸í
electron telescope : x, ÀüÀÚ ¸Á¿ø°æ
electron tube : x, ÀüÀÚ°ü(X¼±°ü µûÀ§)
electron volt : x, ÀüÀÚ º¼Æ®(ÀÌ¿Â, ¼Ò¸³ÀÚ ¿¡³ÊÁö ´ÜÀ§, »ı·« EV)
electrooculogram : n, (¾È°ú)Àü±â ¾È±¸µµ, ¾ÈÀüµµ
electrooptic : a, Àü±â ±¤ÇĞÀÇ
electrooptic device : x, (Àü)Àü±â ±¤ÇĞ ¼ÒÀÚ
electrooptic effect : x, (Àü)Àü±â ±¤ÇĞ È¿°ú
electrooptics : n, Àü±â ±¤ÇĞ
electropaint : n, vt, vi, ÀüÇØ µµÀå¿¡ ¾²ÀÌ´Â µµ·á, (±İ¼Ó¿¡)ÀüÇØ µµÀåÇÏ´Ù
electropainting : n, ÀüÇØ(Àü±â)µµÀå(±İ¼Ó Ç¥¸é¿¡ ÆäÀÎÆ®ÀÇ ¿¯Àº ÃşÀ» ÀüÇØ½ÃÄÑ Ä§Àû½ÃÅ´)
electrophone : n, Àü±â¾Ç±â, ÀüÀÚº¸Ã»±â
electrophonic : a, Àü±â ¹ß¼ºÀÇ
electrophorese : vt, (¹°, È­)...¿¡ Àü±â ¿µµ¿À» ½ÃÅ°´Ù, (ÇÏÀü ¹°ÁúÀÇ ºĞÀÚ¸¦)Àü±â ¿µµ¿À¸·Î ºĞ¸®ÇÏ´Ù
electrophoresis : n, Àü±âÀÌµ¿, Àü±â¿µµ¿¹ı
electrophorus : n, Àü±âÀï¹İ, ±âÀü¹İ
electrophotograph : n, (ÀÇ)Àü±â Áø´Ü »çÁø
electrophotography : n, ÀüÀÚ »çÁø¼ú
electrophrenic respiration : x, (ÀÇ)È¾°İ¸· ½Å°æ Àü±â(ÀÚ±Ø)È£Èí(¹ı)(ÀÎ°ø È£ÈíÀÇ ÀÏÁ¾)
electroplate : vt, n, Àü±âµµ±İÁ¦Ç°...¿¡ Àü±âµµ±İÀ» ÇÏ´Ù
electroplating : n, Àü±â µµ±İ(¹ı), Àüµµ
electroplexy : n, (¿µ)=ELECTROSHOCK THERAPY
electropop : n, ÀüÀÚÆË(ÀüÀÚÀ½À» »ç¿ëÇÑ ÆË¹ÂÁ÷)
electropositive : a, ¾çÀü±âÀÇ, ¾ç¼ºÀÇ
electropult : n, Àü±âÄ³´õÆŞÆ®(ÂªÀº È°ÁÖ·Î¿¡¼­ÀÇ ¹ßÁø ÀåÄ¡)
electroretinograph : n, (¾È°ú)¸Á¸· Àü±â ÃøÁ¤±â
electroscope : n, °ËÀü±â
electroscopic : a, °ËÀü±âÀÇ
electrosensitive : a, Àü±â °¨±¤¼ºÀÇ
electrosensitivity : n, (»ı)(µ¿¹°ÀÇ)Àü±â Áö°¢ ´É·Â, (»ıÃ¼ ÀÏ¹İÀÇ)Àü±â °¨ÀÀ·Â, Àü±â ¹İÀÀ
electroshock : n, Á¤½Åº´ÀÇ Àü°İ ¿ä¹ı
electroshock therapy : x, (Á¤ÀÇ)Àü±â ¼îÅ©(Ãæ°İ)¿ä¹ı
electrosleep : n, (ÀÇ)Àü±â ¼ö¸é(³ú¿¡ ÀúÀü¾Ğ Àü·ù¸¦ Èê·Á Àáµé°Ô ÇÔ)
electrostatic : a, (Àü)Á¤Àü(±â)ÀÇ, Á¤Àü±âÇĞÀÇ
electrostatic precipitator : x, Àü±âÁıÁøÀåÄ¡(¿¬±â, ¸ÕÁö, ±â¸§ µî¿¡ ºÎÀ¯ÇÏ´Â ºÒ¼ø¹°À» Ã¤ÁıÇÔ)
electrostatics : n, Á¤ÀüÇĞ
electrotechnics : n, Àü±â°øÇĞ
electrotechnology : n, Àü±â °øÇĞ, ÀüÀÚ °øÇĞ
electrotelyze : vt, ÀüÇØÇÏ´Ù
electrotherapeutic : a, (ÀÇ)Àü±â ¿ä¹ıÀÇ
electrotherapeutics : n, (ÀÇ)Àü±â ¿ä¹ı
electrotherapist : n, (ÀÇ)Àü±â ¿ä¹ı ÀÇ»ç
electrotherapy : n, Àü±â¿ä¹ı
electrothermal : a, Àü¿­ÀÇ, Àü±â¿Í ¿­ÀÇ
electrotome : n, ÀÚµ¿ Â÷´Ü±â
electrotonus : n, (»ı¸®)Àü±â ±äÀå(Àü·ù¸¦ ÅëÇÏ¿´À» ¶§ ÀÏ¾î³ª´Â ½Å°æ, ±ÙÀ°ÀÇ »ı¸®Àû ±äÀå)
electrotype : vt, Àü±â°üÀ¸·Î ¸¸µé´Ù, ¿Ã ¶ß´Ù
electrotyper : n, Àü±â Á¦ÆÇ°ø
electrotypy : n, Àü±âÆÇ Á¦ÀÛ¹ı, Àü±â Á¦ÆÇ¼ú
electrovalence : n, ÀÌ¿Â¿øÀÚ°¡, ÀüÀÚÀÌµ¿
electrum : n, È£¹Ú±İ(±İ, ÀºÀÇ ÇÕ±İ, °í´ë ±×¸®½º È­Æä·Î »ç¿ë ÇßÀ½)
electuary : n, (½Ã·´, ²Ü°ú ÇÔ²² °³¾î ¸¸µç)¿¬¾à, ÇÓ¾Æ¸Ô´Â ¾à
eledoisin : n, (¾à)¿¤·¹µµÀÌ½Å(³«ÁöÀÇ Å¸¾×¼±¿¡¼­ Ã¤ÃëÇÑ Ç÷°ü È®Àå, °­¾ĞÁ¦)
eledtioneer : vi, n, ¼±°Å ¿îµ¿À» ÇÏ´Ù, ¼±°Å ¿îµ¿¿ø
eleemosynary : a, n, º£Çª´Â, ÀÚ¼±ÀÇ, ÀÚ¼±À» ¹Ş´Â
elegance : n, ¿ì¹Ì, ¿ì¾Æ, ´Ü¾Æ, °í»óÇÔ, °úÇĞÀûÀÎ Á¤¹Ğ¼º, ¿ì¾ÆÇÑ ¸»¾¾
elegant : a, ¿ì¾ÆÇÑ, Ç°À§ÀÖ´Â, ÈÇ¸¢ÇÑ, ±Ù»çÇÑ
elegantly : ad, 
elegiac : a, n, ¸¸°¡ÀÇ, ¾Ö°¡Á¶ÀÇ, ½½ÇÂ, ¸¸°¡Çü½ÄÀÇ ½Ã°¡
elegiac couplet : x, ¾Ö°¡Á¶ ¿¬±¸
elegiac stanza : x, (½ÃÇĞ)¾Ö°¡Á¶ÀÇ ¿¬
elegist : n, ¾Ö°¡(¸¸°¡)½ÃÀÎ
elegize : vt, vi, ¾Ö°¡¸¦Áş´Ù, ¾Ö°¡·Î ¾ÖµµÇÏ´Ù
elegy : n, ¸¸°¡, ¾Ö°¡, ¿¤·¹Áö
elem, : x, element(s), elementary
element : n, ¿ä¼Ò, ¼ººĞ, ºĞÀÚ, ¿ø¼Ò, ÀÚ¿¬·Â, Ç³¿ì, °íÀ¯ÀÇ È¯°æ, ¼ÒºÎ´ë, ±âº», ÃÊº¸, »§°ú Æ÷µµÁÖ, (strife of the elements ÆøÇ³¿ì)
element 104 : x, (È­)104¹ø ¿ø¼Ò(12¹øÂ°ÀÇ ÃÊ¿ì¶õ ¿ø¼Ò, ÀÎ°ø ¹æ»ç¼º ¿ø¼Ò)
element 105 : x, (È­)105¹ø ¿ø¼Ò(ÀÎ°ø ¿ø¼ÒÀÇ ÇÏ³ª)
element 106 : x, (È­)106¹ø ¿ø¼Ò(ÃÊ¿ì¶õ ¿ø¼ÒÀÇ 14¹øÂ°ÀÇ °Í, ÀÎ°ø ¹æ»ç¼º ¿ø¼Ò)
element 107 : x, (È­)107¹ø ¿ø¼Ò(ÁÖ±âÇ¥ ¹øÈ£ 107ÀÇ ÃÊ¿ì¶õ ¹æ»ç¼º ¿ø¼ÒÀÇ 15¹øÂ°ÀÇ °Í, ÀÎ°ø ¹æ»ç¼º ¿ø¼Ò)
element 126 : x, (È­)126¹ø ¿ø¼Ò(ÀÚ¿¬ ¼Ó¿¡ Á¸ÀçÇÑ´Ù°í ¹Ï¾îÁö´Â ¹Ì¹ß°ßÀÇ ¹«°Å¿î ¿ø¼Ò)
elemental : a, ¿ø¼ÒÀÇ, º»ÁúÀûÀÎ, ¿ø¸®ÀÇ, »ç´ëÀÇ, ±Ù¿øÀûÀÎ
elemental area : x, È­¼Ò(ÅÚ·¹ºñÁ¯ È­¸éÀÇ Á÷»ç°¢Çü ±¸¿ª)
elemental diet : x, (ÀÇ)±âº»½Ä, ¼ººĞ ¿µ¾ç
elementarily : ad, 
elementary : a, ±âº»ÀÇ, ÃÊº¸ÀÇ, º»ÁúÀÇ, ¿ø¼ÒÀÇ
elementary particles : x, ¼Ò¸³ÀÚ
elementary school : x, ±¹¹Î ÇĞ±³
elemi : n, ¿¤·¹¹Ì(¿­´ë»êÀÇ ¹æÇâ¼öÁö), °í¾à, ´Ï½º µî¿¡ ¾²ÀÓ
Elena : n, ¿©ÀÚ ÀÌ¸§
elenchus : n, (³í)¹İ´ë ³íÁõ, ³íÆÄ, (ÀÏ¹İÀûÀ¸·Î)³í¶õ, ³í¹Ú
elenctic : a, ³í¹ÚÀÇ, (³í)¹İ´ë ³íÁõÀûÀÎ, ±Ëº¯ÀÇ
elephant : n, ÄÚ³¢¸®(¹Ì±¹ ¸¸È­¿¡¼­´Â °ø¿Í´çÀ» Ç¥½ÃÇÔ), ½ÖÀ» º¸´Ù, ±¸°æÇÏ´Ù
elephant'sear : n, =BEGONIA, =TARO
elephanta : n, ÀÎµµÀÇ ¸È¶ó¹Ù¸£ ¿¬¾È¿¡¼­ ºÎ´Â °­Ç³
elephant bird : x, (Á¶)À¶Á¶
elephant ears : x, (±¸)¹Ì»çÀÏ °Ñ¸éÀÇ µÎ²¨¿î ±İ¼ÓÆÇ(°øÁß ¸¶Âû·Î ÀÎÇÑ ¿­ÀÇ ºĞ»êÀ» µµ¸ğ)
elephantiasis : n, »óÇÇº´
elephantine : a, ÄÚ³¢¸®ÀÇ, °Å´ëÇÑ, º¼Ç°¾ø´Â, ´À¸°
elephant seal : x, (µ¿)ÇØ»ó, ÇØ¸¶
Eleusinian : a, n, ELEUSIS½ÃÀÇ (½Ã¹Î)
Eleusinian mysteries : x, ¿¤·¹¿ì½Ã½º Á¦Àü
Eleusis : n, ¿¤·¹¿ì½Ã½º(°í´ë ±×¸®½º Attica±¹ÀÇ µµ½Ã)
elev, : x, elevation
elevate : vt, ¿Ã¸®´Ù, ½ÂÁø½ÃÅ°´Ù, ±â¿îÀ» ºÏµ¸¾ÆÁÖ´Ù, Çâ»ó½ÃÅ°´Ù, ¾Ó¾çÇÏ´Ù, ±âºĞÀ» µé¶ß°ÔÇÏ´Ù
elevated : n, a, ³ôÀº, °í»óÇÑ, ÄèÈ°ÇÑ, °Å³ªÇÑ
elevated railroad (railway) : x, (¹Ì)°í°¡ Ã¶µµ
elevation : n, ¿Ã¸®´ÂÀÏ, ½ÂÁø, Çâ»ó, ÀÔ¸é, ±âÇ°, °í»ó
elevation : n, °øÁßÀÇ ¼ø°£ Á¤Áö
elevator : n, ½Â°­±â, °î¹°Ã¢°í
elevator shaft : x, ½Â°­±â Åë·Î
elevator shoe : x, Å°°¡ Å©°Ô º¸ÀÌ·Á°í µÎ²¨¿î ¾ÈÃ¢À» ±ñ ±¸µÎ
elevatory : a, ¿Ã¸®´Â, ³ôÀÌ´Â
eleven : n, a, ¿­ÇÏ³ª, Ãà±¸ÆÀ, ¿­ÇÑ»ç¶÷ÀÇ
elevenfold : a, ad, 11¹èÀÇ(·Î)
eleven o'clock : x, (¿µ¹æ)(11½Ã°æ¿¡ ¸Ô´Â)°£´ÜÇÑ ½Ä»ç
elevenplus : n, ÁøÇĞÀÚ°İÀÎÁ¤½ÃÇè
elevenses : n, °¡º­¿îÁ¡½É
eleventh : a, n, Á¦11ÀÇ, Á¦ 11
eleventh hour : x, ¸¶Áö¸· ±âÈ¸, ÃÖÈÄÀÇ ¼ø°£, ¸·ÆÇ, ¸¶°¨ÀÌ ÀÓ¹ÚÇÑ ½Ã°£
elevon : n, (°ø)¿¤¸®º»(½Â°­Å¸¿Í º¸Á¶ ³¯°³ÀÇ ¿ªÇÒÀ» ÇÏ´Â)
elf : n, ²¿¸¶¿äÁ¤, ³­ÀïÀÌ ²¿¸¶, °³±¸ÀåÀÌ
ELF : x, extremely low frdquency ÃÊÀúÁÖÆÄ
ELF : x, Eritrean Liberation Front
elf arrow bolt : n, µ¹È­»ìÃË
elf child : x, ¹Ù²ãÄ£ ¾ÆÀÌ
elf fire : x, µµ±úºñ ºÒ
elfin : n, a, ²¿¸¶¿äÁ¤
elfish : a, ²¿¸¶ ¿äÁ¤ °°Àº, Àå³­ ÀßÇÏ´Â, elfishly, ad, elfishness, n
elfland : n, ¿äÁ¤ÀÇ ³ª¶ó
elflock : n, ¾ûÅ²¸Ó¸®
Elgin marbles : x, ´ë¿µ¹Ú¹°°ü¿¡ ÀÖ´Â °í´ë ±×¸®½ºÀÇ ´ë¸®¼® Á¶°¢
El Giza : n, =GIZA
El Greco : n, (1541, 1614)±×·¹ÄÚ(½ºÆäÀÎÀÇ È­°¡, Á¶°¢°¡)
elhi : a, ±¹¹Î ÇĞ±³¿¡¼­ °íµî ÇĞ±³±îÁöÀÇ, ÃÊ, Áß°íÀÇ
Elia : n, Charles LambÀÇ ÇÊ¸í
Elias : n, ³²ÀÚ ÀÌ¸§, =ELIJAH
elicit : vt, ²ø¾î³»´Ù
elicitation : n, ÀÌ²ø¾î ³¿, À¯µµÇØ ³¿
elide : vt, ¸ğÀ½, À½ÀıÀ» »ı·«ÇÏ´Ù
eligibility : n, ÀûÀÓ, Àû°İ
eligible : a, n, ÅÃÇØµµ ÁÁÀº, »ÌÈú ÀÚ°İ ÀÖ´Â, ÀûÀÓÀÇ, Àû°İÀÚ, ¹Ù¶÷Á÷ÇÑ
Elihu : n, ³²ÀÚ ÀÌ¸§, (¼º)¿¤¸®ÈÄ(°í¹ÎÇÏ´Â ¿é¿¡°Ô ÇÏ´À´ÔÀÇ °Å·èÇÏ½ÉÀ» ±ú¿ìÄ¡·Á ÇÏ´ø ÀşÀºÀÌ)
Elijah : n, ¿¤¸®¾ß(È÷ºêÀÇ ¿¹¾ğÀÚ)
eliminable : a, Á¦°ÅÇÒ¼öÀÖ´Â
eliminant : n, (¼ö)¼Ò°Å½Ä
eliminate : vt, Á¦°ÅÇÏ´Ù, »èÁ¦ÇÏ´Ù, »ı·«ÇÏ´Ù, ¹è¼³ÇÏ´Ù
elimination : n, Á¦°Å, ¹èÃâ, ¿¹¼±, ¼Ò°Å
eliminative : a, Á¦°ÅÇÒ ¼ö ÀÖ´Â, (¼ö)¼Ò°ÅÇÒ ¼ö ÀÖ´Â, (»ı¸®)¹èÃâ(¹è¼³)(ÀÛ¿ë)ÀÇ
eliminator : n, Á¦°ÅÇÏ´Â ¹°°Ç, ÀÏ¸®¹Ì³×ÀÌÅÍ(±³·ù¿¡¼­ Á÷·ù¸¦ ¾ò´Â ÀåÄ¡)
eliminatory : a, Á¦°Å(»èÁ¦, ¹èÃâ, ¹è¼³)ÀÇ
Elinor : n, ¿©ÀÚ ÀÌ¸§
ELINT : n, ÀüÀÚ Á¤º¸
Eliot : n, George(1819, 80)(Nary Ann EvansÀÇ ÇÊ¸í)¿µ±¹ÀÇ ¿©·ù ¼Ò¼³°¡, Thomas Stearns(1888, 1965)¿µ±¹ÀÇ ½ÃÀÎ, ºñÆò°¡
Elisabeth : n, =ELIZABETH
Elise : n, ¿©ÀÚ ÀÌ¸§
Elisha : n, ¿»¸®»ş(È÷ºê¸®ÀÇ ¿¹¾ğÀÚ, ElijahÀÇ ÈÄ°èÀÚ)
elision : n, ¸ğÀ½»ı·«
elite : n, ¿¤¸®Æ®(the elite of society ¸í»çµé)
Elite Guard : x, (³ªÄ¡½ºÀÇ)Ä£À§´ë, Á¤¿¹ ºÎ´ë
elitism : n, ¿¤¸®Æ®ÁÖÀÇ, ¿¤¸®Æ®¿¡ ÀÇÇÑ Áö¹è, ¿¤¸®Æ® ÀÇ½Ä(ÀÚÁ¸½É)
elitist : n, a, ¿¤¸®Æ®ÁÖÀÇÀÚ, ¿¤¸®Æ®(ÀÚÃ³ÀÚ), ¿¤¸®Æ®ÁÖÀÇÀÇ
elixir : n, ¿¬±İ¼úÀÇ ¿µ¾×, ºÒ·Î Àå¼öÀÇ ¿µ¾à, ¸¸º´ ÅëÄ¡¾à
Eliz, : x, Elizabeth, Elizabethan
Eliza : n, ¿©ÀÚ ÀÌ¸§
Elizabeth : n, ¿¤¸®ÀÚº£½º1¼¼
Elizabethan : a, n, ¿¤¸®ÀÚº£½º1¼¼½Ã´ëÀÇ
elizabethan sonnet : , ¿¤¸®ÀÚº£½ºÁ¶Ç³ÀÇ ¼Ò³×Æ®(Shakespearian sonnet¶ó°íµµ ÇÔ, ¾Ğ¿î Çü½ÄÀº abab cacd efef gg)
elk : n, Å«»ç½¿
elkhound : n, (³ë¸£¿şÀÌ ¿ø»êÀÇ)»ç½¿ »ç³É°³
ell : n, ¿¤(45ÀÎÄ¡¿¡ »ó´çÇÏ´Â ¿¾³¯ÀÇ ¿µ±¹ Ã´µµ)(Give him an inch and he'll take an ell ºÀ´çÀ» ºô·Á ÁÖ´Ï ¾È¹æ±îÁö ´Ş¶õ´Ù)
ell : n, LÇüÀÇ ¹°°Ç, LÇô, ÁõÃà
Ella : n, ¿©ÀÚ ÀÌ¸§
Ellen : n, ¿©ÀÚ ÀÌ¸§
ellipse : n, Å¸¿ø, Àå¿øÇü
ellipsis : n, »ı·«, »ı·«ºÎÈ£
ellipsograph : n, Å¸¿øÄÄÆÛ½º, Å¸¿øÀÚ
ellipsoid : n, a, Å¸¿ø¸é
ellipsoidal : a, Å¸¿øÃ¼(¸ğ¾ç)ÀÇ
ellipt, : x, elliptical, elliptically
elliptic : a, Å¸¿øÀÇ, »ı·«ÀÇ
ellipticity : n, Å¸¿ø ¸ğ¾ç, Å¸¿øÀ², (Æ¯È÷)Áö±¸ Å¸¿øÀ²
Ellis : n, ³²ÀÚ ÀÌ¸§
Ellis Island : n, ¿¤¸®½º¼¶(´º¿åÇ×ÀÇ ÀÛÀº ¼¶, Àü¿¡ ÀÌ¹Î °Ë¿ª¼Ò°¡ ÀÖ¾úÀ½)
elm : n, ´À¸¨³ª¹«
Elmer : n, ³²ÀÚ ÀÌ¸§
Elmo : n, ³²ÀÚ ÀÌ¸§
elmy : a, ´À¸¨ ³ª¹«°¡ ¸¹Àº
El Nino : n, ¿¤´Ï´¢(³²¾Æ¸Ş¸®Ä« ºÏ¼­ºÎ ¿¬¾ÈÀ» ³²ÇÏÇÏ´Â ³­·ù)
elocution : n, ¿õº¯¼ú, ÇĞ¼ú, ³¶µ¶¹ı
elocutionary : a, ¹ß¼º¹ı»óÀÇ, ¿¬¼³¹ı(¿õº¯¼ú)»óÀÇ
elocutionist : n, ¿õº¯°¡
eloge : n, Âù»ç, (Æ¯È÷ ÇÁ¶û½º ÇĞ»ç¿ø È¸¿øÀÇ)Ãßµµ ¿¬¼³, Ãßµµ»ç
Elohim : n, ¿¹·ÎÈû(¿©È£¿ÍÀÇ º°Äª)
Elohist : n, ¿¤·ÎÈ÷½ºÆ®(±¸¾à¼º¼­ Ã¹ 6Æí¿¡¼­ ÇÏ´À´ÔÀ» ElohimÀÌ¶ó ºÎ¸¥ ÀúÀÚ)
Eloise : n, ¿©ÀÚ ÀÌ¸§
elongate : a, vt, ±æ°ÔÇÏ´Ù, ±æ¾îÁö´Ù, ¿¬ÀåÇÏ´Ù, ±æ¾îÁø, °¡´Ã°í±ä
elongated : a, =ELONGATE
elongation : n, ¿¬Àå, ½ÅÀå
elope : vi, ´«¸Â¾Æ´Ş¾Æ³ª´Ù
elopement : n, ¾ÖÀÎ°ú ÇÔ²² ´Ş¾Æ³ª±â, °¡Ãâ, µµ¸Á
eloper : n, ´«ÀÌ ¸Â¾Æ ´Ş¾Æ³ª´Â »ç¶÷, µµ¸Á²Û
eloquence : n, ¿õº¯
eloquent : a, ¿õº¯ÀÇ, Ç¥Á¤ÀÌ Ç³ºÎÇÑ, ...À» Àß ³ªÅ¸³»´Â
El Paso : n, ¿¤ÆĞ¼Ò
El Pasoan : n, ¿¤ÆĞ¼Ò ÅÂ»ıÀÇ »ç¶÷, ¿¤ÆĞ¼Ò ÁÖ¹Î
Elsa : n, ¿©ÀÚ ÀÌ¸§
El Salvador : n, ¿¤»ì¹Ùµµ¸£(Áß¾Ó ¾Æ¸Ş¸®Ä«ÀÇ °øÈ­±¹)
Elsan : n, Å»Ãëµî¿¡ È­ÇĞ ¾àÇ°ÀÌ ¾²ÀÌ´Â ÈŞ´ë º¯±â
else : ad, ´Ş¸®, ±×¹Û¿¡, ±×·¸Áö¾ÊÀ¸¸é
elsewhere : ad, ¾îµò°¡µı°÷¿¡
elsewhither : ad, =ELSEWHERE
Elsie : n, ¿©ÀÚ ÀÌ¸§
ELT : x, English Language Teaching, European letter telegram
EL Tor : x, (½Ã³ªÀÌ ¹İµµ¿¡ ÀÖ´Â ÀÌÁıÆ®ÀÇ °Ë¿ª¼Ò ÀÌ¸§¿¡¼­)(¼¼±Õ)¿¤Åä¸£Çü Äİ·¹¶ó±Õ
elucidate : vt, ¹àÈ÷´Ù, ¼³¸íÇÏ´Ù
elucidation : n, (¹®¾î)¼³¸í, ÇØ¸í
elucidative : a, ¼³¸íÀûÀÎ, ÇØ¸íÀûÀÎ
elucidator : n, ¼³¸í(ÇØ¸í)ÇÏ´Â »ç¶÷
elucidatory : a, ¹àÈ÷´Â, ¼³¸íÀûÀÎ
elude : vt, (»ìÂ¦ ¸öÀ» µ¹·Á)ÇÇÇÏ´Ù, ¹ş¾î³ª´Ù(evad)
elusion : n, È¸ÇÇ, µµÇÇ
elusive : a, Æ÷ÂøÇÏ±â¾î·Á¿î, ¿ëÇÏ°Ô ºüÁ®³ª°¡´Ù, ¾Ë±â¾î·Á¿î
elusory : a, ºÙÀâ±â ¾î·Á¿î, Àß ÇÇÇÏ´Â
elutriate : vt, ¾Ä¾î¼­ ±ú²ıÀÌ ÇÏ´Ù, ¼¼±¤ÇÏ´Ù, ÇöÅ¹ ºĞ¸®ÇÏ´Ù
eluvium : n, (ÁöÁú)Ç³È­ ÀÜ·ù¹°, ÀÜ·ù ÅğÀû¹°(Ãş), ÀÜÀûÃş
elvan : n, ¸Æ¹İ¾Ï, È­°­¹İ¾Ï
elver : n, »õ³¢ ¹ìÀå¾î(¹Ù´Ù¿¡¼­ °­¹°·Î ¿Ã¶ó¿Â)
elves : n, elfÀÇº¹¼ö
Elvira : n, ¿©ÀÚ ÀÌ¸§
elvish : a, =ELFISH
Ely : n, ÀÏ¸®(ÀÏ±Û·£µå µ¿ºÎÀÇ Isle of Ely Áö¹æÀÇ µµ½Ã, À¯¸íÇÑ ¾Æ¸§´Ù¿î CathedralÀÌ ÀÖÀ½)
Elysee : n, ¿¤¸®Á¦±Ã(ÇÁ¶û½º ´ëÅë·É °üÀú)
Elysian : a, ELYSIUMÀÇ(°°Àº), Áöº¹ÀÇ
Elysian fields : x, =ELYSIUM 1 a
Elysium : n, a, ±Ø¶ô, ³«Åä, ÀÌ»óÇâ
elytron : n, °Ñ³¯°³, ½ÃÃÊ
Elzevi(e)r : n, ¿¤Á¦ºñ¾î È°ÀÚÃ¼
em : n, MÀÚ, (ÀÎ)Àü°¢(MÀÚ Å©±âÀÇ 4°¢Çü)
em : pron, (±¸)=THEM
Em : n, ¿©ÀÚ ÀÌ¸§
Em : x, (È­)emanation
EM : x, electron micrsscopeÀüÀÚ Çö¹Ì°æ, electronic mailÀüÀÚ ¿ìÆí, (¹Ì)enlisted man(men), (±º)education manual
em- : pref, =EN-
EMA : x, European Monetary Agreement(°æ)À¯·´ ÅëÈ­ ÇùÁ¤
emaciate : vt, ¼è¾àÄÉÇÏ´Ù
emaciated : a, ¼öÃ´ÇÑ, ¿©À©, ¼è¾àÇÑ
emaciation : n, 
emanate : vi, (ºû, ¿­, ¼Ò¸® µûÀ§°¡)¹ß»êÇÏ´Ù
emanation : n, ¹ß»ê¹°, ¹æ»ç¹°, ¿¡¸¶³ªÆ¼¿Â(¹æ»ç¼º ±âÃ¼)
emanative : a, ¹ß»ê(¹æ»ç)ÇÏ´Â(½ÃÅ°´Â), ¹ß»ê¼º ÀÖ´Â, ¹æ»ç¼ºÀÇ
emancipate : vt, ÇØ¹æÇÏ´Ù
emancipated : a, ÇØ¹æµÈ, ÀüÅë¿¡ ¾ô¸ÅÀÌÁö ¾Ê´Â, ÀÚÁÖÀûÀÎ, ÀÚÀ¯ÀÎÀÇ
emancipation : n, ÇØ¹æ
emancipationist : n, ³ë¿¹ ÇØ¹æ·ĞÀÚ
Emancipation Proclamation : x, (¹Ì»ç)³ë¿¹ ÇØ¹æ·É(ÇØ¹æ ¼±¾ğ)
emancipative : a, =EMANCIPATORY
emancipator : n, ÇØ¹æÀÚ
emancipatory : a, ÇØ¹æÀÇ, ¼®¹æÀÇ
Emanuel : n, ³²ÀÚ ÀÌ¸§
emarginate : a, (½Ä)°¡ÀåÀÚ¸®°¡ Åé´Ï¸ğ¾çÀ¸·Î °¥¶óÁø, ¿À¸ñÇÏ°Ô µé¾î°£ ÇüÀÇ
emasculate : vt, a, ºÒ±î´Ù, °Å¼¼ÇÏ´Ù, À¯¾àÇÏ°ÔÇÏ´Ù, ºÒ±ñ, °Å¼¼µÈ, À¯¾àÇÑ, ¿¬¾àÇÑ
emasculation : n, °Å¼¼, ¿ä±äÇÑ µ¥¸¦ »©¾î ¹ö¸², ¾ó¹ö¹«¸², ¹«·ÂÈ­, À¯¾à
emasculative : a, °Å¼¼ÇÏ´Â, ¹«·ÂÈ­ÇÏ´Â
emasculator : n, °Å¼¼ÇÏ´Â »ç¶÷(µµ±¸), ¹«·ÂÈ­ÇÏ´Â »ç¶÷(»ç¹°)
emasculatory : a, =EMASCULATIVE
embalm : vt, ½ÃÃ¼¿¡)ÇâÀ¯¸¦ ¹ß¶ó¼­ º¸Á¸ÇÏ´Ù:(ÀÌ¸§À»)±æÀÌ ±â¾ï¿¡ ³²±â´Ù, Çâ±â¸¦ Ç³±â´Ù, Çâ·á¸¦ Ä¡´Ù
embalmment : n, (½ÃÃ¼ÀÇ)¹æºÎ º¸Á¸, ¹ÌÀÌ¶ó·Î ¸¸µê, ¹æºÎ º¸Á¸Á¦
embank : vt, µÏÀ¸·Î µÎ¸£´Ù, µÏÀ» °, ´Ù
embankment : n, Á¦¹æ, µÏ, ÃàÁ¦
embarcation : n, =EMBARKATION
embargo : n, vt, Ç×³»ÃâÀÔ±İÁö, Åë»ó±İÁö, ±İÁöÇÏ´Ù, ¸ô¼öÇÏ´Ù
embark : vi, vt, ¹è¸¦Å¸´Ù, Ãâ¹üÇÏ´Ù, ¹è¿¡ ÅÂ¿ì´Ù, ÅõÀÚÇÏ´Ù
embarkation : n, ½Â¼±, Å¾½Â, ÀûÀç, (»õ »ç¾÷ µî¿¡ÀÇ)Âø¼ö
embarkation card : x, Ãâ±¹ Ä«µå
embarkment : n, =ENBARKATION
embarras de richesse : n, Ã³¸® °ï¶õÇÒ Á¤µµ·Î Àç»êÀÌ ¸¹À½, Áö³ªÄ£ Ç³¿ä
embarrass : vt, °ï¶õÄÉÇÏ´Ù, ´çÈ¤ÄÉÇÏ´Ù, ºĞ±ÔÄÉÇÏ´Ù, Çàµ¿À» ¹æÇØÇÏ´Ù
embarrassed : a, ¾î¸®µÕÀıÇÑ, ´çÈ¤ÇÑ, Ã¢ÇÇÇÑ, ¹«¾ÈÇÑ, ³­Ã³ÇÑ, (±İÀüÀûÀ¸·Î)±Ã»öÇÑ, ÂÉµé¸®´Â
embarrassedly : ad, °ï¶õ(³­Ã³)ÇÑ µíÀÌ, ¸ÚÀûÀº µíÀÌ, Ã¢ÇÇÇÑ µíÀÌ
embarrassing : a, Â¿Â¿¸Å°Ô ÇÏ´Â, ´çÈ²(Ã¢ÇÇ, ¹«¾È)ÄÉ ÇÏ´Â, ³­Ã³ÇÑ, °ï¶õÇÑ, embarrassingly, ad
embarrassment : n, ³­Ã³ÇÔ, ´çÈ¤, °ï¶õ, ¹æÇØ, Àå¾Ö
embassador : n, =AMBASSADOR
embassy : n, ´ë»ç°ü, »çÀı´Ü, ´ë»çÀÇ ÀÓ¹«
embattle : vt, ÁøÀ»Ä¡´Ù, Æ÷ÁøÇÏ´Ù, ¼º¿¡ ÃÑ¾È ´Ş¸° ÈäÀåÀ» °®Ãß´Ù
embattled : ÀüÅõ ÅÂ¼¼¸¦ °®Ãá, Æ÷ÁøÇÑ, (°Ç)ÃÑ¾È ÈäÀåÀÌ ÀÖ´Â, (±¸È¹¼±ÀÌ)ÃÑ¾È ¸ğ¾çÀ¸·Î µéÂß³¯ÂßÇÑ, Àû(±º)¿¡°Ô Æ÷À§ ´çÇÑ, (»ç¶÷ÀÌ ´Ã)±«·ÓÇôÁö´Â, Áö°Ü¿î
embattlement : n, =EMBATTLED 1ÀÇ »óÅÂ, BATTLENENT
embay : (¹è¸¦)¸¸ ¾È¿¡ ³Ö´Ù, (¹Ù¶÷ÀÌ ¹è¸¦)¸¸ ¾È¿¡ µé¿© º¸³»´Ù, (¼±´ë¸¦)¸¸Ã³·³ µÑ·¯½Î¼­ ÁöÅ°´Ù, °¡µÎ¾î ³Ö´Ù, Æ÷À§ÇÏ´Ù, ¸¸ ¸ğ¾çÀ¸·Î ÇÏ´Ù
embayment : n, ¸¸ Çü¼º, ¸¸, ¸¸ ¸ğ¾çÀÇ°Í
embed : vt, ¸ÅÀåÇÏ´Ù, ¹¯´Ù, ±íÀÌ °£Á÷ÇÏ´Ù
embellish : vt, Àå½ÄÇÏ´Ù
embellishment : n, Àå½Ä
ember : n, Å¸´Ù³²Àº°Í, ¿©½Å
ember : n, ´Ü½Ä°ú ±âµµÀÇ °èÀç
Ember days : x, »ç°èÀçÀÏ
Ember week : x, (ÃµÁÖ±³)»ç°è ÀçÀÏÁÖ°£
embezzle : vt, À§Å¹±İ µûÀ§¸¦ ½á¹ö¸®´Ù
embezzlement : n, À§Å¹±İ µûÀ§ÀÇ À¯¿ë, Âø¿ë
embezzler : n, (À§Å¹±İ µîÀ»)½á¹ö¸®´Â »ç¶÷, È¾·É(Âøº¹)ÀÚ
embitter : vt, ¾²°ÔÇÏ´Ù, °íµÇ°ÔÇÏ´Ù, ½ÉÇÏ°ÔÇÏ´Ù
embitterment : n, (±«·Î¿ò µîÀÇ)½É°¢È­, (¿øÇÑ µîÀÇ)°İÈ­, °İºĞ
emblazon : vt, ¹æÆĞ¸¦ ¹®ÀåÀ¸·Î Àå½ÄÇÏ´Ù, È­·ÁÇÏ°Ô Àå½ÄÇÏ´Ù, Âù¾çÇÏ´Ù
emblazonment : n, ¹®Àå Àå½Ä
emblazonry : n, ¹®Àå È­¹ı, ¹®Àå, Àå½Ä
emblem : n, vt, »óÂ¡
emblematic : a, »óÂ¡ÀÇ..., À» »óÂ¡ÇÏ´Â
emblematist : n, Ç¥Àå Á¦ÀÛÀÚ, ±âÀå(Ç¥Àå)°í¾ÈÀÚ, ¿ìÀÇÈ­ È­°¡
emblematize : vt, »óÂ¡ÀûÀ¸·Î ³ªÅ¸³»´Ù, »óÂ¡ÇÏ´Ù
emblements : n, (¹ı)ÀÎ°ø °æÀÛ¹°, ±Ù·Î °ú½Ç, (Â÷ÁöÀÎÀÇ)³óÀÛ¹° ¼öµæ±Ç
embodier : n, 
embody : vt, ÇüÃ¼¸¦ ºÎ¿©ÇÏ´Ù, ÇüÃ¼ ÀÖ´Â °ÍÀ¸·Î ¸¸µé´Ù, ±¸Ã¼È­ÇÏ´Ù, ±¸Ã¼ÀûÀ¸·Î Ç¥ÇöÇÏ´Ù, ÀÏÃ¼È­ÇÏ´Ù, ÅëÇÕÇÏ´Ù, Æ÷ÇÔÇÏ´Ù
embog : vt, ¼ö··¿¡ ºü¶ß¸®´Ù, ±ÃÁö¿¡ ºüÁ® ²ÄÂ¦ ¸øÇÏ°Ô ÇÏ´Ù
embolden : vt, ¿ë±â¸¦ÁÖ´Ù, ´ë´ãÇÏ°ÔÇÏ´Ù
embolic : a, (º´¸®)»öÀü(Áõ)ÀÇ, »öÀüÁõ¿¡ ÀÇÇÑ, (¹ß»ı)ÇÔÀÔ(±â)ÀÇ, ÇÔÀÔ¿¡ ÀÇÇÑ
embolism : n, »öÀüÁõ
embolismic : a, (À¯ÅÂ·ÂÀ¸·Î)À±³â
embolus : n, »öÀü¹°
embonpoint : n, ¿©ÀÎÀÇ ºñ¸¸
embosom : vt, Ç°¿¡¾È´Ù, µÑ·¯½Î´Ù
emboss : vt, µ¸À»»õ±èÇÏ´Ù, µµµå¶óÁö°Ô ÇÏ´Ù(embossed printing ¿ìÇ¥, ±¸±Ş ¸íÇÔ, ÃÊ´ëÀå µîÀ» ÀÎ¼â)
embossed : a, ºÎÁ¶ ¼¼°øÀ» ÇÑ, ¾ç°¢À¸·Î ¹«´Ì¸¦ ³ÖÀº, ¾ç°¢À¸·Î »õ±ä, µ¸À»»õ±èÀÇ, ´­·¯¼­ µµµå¶óÁö°Ô ÇÑ
embossment : n, ºÎÁ¶·Î ÇÔ, µµµå¶óÁö°Ô ÇÔ, ºÎÁ¶ ¼¼°ø, ¾ç°¢ ¹«´Ì(Àå½Ä)
embouchure : n, ÇÏ±¸, °ñÂ¥±âÀÇ ¾î±Í, À§ÁÖ¾Ç±âÀÇ ÁÖµÕÀÌ
embourgeoisement : n, (F)Áß»ê °è±Ş(ºÎ¸£ÁÖ¾Æ)È­
embourgeoisification : n, Áß»ê °è±Ş(ºÎ¸£ÁÖ¾Æ)È­
embowel : vt, =EISEMBOWEL
embower : vt, vi, ³ª¹µÀÙÀ¸·Î°¡¸®´Ù, ¼û±â´Ù, ³ª¹«±×´Ã¿¡¼­½¬´Ù
embrace : vt, vi, n, Æ÷¿ËÇÏ´Ù, ²¸¾È´Ù, ¸Å¼öÇÏ´Ù, Æ÷ÇÔÇÏ´Ù, ±ú´İ´Ù, Ã¤¿ëÇÏ´Ù, ¼­·Î ²¸¾È´Ù, Æ÷¿Ë
embracement : n, Æ÷¿Ë, (±â²¨ÀÌ)¹Ş¾ÆµéÀÓ, ¼ö¶ô
embraceor : n, (¹ı)(¹ı°ü, ¹è½É¿ø µîÀ»)¸Å¼öÇÏ´Â »ç¶÷
embracer : n, Æ÷¿ËÇÏ´Â »ç¶÷, ¹Ş¾ÆµéÀÌ´Â »ç¶÷, EMBRACEOR
embracery : n, ¹Ì¼ö
embracive : a, Æ÷°ıÀûÀÎ, Æ÷¿ËÀ» ÁÁ¾ÆÇÏ´Â
embranchment : n, (°ñÂ¥±â, »ê°è, ÇÏÃµ µîÀÇ)ºĞ±â, ºĞ·ù
embrangle : vt, È¥¶õ(ºĞ±Ô)½ÃÅ°´Ù
embrasure : n, (°Ç)³ªÆÈ²ÉÃ³·³ ¾ÈÂÊÀ» ¹Ù±ùÂÊº¸´Ù ³Ğ°Ô ³½ ¹®ÀÌ³ª Ã¢±¸¸Û, (Ãà¼º)(³ªÆÈ²É ¸ğ¾çÀÇ)ÃÑ¾È
embrittle : vt, vi, ºÎ¼­Áö±â ½±°Ô ÇÏ´Ù(µÇ´Ù), ¹«¸£°Ô ÇÏ´Ù(µÇ´Ù)
embrocate : vt, ...¿¡ ¾àÀ» ¹Ù¸£´Ù..., ¿¡ ÂòÁúÇÏ´Ù
embrocation : n, (¹®¾î)µµÆ÷, (¾à¿ë)µµÆ÷¾×, ½ÀÆ÷
embroglio : n, =IMBROGLIO
embroider : vt, ÀÚ¼öÇÏ´Ù, ¼ö³õ´Ù, °úÀåÇÏ´Ù
embroiderer : n, ÀÚ¼ö¾÷ÀÚ, ¼ö³õ´Â »ç¶÷
embroidery : n, ÀÚ¼ö, ¼ö³õ±â, ÀÚ¼öÇ°, À±»ö
embroil : vt, ºĞ±Ô½ÃÅ°´Ù, ÈÛ¾µ¾î³Ö´Ù
embroilment : n, ºĞ±Ô
embrown : vt, °¥»öÀ¸·Î ¹°µéÀÌ´Ù, (ºû±òÀ»)¾îµÓ°Ô ÇÏ´Ù
embrue : vt, =IMBRUE
embrute : v, =IMBRUTE
embry- : x, (¿¬°áÇü)EMBRYOÀÇ ¶æ(¸ğÀ½ ¾Õ¿¡¼­´Â embry-)
embryo : n, a, ¹è, ÅÂ¾Æ, ¿ò, ½Ï, ¹èÀÇ, ÅÂ¾ÆÀÇ, ÃÊ±âÀÇ
embryo freezing : x, ¼öÁ¤¶õÀÇ µ¿°á º¸Á¸(¾×Ã¼ Áú¼Ò·Î ³Ãµ¿ º¸Á¸)
embryoid : n, (»ı)(µ¿½Ä¹°ÀÇ) ºÎÁ¤¹è, ¹è¾çÃ¼, (¹èÀÇ ±¸Á¶¿Í ±â´ÉÀ» °¡Áø ½Ä¹°(µ¿¹°))
embryol, : x, embryology
embryologic : a, ¹ß»ı(ÅÂ»ı)ÇĞ(»ó)ÀÇ
embryologist : n, ¹ß»ı(ÅÂ»ı)ÇĞÀÚ
embryology : n, ¹ß»ıÇĞ
embryonic : a, ¹èÀÇ, ÅÂ¾ÆÀÇ, ¹Ì¹ß´ŞÀÇ
embryo sac : x, (½Ä)¹è³¶
embryo transfer : x, (ÀÇ)¹èÀÌ½Ä(ÀÚ±Ã ³»ÀÇ ÅÂ¾Æ¸¦ ¿Ü°úÀû ¼ö´ÜÀ¸·Î ´Ù¸¥ ÀÚ±ÃÀ¸·Î ¿Å±â´Â °Í)
embus : vt, vi, (±º)¹ö½º(Æ®·°)¿¡ ÅÂ¿ì´Ù(Å¸´Ù)
embusque : n, Á¤ºÎÀÇ ÀÏÀ» ÇÏ¸ç º´¿ªÀ» ±âÇÇÇÏ´ÂÀÚ
emcee : n, vi, vt, »çÈ¸ÀÚ, »çÈ¸ÇÏ´Ù
EMCF : x, European Monetary Cooperation Fund(±İÀ¶)À¯·´ ÅëÈ­ Çù·Â ±â±İ
emeer : n, =EMIR
emend : vt, ¹®¼­ µûÀ§¸¦ ±³Á¤ÇÏ´Ù(correct)
emendable : a, ¼öÁ¤(Á¤Á¤)ÇÒ ¼ö ÀÖ´Â
emendate : vt, =EMEND
emendation : n, ±³Á¤
emendator : n, ±³Á¤(¼öÁ¤)ÀÚ
emendatory : a, ±³Á¤(¼öÁ¤)ÀÇ
emer, : x, emeritus
emerage : vi, ³ªÅ¸³ª´Ù, ÀÏ¾î³ª´Ù, ºüÁ®³ª¿À´Ù
emerald : n, a, ³ìÀ½ ¿¡¸Ş¶öµå, ¼±³ì»öÀÇ
Emerald Isle : x, ¿¡¸Ó¶öµå ¼¶(¾ÆÀÏ·£µåÀÇ ¼ÓÄª)
Emerald Lile : x, ¾ÆÀÏ·£µåÀÇ ¹ÌÄª
emergence : n, ÃâÇö, Å»Ãâ
emergency : n, ºñ»ó»çÅÂ, ±ä±ŞÇÑ, À§±Ş»çÅÂ
emergency brake : x, ¿­Â÷ µûÀ§ÀÇ ºñ»ó ºê·¹ÀÌÅ©
emergency call : x, ºñ»ó ¼ÒÁı
emergency case : x, ±¸±Ş »êÀÚ
emergency door : x, ºñ»ó±¸
emergency landing : x, (°ø)±ä±Ş(ºÒ½Ã)Âø·ú
emergency measures : x, ÀÀ±Ş Á¶Ã³
emergency power : x, Àü½Ã, ÀçÇØ½ÃÀÇ ºñ»ó ÁöÈÖ±Ç
emergency staircase : x, ºñ»ó °è´Ü
emergent : a, ºÒ½Ã¿¡³ªÅ¸³ª´Â, ¶æ¹ÛÀÇ, ±ä±ŞÇÑ
emergicenter : n, (¹Ì)ÀÀ±Ş Áø·á¼Ò, ÀÀ±Ş½Ç(¿¹¾à ¾øÀÌ °£´ÜÇÑ ±¸±Ş Ã³Ä¡¸¦ ½Ñ°ªÀ¸·Î ¹ŞÀ» ¼ö ÀÖ´Â)
emerging : a, ÃÖ±Ù »ı°Ü³­, ÃÖ±Ù¿¡ ¸¸µé¾îÁø
emeritus : a, ¸í¿¹ÅğÁ÷ÀÇ
emersed : a, (¹° ¼Ó µî¿¡¼­)³ª¿Â, ³ªÅ¸³­
emersion : n, =EMERGENCE ½Ä ¶Ç´Â ¾öÆóÈÄ ÀÏ¿ùÀÇ ÀçÇö
Emerson : n, ¹Ì±¹ÀÇ½ÃÀÎ
Emersonian : a, n, ¿¡¸Ó½¼ÀÇ(°°Àº), ¿¡¸Ó½¼ Ç³ÀÇ, ¿¡¸Ó½¼ ¼ş¹èÀÚ
Emersonism : n, ¿¡¸Ó½¼ÁÖÀÇ, (¿¡¸Ó½¼ Ç³ÀÇ)ÃÊÀıÁÖÀÇ
emery : n, ±İ°­»ç
Emery : n, ³²ÀÚ ÀÌ¸§
emery bag : x, ±İ°­»ç ÁÖ¸Ó´Ï(¹Ù´Ã ¿¬¸¶¿ë)
emery board : x, ¼ÕÅéÁÙ
emery cloth : x, »çÆ÷, ¼Ó»õ(¿¬¸¶¿ë)
emery paper : x, ±İ°­»ç·Î ¸¸µé »çÁö, ¼Ó»õ
emery wheel : x, ±İ°­»ç·Î ¸¸µç È¸Àü ¼ıµ¹
Emeter : n, ÇÇºÎÀÇ Àü±â ÀúÇ× º¯È­¸¦ ÃøÁ¤ÇÏ´Â ÀüÀ§°è(°ÅÁş¸» Å½Áö±â¿Í ºñ½ÁÇÑ ÀåÄ¡)
emetic : a, n, ÅäÇÏ°ÔÇÏ´Â
emeu : n, =EMU
emeute : n, (F)Æøµ¿, ¹İ¶õ
emf : x, electromotive force(Àü)±âÀü·Â, Àüµ¿·Â
EMF : x, European Monetary FundÀ¯·´ ÅëÈ­ ±â±Ş
EMG : x, electromyograph(ÀÇ)±ÙÀü ±â·Ï ÀåÄ¡
emia : x, (¿¬°áÇü)(...ÇÑ Ç÷¾×À» °¡Áø »óÅÂ, Ç÷¾× Áß¿¡ ...À» °¡Áø »óÅÂ)ÀÇ ¶æ
emic : a, (¾ğ)ÀÌ¹ÌÅ©ÀûÀÎ(¾ğ¾î, ¹®È­ Çö»ó µîÀÇ ºĞ¼®, ±â¼ú¿¡ ÀÖ¾î¼­ ±â´É¸éÀ» Áß½ÃÇÏ´Â °üÁ¡¿¡ °üÇØ¼­ ¸»ÇÔ)
emigrant : a, n, ÀÌÁÖÇÏ´Â, ÀÌ¹Î
emigrate : vi, vt, ÀÌÁÖÇÏ´Ù
emigration : n, ÀÌÁÖ
emigration tax : x, =EXIT TAX
emigratory : a, ÀÌÁÖÀÇ, ÀÌÁÖ¿¡ °üÇÑ, (Á¶·ù°¡)ÀÌÁÖ¼ºÀÇ
emigre : n, ÀÌ¹Î, ¸Á¸íÇÑ ¿Õ´ç¿ø
Emil : n, ³²ÀÚ ÀÌ¸§
Emilia : n, ¿©ÀÚ ÀÌ¸§
eminence : n, ³ôÀº°÷, ¾ğ´ö, °í±Í, Å¹¿ù, Àú¸í, ÀüÇÏ
eminence grise : n, (F=gray cardinal), ½Éº¹ ¾ÕÀâÀÌ, ¼ûÀº ½Ç·ÂÀÚ, ¹èÈÄ ÀÎ¹°
eminency : n, =EMINENCE
eminent : a, ¿ì¼öÇÑ, À¯¸íÇÑ, ÇöÀúÇÑ
eminent domain : x, (¹ı)ÅäÁö ¼ö¿ë±Ç
emiocytosis : n, (»ı)(¼¼Æ÷ÀÇ)¹èÃâ ÀÛ¿ë, ¹èÃâ °úÁ¤ÀÇ ÇÏ³ª
emir : n, ¾Æ¶óºñ¾ÆÀÇ ´ë°ø, Á·Àå, MohammedÀÇ ÀÚ¼ÕÀ» ºÎ¸£´Â ÄªÈ¿, ÅÍÅ°ÀÇ °í°ü ÄªÈ£
emirate : n, EMIRÀÇ °üÇÒ ±¸¿ª(±ÇÇÑ), ¼öÀå±¹
emissary : n, ¹Ğ»ç, »çÀÚ, °£Ã¸
emission : n, ¹æ»ç, ¹ß»ê, ¹ßÇà
emissive : a, ¹æ»ç¼ºÀÇ, ¹æÃâÀûÀÎ, ¹æ»ç(¹æÃâ)µÈ
emissivity : n, (¹°, È­)¹æ»çÀ², º¹»ç´É
emit : vt, ³»´Ù, ¹ßÇÏ´Ù, ¹ßÇàÇÏ´Ù
emitter : n, ¹æ»çÃ¼, (¹ı·É µîÀÇ)¹ßÆ÷ÀÚ, (ÁöÆó µîÀÇ)¹ßÇàÀÎ, (ÀüÀÚ)ÀÌ¹ÌÅÍ(Æ®·£Áö½ºÅÍÀÇ Àü±ØÀÇÇÏ³ª)
Emma : n, ¿©ÀÚ ÀÌ¸§
Emmanuel : n, ³²ÀÚ ÀÌ¸§
Emmeline : n, ¿©ÀÚ ÀÌ¸§
emmenagogue : n, (¾à)¿ù°æ ÃËÁø¾à, Åë°æÁ¦
Emment(h)aler : n, ¿¡¸àÅ»(Ä¡Áî)
emmet : n, (°í, ¹æ)°³¹Ì
emmetropia : n, (¾È°ú)Á¤½Ã¾È
Emmy : n, ¿¡¹Ì»ó(¹Ì±¹ÀÇ TV¿¹¼ú»ó)
Emmy Award : x, ¿¡¹Ì»ó(¹Ì±¹ÀÇ ÅÚ·¹ºñÁ¯ ¿ì¼ö ÇÁ·Î, ¿ì¼ö ¿¬±âÀÚ, ±â¼úÀÚ µî¿¡°Ô ¸Å³â 1È¸ ¼ö¿©µÇ´Â »ó)
EmnE, : x, Early Modern English
emollient : a, n, ºÎµå·´°ÔÇÏ´Â, ¿ÏÈ­ÇÏ´Â, ¿¬È­Á¦
emolument : n, ±Ş·á, º¸¼ö
emote : vi, °úÀåµÈÇàµ¿À»ÇÏ´Ù, Á¤¼­¸¦ º¸ÀÌ´Ù, °¨Á¤À» ³»´Ù
emotion : n, °¨µ¿, Á¤¼­
emotional : a, °¨Á¤ÀÇ, °¨Á¤ÀûÀÎ, Á¤¿¡ ¹«¸¥
emotionalism : n, °¨°İ¼º, °¨Á¤¿¡ È£¼ÒÇÔ, °¨Á¤ ³ëÃâ °æÇâ
emotionalist : n, °¨Á¤ÀûÀÎ »ç¶÷, °¨Á¤°¡, Á¤¿¡ ¹«¸¥ »ç¶÷, °¨°İ¼ºÀÇ »ç¶÷, °¨Á¤¿¡ È£¼ÒÇÏ´Â ÀÛ°¡, ÁÖÁ¤ÁÖÀÇÀÚ
emotionalistic : a, 
emotionality : n, °¨°İ¼º, °¨µ¿¼º, Á¤¼­¼º
emotionalize : Á¤¼­ÀûÀ¸·Î ÇÏ´Ù, °¨Á¤ÀûÀ¸·Î Ãë±ŞÇÏ´Ù, °¨Á¤¿¡  °­ÇÏ°Ô È£¼ÒÇÏ´Ù, ¸÷½Ã °¨µ¿½ÃÅ°´Ù, °¨Á¤Àû(ºñÀÌ¼ºÀû)ÀÎ ¾ğµ¿À» ÇÏ´Ù
emotionally : ad, Á¤¼­ÀûÀ¸·Î
emotionless : a, ¹«Ç¥Á¤ÇÑ, ¹«°¨µ¿ÀÇ, °¨Á¤ÀÌ ´ã±âÁö ¾ÊÀº, °¨Á¤À» ³ªÅ¸³»Áö ¾Ê´Â
emotive : a, °¨Á¤ÀÇ(¿¡ °üÇÑ), (¾î±¸ µîÀÌ)°¨Á¤À» ³ªÅ¸³»´Â, °¨Á¤ Ç¥ÃâÀÇ, °¨Á¤¿¡ È£¼ÒÇÏ´Â, °¨µ¿ÀûÀÎ, emotively, ad
emotivity : n, °¨µ¿¼º
EMP : x, electromagnetic pulse ÀüÀÚ ÆŞ½º
Emp, : x, Emperor, Empress
empale : vt, =IMPALE
empanada : n, (¿ä¸®)(Áß³²¹ÌÀÇ)½ºÆäÀÎ½Ä ÆÄÀÌ ¿ä¸®(°í±â, »ı¼±, ¾ßÃ¤ µîÀ» Àç·á·Î »ç¿ë)
empanel : v, =IMPANEL
empaquetage : n, ÆĞÅ°Áö (¿¹¼ú)ÀÛÇ°(Äµ¹ö½º µîÀ¸·Î ¹°°ÇÀ» ½Î°í ¹­¾î¼­ ¸¸µé¾î ³»´Â °³³ä¿¹¼úÀÇ ÇÑ ¼ö¹ı)
empathic : a, °¨Á¤ ÀÌÀÔÀÇ(¿¡ ÀÔ°¢ÇÑ), empathically, ad
empathize : vt, vi, °¨Á¤ ÀÌÀÔÇÏ´Ù, ¸¶À½À¸·ÎºÎÅÍ °ø°¨ÇÏ´Ù
empathy : n, °¨Á¤ÀÌÀÔ(»ó´ë¹æÀÇ °¨Á¤ÀÇ ¿ÏÀüÇÑ ÀÌÇØ)
empennage : n, (F)(°ø)(ºñÇà±â, ºñÇà¼±ÀÇ)¹ÌºÎ, ¹ÌÀÍ
emperor : n, È²Á¦
emperor moth : x, »ê´©¿¡³ª¹æ
emperor penguin : x, (Á¶)¿¥ÆÛ·¯(È²Á¦)Æë±Ï(°¡Àå Å« Á¾·ù)
empery : n, (½Ã, ¹®¾î)È²Á¦ÀÇ ¿µÅä(ÅëÄ¡±Ç), ±¤´ëÇÑ ¿µÅä(±Ç·Â)
emphasis : n, °­Á¶, °­¼¼, ¾î¼¼, ¹®¼¼
emphasize : vt, °­Á¶ÇÏ´Ù
emphatic : a, ¾î¼¼°¡°­ÇÑ, °­Á¶ÇÑ, ´ÜÈ£ÇÑ, Àı´ëÀûÀÎ, µÎµå·¯Áø
emphatically : ad, °­ÇÏ°Ô
emphysema : n, ±âÁ¾
empire : n, Á¦±¹, Àı´ë Áö¹è±Ç
empire builder : x, (¿µÅä È®ÀåÀ» ²ÒÇÏ´Â)Á¦±¹ÁÖÀÇÀÚ, ÀÚ±âÀÇ ¼¼·Â È®´ë¿¡ ÁÖ·ÂÇÏ´Â »ç¶÷
Empire City : x, ´º¿å½Ã
Empire Day : x, =COMMONWEALTH DAY
Empire State : x, New YorkÁÖÀÇ ¼ÓÄª
Empire State Building : x, ¿¥ÆÄÀÌ¾î ½ºÅ×ÀÌÆ® ºôµù(´º¿å½Ã¿¡ ÀÖ´Â, Áö»ó102ÃşÀÇ °íÃş °Ç¹°, ÅÚ·¹ºñÁ¯ Å¾À» Æ÷ÇÔÇÑ ³ôÀÌ´Â¾à 449¹ÌÅÍ)
empiric : n, °æÇèÁÖÀÇÀÚ, µ¹ÆÈÀÌ ÀÇ»ç, °æÇèÀÇ, °æÇèÀûÀÎ, µ¹ÆÈÀÌ ÀÇ»ç °°Àº
empirical : a, °æÇèÀûÀÎ, °æÇè(½ÇÇè)»óÀÇ, (È­)½ÇÇè½Ä, °æÇèÁÖÀÇÀÇ(ÀÇ»ç µî), empirically°æÇèÀûÀ¸·Î, ad
empiricism : n, °æÇèÁÖÀÇ
empiricist : n, °æÇèÁÖÀÇÀÚ, (Ã¶ÇĞ»óÀÇ)°æÇè·ĞÀÚ, EMPIRIC
emplace : vt, (Æ÷»óÀ»)¼³Ä¡ÇÏ´Ù
emplacement : n, ¼³Ä¡, °íÁ¤, À§Ä¡
emplane : vi, vt, ºñÇà±â¿¡Å¸´Ù
employ : vt, °í¿ëÇÏ´Ù, ¾²´Ù, ¼ÒºñÇÏ´Ù, ...¿¡ Á¾»çÇÏ´Ù, °í¿ë, »ç¿ë, ...¿¡ °í¿ëµÇ¾î, ½ÇÁ÷ÇÏ´Ù
employability : n, 
employable : a, (»ç¶÷ÀÌ)°í¿ëÇÏ±â¿¡ ÀûÇÕÇÑ
employe : n, (F)=EMPLOYEE
employed : a, ÃëÁ÷(Ãë¾÷)ÇÏ°í ÀÖ´Â, °í¿ëÀÚµé, ³ëµ¿ÀÚ(º¸Åë ÇÑ ³ª¶ó, ÇÑÁö¿ªÀÇ Ãë¾÷ÀÚ ÀüÃ¼¸¦ ¸»ÇÔ)
employee : n, °í¿ëÀÎ, Á¾¾÷¿ø
employer : n, °í¿ëÁÖ
employment : n, °í¿ëÁ÷
employment agency : x, (¹Î°£ÀÇ)Á÷¾÷ ¼Ò°³¼Ò(¾È³»¼Ò)
employment bureau : x, (¹Ì)Á÷¾÷ ¾ÈÁ¤¼Ò
employment exchange(office) : x, (¿µ)°ø°ø Á÷¾÷ ¾ÈÁ¤¼Ò
Employment Service Agency : x, (¿µ)Á÷¾÷ ¾ÈÁ¤±¹, °í¿ë ¼­ºñ½ºÃ», Áö¾÷ ¼Ò°³¼Ò
empoison : vt, (°í, ¹®¾î)µ¶À» ³Ö´Ù, µ¶»ìÇÏ´Ù, ¾Çµ¶ÇÑ ¸¶À½(¾Ó½É)À» Ç°°Ô ÇÏ´Ù, °İ¾Ó(°İºĞ)½ÃÅ°´Ù, ºÎÆĞ(Å¸¶ô)½ÃÅ°´Ù
empolder : vt, °£Ã´ÇÏ´Ù, ¸Å¸³ÇÏ´Ù
emporium : n, (¹®¾î)(Áß¾Ó)½ÃÀå, »ó¾÷ Áß½ÉÁö, (¹Ì)¹éÈ­Á¡, Å« »óÁ¡
empower : vt, , , ¿¡°Ô±ÇÇÑÀ»ÁÖ´Ù
empress : n, È²ÈÄ, ¿©Á¦
empress dowager : x, È²ÅÂÈÄ, ´ëºñ
empressement : n, (F)(È¯¿µ µîÀÇ)¿­ÀÇ, ¿­¼º, Ä£Àı, ¿ÂÁ¤
emprise : n, (°í, ½Ã)¿Ëµµ, ¸ğÇè, ´ã´ëÇÑ ¿ë±â
emptily : ad, ¸ÛÇÏ°Ô, °øÇãÇÏ°Ô
emptiness : n, °ø, (¼ÓÀÌ)ºö, (¸¶À½, »ç»ó, ³»¿ë µîÀÇ)ÅÖ ºö, °øÇã, µ¡¾øÀ½, ¹«Áö, ¹«ÀÇ¹Ì, ºó °÷, °øº¹
empty : a, ºó, ºñ¾îÀÖ´Â, °øÇãÇÑ, ¹«ÀÇ¹ÌÇÑ, ¹è°íÇÂ, ºñ¿ì´Ù, ºñ´Ù
empty calorie : x, ´Ü¹éÁú, ºñÅ¸¹Î µîÀ» Æ÷ÇÔÇÏÁö ¾ÊÀº ½Ä¹°ÀÇ Ä®·Î¸®
emptyhanded fake : x, ÄõÅÍ¹éÀÌ ºó ¼ÕÀ¸·Î °øÀ» ´øÁö´Â ½Ã´¿À» ÇÏ´Â °Í
emptyheaded : a, ¸Ó¸®°¡ ÅÖºó, ¹«½ÄÇÑ
empty nester : x, (±¸)ÀÚ½ÄÀÌ ¾ø´Â »ç¶÷(ºÎºÎ), ÀÚ½Äµé°ú µû·Î »ç´Â ¿Ü·Î¿î ºÎºÎ
empty nest  syndrome : (Á¤ÀÇ)¼ºÀåÇÑ ÀÚ½ÄµéÀÌ  ´Ù ¶°³ª¹ö¸° ³ë³â  ºÎºÎ¿¡°Ô ÈçÈ÷ ³ªÅ¸³ª´Â  ÁõÈÄ±º(Á¤½ÅÀû ºÒ¾ÈÁ¤°ú  ¿ì¿ïÁõÀ» ¼ö¹İÇÏ´Â ÇãÅ»°¨)
empty set : x, (¼ö)°øÁıÇÕ
empurple : vt, ÀÚÁÖºûÀ¸·Î ÇÏ´Ù(¹°µéÀÌ´Ù)
empyema : n, Ãà³óÁõ
empyreal : a, ÃÖ°íÃµÀÇ, ÇÏ´ÃÀÇ, Á¤È­·Î ÀÌ·ç¾îÁø
empyrean : n, È­Ãµ, Ãµ¹®ÇĞÀÇ ¿ÀÃµÁßÀÇ ÃÖ°í, Ãµ°ø
EMR : x, educable mentally retarede ±³À° °¡´ÉÇÑ Àú´É¾Æ
EMS : x, European Monetary System
EMT : x, emergency medical technician
emtyhanded : a, ºó¼ÕÀÇ, ¸Ç¼ÕÀ¸·Î
emu : n, ¿¡¹Â(Å¸Á¶ ºñ½ÁÇÑ Å« »õ, ³¯Áö ¸øÇÔ
EMU : x, extravehicular mobility unit¿ìÁÖ¼±¹ÛÈ°µ¿¿ë ¿ìÁÖº¹
emulate : vt, ...¿Í ¿ì¿­À» ´ÙÅõ´Ù(strive to equal or excel)
emulation : n, 
emulative : a, °æÀïÀÇ, ÁöÁö¾ÊÀ¸·Á´Â, emulatively, ad
emulator : n, °æÀïÀÚ
emulgent : a, n, ÂøÃâ¼ºÀÇ, ½Å Ç÷°üÀÇ, ½ÅÀå Á¤¸ÆÀÇ, (ÇØ)½ÅÇ÷°ü, ½ÅÀå Á¤¸Æ, ÀÌ´¢Á¦
emulous : a, °æÀï½ÉÀÌ°­ÇÑ, ¿­¸ÁÇÏ´Â
emulsification : n, À¯Á¦È­
emulsify : vt, Á¥°°ÀÌ¸¸µé´Ù
emulsion : n, À¯Á¦
emulsion chamber : x, (¿øÀÚ¹°¸®)¿øÀÚÇÙ °ÇÆÇÀ» ¿¬ÆÇ »çÀÌ¿¡ ³¢¿ö Á¶¸³ÇÑ ÇÏÀüÀÔÀÚ ºñÀû ÃøÁ¤±â
emulsive : a, À¯Ã¼¼ºÀÇ, À¯»óÈ­¼ºÀÌ ÀÖ´Â, À¯Á¦È­ÇÒ ¼ö ÀÕ´Â
emunctory : n, a, (»ı¸®)¹èÃâ±â(°ü)(ÇÇºÎ, ½ÅÀå, Æó µî), ¹èÃâÀÇ, ¹èÃâ±â(°ü)ÀÇ
en : n, NÀÚ, (ÀÎ)¹İ°¢(Àü°¢)
en : pref, (F)...¿¡(ÀÖ¾î¼­), À¸·Î, À¸·Î¼­
en- : pref, µ¿»ç¸¦ ¸¸µê
enable : vt, ...ÇÒ¼öÀÖ°ÔÇÏ´Ù
enabling : a, (¹ı·üÀÌ)(Æ¯º°ÇÑ)±Ç´ÉÀ» ºÎ¿©ÇÏ´Â, ÇÕ¹ıÈ­ÇÏ´Â
enabling act (statute) : x, (¹ı)±Ç´É ºÎ¿©¹ı, ¼ö±Ç¹ı
enact : vt, ¹ı·üÈ­ÇÏ´Ù, Á¦Á¤ÇÏ´Ù, ¿ªÀ» ÇÏ´Ù
enacting clause : x, (¹ı)Á¦Á¤ Á¶Ç×(¹ı·ü¾È ¶Ç´Â Á¦Á¤¹ıÀÇ ¼­µÎ ¹®±¸)
enaction : n, =ENACTMENT
enactive : a, ¹ı·ü Á¦Á¤ÀÇ, Á¦Á¤±Ç(ÀÔ¹ı±Ç)À» °¡Áö´Â
enactment : n, Á¦Á¤, ¼³Á¤, ¹ı·É
enactor : n, 
enamel : n, vt, ¿¡³ª¸á, À¯¾à, ¹ı¶û
enameled : a, ¿¡³ª¸á(µµ·á)¸¦ ÀÔÈù, ¹ı¶ûÀ» Ä¥ÇÑ
enamelware : n, ¹ı¶û Ã¶±â
enamine : n, (È­)¿¡³ª¹Î(ÀÌÁß°áÇÕ Åº¼Ò¸¦ °¡Áø ¾Æ¹Î)
enamor : vt, ¸ÅÈ¤ÇÏ´Ù(be enamored fl ...¿¡ ¸ÅÈ¤µÇ´Ù(¹İ»çÇÏ´Ù))
enamored : a, ¸ÅÈ¤µÈ, È¦µü ¹İÇÑ, »ç¶û¿¡ ºüÁø
enantiomorph : n, °æ»óÃ¼
enarchist : n, (ÇÁ¶û½ºÀÇ)±¹¸³ ÇàÁ¤ ÇĞ¿ø(ENA)Ãâ½ÅÀÇ °í±Ş °ø¹«¿ø
enarthrosis : n, (ÇØ)±¸¿Í°üÀı
en attendant : ad, ±â´Ù¸®°í ÀÖ´Â »çÀÌ¿¡, ±â´Ù¸®¸é¼­, ±× »çÀÌ¿¡
en bloc : ad, ÀÏ°ıÇÏ¿©, ÃÑ°ıÀûÀ¸·Î
enbodiment : n, ±¸Ã¼È­, ±¸Çö, È­½Å
enc, : x, enclosure
encaenia : n, Ã¢¸³±â³äÁ¦, ¿Á½ºÆÛµå ´ëÇÏ°¡ Ã¢¸³ ±â³äÁ¦
encage : vt, »õÀå¿¡³Ö´Ù, °¡µÎ´Ù
encamp : vt, vi, ÁøÀ»Ä¡´Ù
encampment : n, ¾ß¿µ(ÇÔ), ¾ß¿µÁö, ÁøÁö, (ÁıÇÕÀû)¾ß¿µÀÚ
encapsidate : vt, (»ıÈ­)(¼¼Æ÷³»¿¡¼­)(¹ÙÀÌ·¯½º ÀÔÀÚ¸¦)´Ü¹éÁú¸·À¸·Î ½Î´Ù
encapsidation : n, 
encapsulate : vt, Ä¸½¶¿¡ ³Ö´Ù(½Î´Ù), (»ç½Ç, Á¤º¸ µîÀ»)¿ä¾àÇÏ´Ù, Ä¸½¶¿¡ µé¾î°¡´Ù(½ÎÀÌ´Ù)
encapsulation : n, 
encase : vt, ³Ö´Ù, ½Î´Ù, µÑ·¯½Î´Ù
encash : vt, Çö±İÈ­ÇÏ´Ù, Çö±İÀ¸·Î ¹Ş´Ù
encaustic : a, n, ³³È­, ³«È­
enceinte : a, ÀÓ½ÅÇÏ¿©
encephal- : x, (¿¬°áÇü)(³ú)ÀÇ ¶æ(¸ğÀ½ ¾Õ¿¡¼­´Â encephal-)
encephalalgia : n, (ÀÇ)µÎÅë
encephalic : a, ³ú¼öÀÇ(¿¡ °ü°è°¡ ÀÖ´Â)
encephalitic : a, ³ú¿°ÀÇ
encephalitis : n, ³ú¿°
encephalitis lethargica : x, (º´¸®)±â¸é¼º ³ú¿°
encephalitogen : n, (ÀÇ)³ú¿° À¯¹ß ¹°Áú
encephalization : n, (»ı)´ë³úÈ­(ÇÇÁú ÁßÃß·ÎºÎÅÍ ÇÇÁú¿¡ÀÇ ±â´ÉÀÇ ÀÌµ¿)
encephalization quotient : x, (»ı)´ë³úÈ­ Áö¼ö(Ã¼Áß°ú ³úÁß·®°úÀÇ °ü°è Áö¼ö)
encephalo- : x, (¿¬°áÇü)=ENCEPHAL-
encephalogram : n, ³úÁ¶¿µµµ
encephalography : n, (ÀÇ)³ú ¿¢½º·¹ÀÌ ÃÔ¿µ¹ı
encephalomyelitis : n, ³úÃ´¼ö¿°
encephalomyocarditis : n, (ÀÇ)³úÃ´¼ö ½É±Ù¿°
encephalon : n, ³ú, ´ë³ú
enchain : vt, ¼Ó¹ÚÇÏ´Ù, »ç½½·Î¸Å´Ù, °­ÇÏ°Ô ²ø´Ù
enchainement : n, (F)(¹ß·¹)¾Ó¼Ï¸Á
enchant : vt, ¸¶¼úÀ»°É´Ù, ¸ÅÈ¤ÇÏ´Ù
enchanter : n, ¸Å·ÂÀÖ´Â »ç¶÷, ¸ÅÈ¤ÇÏ´Â »ç¶÷, ¸¶¹ı»ç, ¿ä¼úÀïÀÌ
enchanting : a, ¸ÅÈ¤ÀûÀÎ
enchantment : n, ¸ÅÈ¤
enchantress : n, ¿©ÀÚ ¿ä¼úÀïÀÌ, ¸¶³à, ¸ÅÈ¤ÀûÀÎ ¿©ÀÚ
enchase : vt, »õ±â´Ù, ¹Ú¾Æ³Ö´Ù, »ó°¨ÇÏ´Ù
enchilada : n, ¾ãÀº ¿Á¼ö¼ö »§¿¡ ±â°è·Î Àú¹Î °í±â¸¦ ³¢¿ö ±â¸§¿¡ Æ¢°Ü chili¼Ò½º¸¦ Ä£ ¸ß½ÃÄÚ ¿ä¸®
enchiridion : n, Æí¶÷, ±³º» ¾È³»¼­
encina : n, (½Ä)(¹Ì±¹ ³²¼­ºÎ»êÀÇ)¶±°¥³ª¹«ÀÇ ÀÏÁ¾
encipher : vt, ¾ÏÈ£·Î ¹Ù²Ù´Ù
encircle : vt, µÑ·¯½Î´Ù, ÀÏÁÖÇÏ´Ù
encirclement : vt, ÀÏÁÖ, Æ÷À§, °í¸³È­(Àû¼º ±¹°¡±º¿¡ ÀÇÇÑ Æ÷À§)
en clair : ad, (F)(¾ÏÈ£°¡ ¾Æ´Ñ)º¸Åë ¸»·Î
enclasp : vt, ¿òÄÑÁã´Ù, Àâ´Ù ²¸¾È´Ù
enclave : n, °í¸³µÈ¿µÅä
enclitic : a, n, ÀüÁ¢¾î, ÀüÁ¢
enclose : vt, ¿¡¿ö½Î´Ù, µÎ¸£´Ù, ³Ö´Ù, µ¿ºÀÇÏ´Ù
enclosure : n, ¿ï, ´ã, ¿ïÅ¸¸®, ¿ï¾È, ±¸³», (15, 18¼¼±â¿¡ ´ëÁöÁÖ°¡ ±³È¯ ºĞÇÕ¿¡ ÀÇÇÏ¿© ÇÑ °÷¿¡ ¸ğÀº)Á¾È¹Áö
Enclosure Acts : x, (¿µ)°øÀ¯ÁöÀÇ »çÀ¯ÁöÈ­ ¹ı·É(°øÀ¯Áö¸¦ »çÀ¯Áö·Î ¿ï¸·´Â µ¥ °üÇÑ ¹ı·É)
enclothe : vt, =CLOTHE
encloud : vt, ±¸¸§À¸·Î ½Î´Ù(µ¤´Ù)
encode : vt, vi, ¾ÏÈ£È­ÇÏ´Ù
encoder : n, ºÎÈ£±â(ÄÄÇ»ÅÍ)
encomiast : n, ¿¹Âù°¡
encomiastic : a, Âù¹ÌÀÇ, ÄªÂùÀÇ, ¾ÆºÎÇÏ´Â, ÃßÁ¾ÀûÀÎ
encomium : n, Âù»ç, Âù¹Ì
encompass : vt, Æ÷ÇÔÇÏ´Ù, µÑ·¯ ½Î´Ù
encore : int, n, vt, ¾ÓÄÚ¸£ÇÏ´Ù
encounter : n, vi, vt, ¿ì¿¬È÷¸¸³², È¸Àü
encourage : vt, ±â¿îÀ»ºÏµ¸¾ÆÁÖ´Ù, °İ·ÁÇÏ´Ù, Á¶ÀåÇÏ´Ù
encouragement : n, °İ·ÁÇÔ
encouraging : a, °İ·Á(Àå·Á)ÀÇ, ÈûÀ» ºÏµ¸¾Æ ÁÖ´Â, À¯¸ÁÇÑ
encowment insurance : x, ¾ç·Î º¸Çè
encrimson : vt, »õ»¡ˆ, °Ô ¹°µéÀÌ´Ù
encrinite : n, (µ¿)°¹³ª¸®, °¹³ª¸®ÀÇ È­¼®
encroach : vt, Ä§ÀÔÇÏ´Ù
encroacher : n, Ä§ÀÔ(Ä§ÇØ)ÀÚ
encroachment : n, Àá½Ä, Ä§·«, Ä§ÇØ, Ä§½ÄÁö, Ä§·«Áö
encrust : vt, ²®Áú·Î µ¤´Ù
encrypt : vt, vi, =ENCODE
encryption : n, 
enculturation : n, (»çÈ¸)¹®È­È­, ¹®È­ ÀûÀÀ
encumber : vt, ¹æÇØÇÏ´Ù...À¸·Î ¸·´Ù, ¹ø°Å·Ó°Ô ÇÏ´Ù, ºúÀ»Áö°Ô ÇÏ´Ù
encumbrance : n, ¹æÇØ, Àå¾Ö, °ñÄ©°Å¸®
ency : suf, (¼ºÁú, »óÅÂ¸¦ ³ªÅ¸³»´Â ¸í»ç ¾î¹Ì)
encyc : x, encyclopaedia
encyclic : a, n, È¸¶÷ÀÇ, ·Î¸¶ ±³È²ÀÇ È¸Àå
encyclopaedia : n, ¹é°ú»çÀü(ÇÁ¶û½ºÀÇDiderot, d'AlembertµîÀÌ °øµ¿ ÆíÁıÇÑ)¹é°ú Àü¼­
Encyclopaedia britannica : x, ´ë¿µ ¹é°ú »çÀü
encyclopedic : a, ¹é°ú »çÀüÀûÀÎ, (»ç¶÷, Áö½ÄÀÌ)ÇØ¹ÚÇÑ, ¹ÚÇĞÀÇ
encyclopedist : n, ¹é°ú »çÀü ÆíÁıÀÚ
encyst : vt, (»ı)Æ÷³¶¿¡ ½Î´Ù
encystation : n, (»ı)Æ÷³¶ Çü¼º
encystment : n, (»ı)Æ÷³¶ Çü¼º
end : n, vt, vi, ³¡, ¸¶Áö¸·, Á¾¸», ¸ñÀû, °á°ú, Á¶°¢, ÀüÀ§, ºóµÕºóµÕ, ¹ÌÇØ°á·Î, ¾îÂîÇÒ ¹Ù¸¦ ¸ğ¸£°í, ¹«Á÷À¸·Î, »ê¶õÇÏ¿©, ³¡¸¶Ä¡´Ù, ±×¸¸µÎ´Ù, Á×ÀÌ´Ù
END : x, European Nuclear Disarmament
end- : x, (¿¬°áÇü)(³»ºÎ, Èí¼ö)ÀÇ ¶æ
endall : n, Á¾°á, ´ë´Ü¿ø, ¸¸»çÀÇ °á¸»
endamage : vt, =DAMAGE
endameba : n, ¿£µå¾Æ¸Ş¹Ù(¾Æ¸Ş¹Ù Àû¸®ÀÇ º´¿ø±Õ)
endanger : vt, À§ÅÂ·Ó°ÔÇÏ´Ù
endangered : a, (µ¿½Ä¹°ÀÌ)¸êÁ¾µÉ Áö°æ¿¡ ÀÌ¸¥
endangered species : x, ¸êÁ¾ À§±â¿¡ Ã³ÇÑ µ¿½Ä¹°ÀÇ Á¾
end around : x, (¹Ì)¿£µå ¾î¶ó¿îµå(º¼À» ¹ŞÀº °ø°İÆÀÀÇ end°¡ ¶óÀÎ ¹İ´ëÃøÀ¸·Î ¿ìÈ¸ÇÏ¿© ÀüÁøÇÏ´Â Æ®¸¯ ÇÃ·¹ÀÌ)
endblown : a, (°ü¾Ç±â µî)ÀÔÀ» ´ë°í ºÎ´Â ÁÖµÕÀÌ°¡ ´Ş·Á ¼¼·Î·Î ºÎ´Â
end consumer : x, ÃÖÁ¾ ¼ÒºñÀÚ
endear : vt, »ç¶û½º·´°Ô¿©±â°Ô ÇÏ´Ù, ±×¸®¿öÁö°Ö ÇÏ´Ù
endearing : a, »ç¶û½º·¯¿î
endearment : n, Ä£¾Ö, (ÇàÀ§, ¸»¿¡ ÀÇÇÑ)¾ÖÁ¤ÀÇ Ç¥½Ã, ¾Ö¹«
endeavor : n, vi, vt, ³ë·ÂÇÏ´Ù
endemic : a, n, Ç³Åäº´ÀÇ, Ç³Åäº´
endemical : a, =ENDEMIC
endemism : n, ÇÑ Áö¹æÀÇ Æ¯À¯¼º, °íÀ¯¼º, Ç³Åä¼º
endermic : a, (ÀÇ)ÇÇºÎ¿¡ Ä§ÅõÇÏ¿© ÀÛ¿ëÇÏ´Â, ÇÇºÎ¿¡ ¹Ù¸£´Â, ÇÇ³»ÀÇ, endermically, ad
en deshabille : ad, (F)Æòº¹À¸·Î, ¾à½Ä º¹ÀåÀ¸·Î
end game : x, (Ã¼½º, ½ÃÇÕÀÇ)ÃÖÁ¾È¸, ¸·ÆÇ
endgate : n, (Æ®·°ÀÇ)ÀûÀçÇÔÀÇ µŞ´İÀÌ¹®
ending : n, °á¸», Á¾°á, ¸»¹Ì, ¾î¹Ì
endistance : vt, (¿¬±Ø µîÀÌ °ü°´¿¡°Ô)°Å¸®°¨À» °¡Áö°Ô ÇÏ´Ù, °ü°´À» ÀÌÈ­ÇÏ´Ù
endive : n, ²É»óÃß(»ø·¯µå¿ë)
endleaf : n, =ENDPAPER
endless : a, ³¡¾ø´Â, ¹«ÇÑÇÑ, ¿µ¿øÇÑ, ¼øÈ¯ÀÇ
endlessly : ad, ³¡(ÇÑ)¾øÀÌ, °¡ÀÌ¾øÀÌ, ¿µ±¸È÷
end line : x, ³¡(ÇÑ°è, °æ°è)À» ³ªÅ¸³»´Â ¼±, (Å×´Ï½º, ³ó±¸, ¹Ì½Ä Ãà±¸ µîÀÇ)¿£µå ¶óÀÎ
endlong : ad, (°í)¼¼·Î·Î, ¶È¹Ù·Î ¼­¼­
end man : x, ¿­ ³¡ÀÇ »ç¶÷, ¼îÀÇ ¹«´ë ¾ç³¡¿¡ ÀÖ´Â ÈæÀÎ ±¤´ë
end matter : x, (ÀÎ)Ã¥ÀÇ ºÎ·Ï(ÁÖ¼®, Âü°í ¹®Çå ¸ñ·Ï, »öÀÎ µî)
endmost : a, ¸»´ÜÀÇ
endnote : n, (Ã¥ÀÇ)±Ç¸»¿¡ ÀÖ´Â ÁÖ
endo- : x, (¿¬°áÇü)=END-
endobiotic : a, »ı¹°Ã¼³»¿¡ »ç´Â(¼÷ÁÖ¿¡ ±â»ıÇÏ´Â)
endoblast : n, (»ı)³»¹è¿±
endocardial : a, (ÇØ)½ÉÀå³»ÀÇ, ½ÉÀå ³»¸·ÀÇ
endocarditis : n, (º´¸®)½ÉÀå ³»¸·¿°
endocardium : n, (ÇØ)½ÉÀå ³»¸·
endocarp : n, ³»°úÇÇ
endocast : n, µÎ°³°­ µîÀÇ ³»ÇüÀ» ³ªÅ¸³»´Â Çü(ÀÎ»ó)
endocentric : a, (¾ğ)³»½ÉÀûÀÎ
endocrine : a, n, ³»ºĞºñÀÇ, ³»ºĞºñ¹°, È£¸£¸ó, ³»ºĞºñ¼±
endocrine gland : x, (»ı¸®)³»ºĞºñ¼±
endocrinic : a, =ENDOCRINE
endocrinology : n, (ÀÇ)³»ºĞºñÇĞ
endocrinous : a, =ENDOCRINE
endocytose : vt, (»ı)(¼¼Æ÷°¡ ÀÌ¹°À»)Èí¼öÇÏ´Ù
endocytosis : n, (»ı)¼¼Æ÷ ÀÌ¹° Èí¼ö
endoderm : n, (»ı)³»¹è¿±
endodermis : n, (½Ä)³»ÇÇ
endofday glass : x, È¥»ö À¯¸®ÀÜ
endoftape marker : x, (ÀüÀÚ)Å×ÀÌÇÁÀÇ ³¡ Ç¥½Ã¹°(ÀÚ±â Å×ÀÌÇÁÀÇ ³¡À» ³ªÅ¸³»´Â Ç¥½Ã)
endogamic : a, µ¿Á· °áÈ¥ÀÇ
endogamous : a, (»çÈ¸)µ¿Á· °áÈ¥¿¡ ÀÇÇÑ(¿¡ °üÇÑ)
endogamy : n, µ¿Á·°áÈ¥
endogen : n, (½Ä)´ÜÀÚ¿± ½Ä¹°
endogenic : a, =ENDOGENOUS 1, (ÁöÁú)³»ÀÎ¼ºÀÇ
endogenous : a, ³»ºÎ·ÎºÎÅÍ ¹ß»ıÇÏ´Â, ³»»ıÀÇ, ³»ÀÎ¼ºÀÇ
endogeny : n, (»ı)³»ÀÎ¼º ¹ßÀ°
endolymph : n, (ÇØ)(³»ÀÌÀÇ)¹Ì·Î ÀÓÆÄ, ³»ÀÓÆÄ(¾×)
endometritis : n, ÀÚ±Ã ³»¸·¿°
endomitosis : n, (»ı)ÇÙ³» À¯»ç ºĞ¿­
endomorph : n, (½É)³»¹è¿±ÇüÀÇ »ç¶÷(ºñ¸¸ÇüÀÇ), (´Ù¸¥ ±¤¹° ¾È¿¡ µç)³»Æ÷ ±¤¹°
endomorphic : a, (½É)³»¹è¿±ÇüÀÇ(ºñ¸¸ÇüÀÇ), ³»Æ÷ ±¤¹°ÀÇ
endomorphism : n, (°üÀÔ È­¼º¾Ï Áß¿¡¼­ »ı±â´Â)È¥¼ºÀÛ¿ë, (¼ö)ÀÚ±âÁØµ¿Çü
endomorphy : n, (½É)³»¹è¿±Çü
endoparasite : n, (µ¿)³»ºÎ ±â»ıÃ¼(Ãæ)(ÃÌÃæ µî)
endoperoxide : n, (»ıÈ­)¿£µµÆä·Ï½Ãµå
endophilic : a, (»ıÅÂ)ÀÎ°£(È¯°æ)°ú °ü°è°¡ ÀÖ´Â
endoplasm : n, ³»Áú
endoplasmic : a, 
end organ : x, (»ı¸®)(½Å°æÀÇ)Á¾¸» ±â°ü, ´Ü¸»±â
endorheic : a, (Áö)(¹Ù´Ù·Î Á÷Á¢ ÅëÇÏ´Â ÇÏ·ù°¡ ¾ø´Â)³»ºÎ À¯¿ªÀÇ
endorse : vt, ¹è¼­ÇÏ´Ù, º¸ÁõÇÏ´Ù
endorsee : n, ÇÇ¹è¼­ÀÎ, ¾ç¼öÀÎ
endorsement : n, ¹è¼­, º¸Áõ, ½ÃÀÎ, (»óÇ° µîÀÇ)ÃßÃµ
endorser : n, ¹è¼­(¾çµµ)ÀÎ
endosarc : n, (»ı)³»Áú, ³»ºÎ ¿øÇüÁú
endoscope : n, ³»»ç°æ(Á÷Àå, ¿äµµµîÀÇ)
endoscopy : n, (ÀÇ)³»½Ã°æ °Ë»ç(¹ı)
endoskeleton : n, (ÇØ)³» °ñ°İ
endosmosis : n, (»ı, È­)(³»)Ä§Åõ, Ä§ÀÔ
endosperm : n, ¹èÀ¯
endosteum : n, (ÇØ)°ñ³»¸·
endothelium : n, (ÇØ, µ¿)³»ÇÇ, (¼¼Æ÷ÀÇ)³»º¹ Á¶Á÷, (½Ä)³»Á¾ÇÇ
endotherm : n, ¿ÂÇ÷µ¿¹°
endothermal : a, Èí¿­¼ºÀÇ, Èí¿­¹İÀÀÀÇ
endotoxin : n, (»ıÈ­)(±ÕÃ¼)³»µ¶¼Ò
endotoxoid : n, a, (±ÕÃ¼)³»µ¶¼Ò¿¡¼­ ¾òÀ» ¼ö ÀÖ´Â º¯¼º µ¶¼Ò(ÀÇ)
endow : vt, ±â±İÀ»±âºÎÇÏ´Ù, ÀÚÁú, ´É·Â µûÀ§¸¦ ºÎ¿©ÇÏ´Ù
endowment : n, ±âºÎ
endowment assurance : x, (¿µ)=ENDOWMENT INSURANCE
endpaper : n, »öÀÇ ¸éÁö
end point : x, Á¾·áÁ¡, Á¾Á¡, (È­)(ÀûÁ¤ÀÇ)Á¾Á¡, =ENDPOINT
endpoint : n, (¼ö)´ÜÁ¡, Á¾Á¡(¼±ºĞÀÌ³ª ±¤¼±ÀÇ ³¡À» ³ªÅ¸³»´Â Á¡)
end product : x, ¿¬¼Ó º¯È­ÀÇ ÃÖÁ¾°á°ú, ÃÖÁ¾ »ı¼º¹°
end rhyme : x, (¿î)°¢¿î
endrin : n, (È­)¿£µå¸°(»ìÃæÁ¦)
end run : x, ¿£µå·±(°øÀ» °¡Áø ¼±¼ö°¡ ¾Æ±º ¹æ¾îÁøÀÇ Ãø¸éÀ» µ¹¾Æ ÈÄ¹æÀ¸·Î ³ª°¡´Â ÇÃ·¹ÀÌ)±³¹¦ÇÑ È¸ÇÇ
endrun : vt, vi, (¹Ì±¸)Àß ÇÇÇØ¼­ °¡´Ù, Àß ºüÁ® ³ª°¡´Ù
end stop : x, ¹®¹Ì ±âÈ£
endstopped : a, Çà¸» Á¾ÁöÀÇ
Endsville : a, n, (¹Ì¼Ó)ÃÖ°íÀÇ(°Í)
end table : x, (¼ÒÆÄ, ÀÇÀÚ °ç¿¡ ³õ´Â)ÀÛÀº Å×ÀÌºí
endtoend : a, ÇÑÂÊ ³¡°ú ´Ù¸¥ ÇÑÂÊ ³¡À» ÀÕ´Â, (È¸°ú)(Àå µîÀÇ)Àı´ÜÇÑ ¸é°ú ´Ù¸¥ ÇÑ³¡À» ºÀÇÕÇÏ´Â
endue : vt, ºÎ¿©ÇÏ´Ù
endurable : a, ÂüÀ» ¼ö ÀÖ´Â, °ßµô ¼ö ÀÖ´Â, endurably, ad
endurance : n, ÀÎ³», ³»±¸¼º
endure : vt, vi, °ßµğ´Ù, Âü´Ù, °Ş´Ù, ¹Ş´Ù, ÀÎ³»ÇÏ´Ù, ÁöÅÊÇÏ´Ù
enduring : a, Âü´Â, ¿µ¼ÓÀûÀÎ
enduro : n, ÀÚµ¿Â÷µîÀÇ ³»±¸ ·¹ÀÌ½º
end use : x, ÃÖÁ¾ ¿ëµµ
end user : x, ÃÖÁ¾ ¼ö¿äÀÚ, ½Ç¼ö¿äÀÚ
end ways : ad, ³¡À» À§·ÎÇÏ°í, ¼¼·Î
Endymion : x, (±×½Å)¿£µğ¹Ì¿Â(´ŞÀÇ ¿©½Å Selene¿¡°Ô »ç¶û ¹ŞÀº ¹Ì¼Ò³â)
end zone : x, ¿£µå Á¸(°ñ¶óÀÎ°ú ¿£µå¶óÀÎ »çÀÌÀÇ ±¸¿ª)
ENE : x, eastnortheast
ene : suf, (È­)(ºÒÆ÷È­ Åº¼ÒÈ­ÇÕ¹°)ÀÇ ¶æ, (...¿¡ ÅÂ¾î³­(»ç´Â)»ç¶÷)ÀÇ ¶æ
enema : n, °üÀå±â
enemies list : x, Àû´ë ÀÎ¹° ÀÏ¶÷Ç¥
enemy : n, Àû, ¿ø¼ö, Àû±ºÀûÇÔ
energetic : a, Á¤·ÂÀûÀÎ, ¿ø±â¿Õ¼ºÇÑ
energetics : n, (¹°)¿¡³ÊÁö·Ğ(ÇĞ)
energism : n, (À±)È°µ¿ÁÖÀÇ
energize : vt, È°±â¶ì°ÔÇÏ´Ù
energizer : n, Á¤·Â(È°·Â)À» ÁÖ´Â »ç¶÷(¹°°Ç), (ÀÇ)Ç×¿ïÁ¦, Á¤½Å È°¼º ºÎ¿©Á¦
energumen : n, ±Í½Åµé¸°»ç¶÷, ±¤½ÅÀÚ
energy : n, Á¤·Â, È°±â, ¿ø±â, ¿¡³ÊÁö
energy audit : x, (½Ã¼³ÀÇ ¿¡³ÊÁö Àı°¨À» À§ÇÑ)¿¡³ÊÁö °¨»ç(Áø´Ü), energy auditor, n
energy budget : x, (»ıÅÂ°èÀÇ)¿¡³ÊÁö ¼öÁö
energy bush : x, (¿¬·á, Àü·ÂÀÌ µÇ´Â)¿¡³ÊÁö¸²
energy crisis : x, ¿¡³ÊÁö À§±â
energy flow : x, (»ıÅÂ°èÀÇ)¿¡³ÊÁö Èå¸§
energy industry : x, ¿¡³ÊÁö »ê¾÷(¼®Åº, ¼®À¯, Àü±â, °¡½º »ê¾÷ µî)
energyintensive : a, ¸¹Àº ¿¡³ÊÁö¸¦ ¼ÒºñÇÏ´Â, ¿¡³ÊÁö Áı¾àÀûÀÎ
energy park : x, (¹Ì)¿¡³ÊÁö ´ÜÁö, ¿¡³ÊÁö ÀÚ¿ø °øµ¿ ÀÌ¿ëÁö
energysaving : a, ¿¡³ÊÁö¸¦ Àı¾àÇÏ´Â
enervate : vt, ¾àÇÏ°ÔÇÏ´Ù
enervated : a, È°·ÂÀ» ÀÒÀº, ¹«±â·ÂÇÑ
enervation : n, ¿ø±â(±â·Â)»ó½Ç, ¼è¾à, ³ª¾à
enface : vt, (¾îÀ½, Áõ±Ç µîÀÇ)Ç¥¸é¿¡ ±âÀÔ(ÀÎ¼â, ³¯ÀÎ)ÇÏ´Ù, enfacement, n
en famille : ad, (F=in the family)°¡Á·ÀÌ ´ÙÇÔ²², ÈäÇã¹°¾øÀÌ, ºñ°ø½ÄÀ¸·Î
enfant cheri : n, (F=cherished infant)±Í¿°µÕÀÌ, ¼ÒÁßÇÑ °Í, ¾ÖÁöÁßÁöÇÏ´Â °Í
enfant gate : n, (F=spoilt child)¹ö¸©¾ø´Â ¾ÆÀÌ
enfant terrible : x, ¾î¸¥ »´Áú ±ôÂïÇÑ ¾ÆÀÌ
enfeeble : vt, ¾àÇÏ°ÔÇÏ´Ù, enfeeblement¼è¾àn
enfeoff : vt, ¿µÁö(ºÀÅä)¸¦ ÁÖ´Ù, (°í)(¸öÀ»)¸Ã±â´Ù
enfeoffment : n, ºÀÅä ÇÏ»ç, ºÀÅä ÇÏ»çÀå(Áõ¼­), ºÀÅä
en fete : x, (F=in festival)ÃàÁ¦ ±âºĞÀ¸·Î ¶°µé½âÇÏ¿©, ¼ºÀåÇÏ¿©
enfetter : vt, Â÷²¿¸¦ Ã¤¿ì´Ù, ¼Ó¹ÚÇÏ´Ù
enfilade : n, vt, Á¾»çÇÏ´Ù
enfold : vt, ½Î´Ù, ¾È´Ù, Æ÷¿ËÇÏ´Ù, Á¢´Ù, ÁÖ¸§Àâ´Ù
enforce : vt, ½Ç½ÃÇÏ´Ù, °­¿äÇÏ´Ù
enforceability : n, 
enforceable : n, ½Ç½Ã, °­¿ä
enforced : a, °­Á¦µÈ, °­Á¦ÀûÀÎ
enforcedly : ad, 
enforcement : n, (¹ı·üÀÇ)½ÃÇà, ÁıÇà, (º¹Á¾ µîÀÇ)°­Á¦, (ÀÇ°ß µîÀÇ)°­Á¶
enforcement officer : x, (¹Ì)(¹ı·ü µîÀÇ)½ÃÇà°ü, °æ°ü
enforcer : n, (¹ı)(¹ı·ü µîÀÇ)ÁıÇàÀÚ(ÀçÆÇ¼Ò µî), (¾ÆÀÌ½ºÇÏÅ°)»ó´ë ÆÀÀÌ °ÌÀ» ¸Ôµµ·Ï °ÅÄ£ ÇÃ·¹ÀÌ¸¦ ÇÏ´Â ¼±¼ö
enframe : vt, ±×¸² µîÀ» ¾×ÀÚ¿¡ ³¢¿ì´Ù
enfranchise : vt, ÇØ¹æÇÏ´Ù, ¼®¹æÇÏ´Ù, °ø¹Î±ÇÀ» ºÎ¿©ÇÏ´Ù
enfranchisement : n, ÇØ¹æ, ¼®¹æ
eng, : x, engine, engineer(ing), engraved, engraver, engraving
Eng, : x, England, English
Eng, D, : x, Doctor of Engineering
engage : vt, vi, Á¾»ç½ÃÅ°´Ù, ´ç±â´Ù, ¼Ó¹ÚÇÏ´Ù, ¿¹¾àÇÏ´Ù, ±³Àü½ÃÅ°´Ù, °É´Ù, º¸ÁõÇÏ´Ù, °í¿ëÇÏ´Ù, ¾à¼ÓÇÏ´Ù, ±³ÀüÇÏ´Ù, °É¸®´Ù
engage : a, °ü°èµÈ, Á¤Ä¡¿¡ °ü°èµÈ
engaged : vt, ¾à¼ÓµÈ, ¾àÈ¥ÁßÀÎ, ¿ë¹«ÁßÀÎ, ¹Ù»Û, °í¿ëµÈ, ÅëÈ­ÁßÀÎ, ±³ÀüÁßÀÎ
engagement : n, ¾àÈ¥, ¾à¼Ó, °í¿ë, ÃÊºù, ¿ë¹«
engagement ring : x, ¾àÈ¥ ¹İÁö
engager tone : x, (ÀüÈ­)ÅëÈ­Áß ½ÅÈ£À½
engaging : a, ¸¶À½ ²ô´Â, ¸Å·Â ÀÖ´Â
en garcon : ad, (F)µ¶½ÅÀÚ·Î¼­
engarland : vt, È­È¯À¸·Î Àå½ÄÇÏ´Ù
Engel : n, µ¶ÀÏÀÇ Åë°èÇĞÀÚ
Engel's law : x, ¿¨°ÖÀÇ ¹ıÄ¢
Engels : n, Friedrich(1820, 95)µ¶ÀÏÀÇ »çÈ¸ÁÖÀÇÀÚ, MarxÀÇ Çù·ÂÀÚ
engels coefficient : x, ¿¨°Ö°è¼ö
engender : vt, vi, ¾ß±âÇÏ´Ù, ¹ß»ıÇÏ´Ù
engild : vt, (°í)µµ±İÇÏ´Ù, ´Û´Ù
engin, : x, engineer, engineering
engine : n, ±â°ü, ¿£Áø, ±â°üÂ÷, ±â°è, ±â±¸, º´±â
engine bay : x, (°ø)(µ¿Ã¼ ÇÏºÎÀÇ)¿£Áø °İ³³½Ç
engine company : x, ¼Ò¹æ¼­
engine department : x, (¼±¹ÚÀÇ)±â°ü½Ç
engine driver : x, Ã¶µµÀÇ ±â°ü»ç
engineer : °øÇĞ°¡, ±â¼úÀÚ, ±â»ç, (±â°è	µûÀ§ÀÇ)¼³°èÀÚ, Ã¶µµÀÇ ±â°ü»ç, À°±ºÀÇ  °øº´, ÇØ±ºÀÇ ±â°ü  Àå±³, ¼³°èÇÏ´Ù, ´É¶õÇÏ°Ô Ã³¸®ÇÏ´Ù
Engineer Corps : x, (¹Ì)°øº´´Ü
engineered food : x, °­È­(º¸Á¸)½ÄÇ°
engineerese : n, ±â¼ú ¿ë¾î, Àü¹® ¿ë¾î
engineering : n, °øÇĞ, ±â¼ú, ±â°ü¼ú, °ø»ç
engineer officer : x, (°ø±º)°øº´ Àå±³, (ÇØ±º)±â°ü Àå±³
engine house : x, Â÷°í
engineman : n, =ENGINE DRIVER
engine room : x, ±â°ü½Ç
enginery : n, ±â°ü, ±â°è·ù, º´±â °è·«
engine shed : x, ±â°ü Â÷°í
engine turning : x, ·ÎÁ¬ ¹«´Ì(½Ã°è µÚµ¤°³, Áõ±Ç µî¿¡ ±â°è·Î »õ°Ü ³ÖÀº ÁÙ¹«´Ì)
engird : vt, ¶ì·Î °¨´Ù, µÑ·¯½Î´Ù
engirdle : vt, =GIRDLE
England : n, À×±Û·£µå
englander : n, =LITTLE ENGLANDER, À×±Û·£µå »ç¶÷, ¿µ±¹ÀÎ
English : a, n, vt, ¿µ¾î, ¿µ±¹ÀÇ, ¿µ±¹»ç¶÷, Ç®ÀÌÇÏ´Ù
English Canadian : x, ¿µ±¹°è Ä³³ª´Ù »ç¶÷, ¿µ¾î¸¦ »ç¿ëÇÏ´Â Ä³³ª´Ù »ç¶÷
English Channel : x, ¿µ±¹ ÇØÇù
English daisy : x, (½Ä)µ¥ÀÌÁö
English disease : x, ¿µ±¹º´(³ëµ¿ÀÚÀÇ ÅÂ¾÷¿¡ ÀÇÇÑ »ı»ê ÀúÇÏ µîÀÇ »çÈ¸Àû º´Æó), (°í)±¸·çº´, ±â°üÁö¿°
English English : x, ¿µ±¹ ¿µ¾î
Englisher : n, ¿µ±¹ ±¹¹Î, ¿Ü±¹¾î¸¦ ¿µ¾î·Î ¹ø¿ªÇÏ´Â »ç¶÷
English flute : x, (¾Ç)=RECORDER 3
English horn : x, À×±Û¸®½Ã È£¸¥(oboe·ùÀÇ ¸ñ°ü ¾Ç±â)
Englishism : n, ¿µ±¹½Ä ¾î¹ı, ¿µ±¹Ç³(½Ä), ¿µ±¹ÁÖÀÇ
English ivy : x, (½Ä)¼­¾ç ´ãÀïÀÌ µ¢±¼
Englishize : vi, ¿µ±¹½Ä Ç³À¸·Î ÇÏ´Ù
Englishman : n, À×±Û·£µå »ç¶÷, ¿µ±¹ÀÎ(³²ÀÚ), ¿µ±¹¼±
Englishment : n, (¿Ü±¹ ÀúÀÛ¹°ÀÇ)¿µ¾î¿ª, ¿µ¿ªÆÇ
English muffin : x, ¿µ±¹½Ä ¸ÓÇÉ(ÀÌ½ºÆ®¸¦ ³ÖÀº ¸ÓÇÉ)
Englishness : n, ¿µ±¹(»ç¶÷)´Ù¿ò, ¿µ±¹(»ç¶÷)½Ä
English Revolution : x, (¿µ»ç)¿µ±¹ Çõ¸í, ¸í¿¹(¹«Ç÷)Çõ¸í
Englishry : n, (ÅÂ»ıÀÌ)¿µ±¹»ç¶÷ÀÓ, ¿µ±¹Ç³, (ÁıÇÕÀû)(¾ÆÀÏ·£µåÀÇ)À×±Û·£µå°è ÁÖ¹Î
English setter : x, ¿µ±¹Á¾ »ç³É°³
English sickness : x, =ENGLISH DISEASE
English sonnet : x, ¿µ±¹Ç³ 14Çà½Ã
English sparrow : x, (Á¶)ÁıÂü»õ
Englishspeaking : a, ¿µ¾î¸¦ ¸»ÇÏ´Â
English walnut : x, (½Ä)¼­¾çÈ£µµ³ª¹«, ±× ¿­¸Å
Englishwoman : n, ¿µ±¹¿©ÀÚ
engorge : vt, °Ô°É½º·¹¸Ô´Ù
engr, : x, engineer, engineering, engraved, engraver, engraving
engraft : vt, Á¢¸ñÇÏ´Ù, ÁÖÀÔÇÏ´Ù
engrail : vt, ±òÂß±òÂßÇÏ°Ô ÇÏ´Ù, °¡Àå ÀÚ¸®¸¦ Åé´Ï ¸ğ¾çÀ¸·Î ÇÏ´Ù
engrain : vt, a, =INGRAIN
engrained : a, =INGRAINED
engram : n, (½É)±â¾ï ½É»ó, (»ı)±â¾ïÀÇ ÈçÀû(¼¼Æ÷³»¿¡ Çü¼ºµÈ´Ù°í ¿©°ÜÁö´Â)
en grande tenue : ad, (F=in full dress)Á¤ÀåÀ¸·Î
engrave : vt, »õ±â´Ù, Á¶°¢ÇÏ´Ù
engraver : n, Á¶°¢»ç, Á¶ÆÇ°ø
engraving : n, Á¶°¢, Á¶ÆÇ, ÆÇÈ­
engross : vt, Å«±ÛÀÚ·Î¾²´Ù, Á¤½ÄÀ¸·Î ¾²´Ù, »©¾Ñ´Ù, ¸ôµÎ½ÃÅ°´Ù
engrossing : a, ¸¶À½À» »ç·ÎÀâ´Â, ¸¶À½À» ½ò¸®°Ô ÇÑ´Â, Àü·Å(¸ôµÎ)ÇÏ°Ô ÇÏ´Â, engrossingly, ad
engrossment : n, Àü·Å, ¸ôµÎ, Á¤½Ä ÀÚÃ¼·Î Å©°Ô ¾¸, Á¤¼­, Á¤¼­ÇÑ °Í, µ¶Á¡, ¸ÅÁ¡
engrs, : x, engineers
engulf : vt, (½É¿¬, ¼Ò¿ëµ¹ÀÌ µî¿¡)»¡¾ÆµéÀÌ´Ù, ´øÁ® ³Ö´Ù, »ïÅ°´Ù, µéÀÌÅ°´Ù, engulfment, n
enhance : vt, ³ôÀÌ´Ù, ´Ã¸®´Ù, °­È­ÇÏ´Ù
enhanced : a, Áß´ëÇÑ, ³ôÀÎ, °­È­ÇÑ
enhanced radiation : x, (±º)°­È­ ¹æ»ç¼±
enhanced radiation weapon : x, (±º)°­È­ ¹æ»ç¼± ¹«±â
enhanced recovery : x, =TERTIARY RECOVERY
enhancement : n, (°¡°İ, ¸Å·Â, °¡Ä¡ µîÀÇ)»ó½Â, µî±Í, Çâ»ó, Áõ´ë
enharmonic : a, »çºĞÀ½ÀÇ(Æò±ÕÀ²¿¡¼­´Â)ÀÌ¸í µ¿À½ÀÇ(¿Ã¸² ¶óÀ½°ú ³»¸² ¸¶À½ µûÀ§)a
enhearten : vt, ¿ë±â¸¦ µ¸¿ì´Ù
ENI : x, Ente Nazionale Idrocarburi
eniac : x, ¿¡´Ï¾×(¹Ì±¹¿¡¼­ ¸¸µé¾îÁø º»°İÀû ÄÄÇ»ÅÍ, »óÇ¥¸í)
Enid : n, ¿©ÀÚ ÀÌ¸§
enigma : n, ¼ö¼ö²²³¢, ¼ö¼ö²²³¢ÀÇ ÀÎ¹°, ºÒ°¡ÇØ¾È »ç¹°
enigmatic : a, ¼ö¼ö²²³¢ÀÇ(°°Àº), ¾Ë±â ¾î·Á¿î, (ÀÎ¹°ÀÌ)Á¤Ã¼ ¸ğ¸¦, ºÒ°¡»çÀÇÇÑ, enigmatically, ad
enigmatize : vt, vi, ¼ö¼ö²²³¢·Î ¸¸µé´Ù, ÀÌÇØÇÒ ¼ö ¾ø°Ô ÇÏ´Ù
enisle : vt, (½Ã)¼¶À¸·Î ¸¸µé´Ù, °íµµ¿¡ µÎ´Ù, °í¸³½ÃÅ°´Ù
Eniwetok : n, ¿¡´Ï¿ş·Ï È¯ÃÊ(¹Ì±¹ÀÇ ¿øÆø ½ÇÇèÁö)
enjambment : n, (½Ã)±¸°ÉÄ¡±â(½ÃÀÇ 1ÇàÀÇ ¶æ, ±¸¹®ÀÌ ´ÙÀ½ Çà¿¡ °ÉÃÄ¼­ ÀÌ¾îÁö´Â ÀÏ)
enjoin : vt, ¸í·ÉÇÏ´Ù, °úÇÏ´Ù
enjoy : vt, Áñ±â´Ù, ´©¸®´Ù, ÇâÀ¯ÇÏ´Ù, °Ç°­, Àç»ê µûÀ§¸¦ °¡Áö°í ÀÖ´Ù(enjoy oneself Áñ±â´Ù, Áñ°Ì°Ô Áö³»´Ù(½Ã°£À» º¸³»´Ù)
enjoyable : a, ÇâÀ¯ÇÒ ¼öÀÖ´Â, Áñ°Å¿î
enjoyment : n, Çâ¶ô
enkephalin : n, (»ıÈ­)¿£ÄÉÆÈ¸°(ÁøÅëÁ¦)
enkindle : vt, ºÒ, °¨Á¤À» Å¸¿À¸£°ÔÇÏ´Ù
enl, : x, enlisted, enlarge(d)
enlace : vt, ·¹ÀÌ½º·Î Àå½ÄÇÏ´Ù, ´Ü´ÜÈ÷ µ¿ÀÌ´Ù(°¨´Ù), ¿¡¿ö½Î´Ù, ¾ôÈ÷°Ô ÇÏ´Ù
enlarge : vt, vi, È®´ëÇÏ´Ù, ³Ğ¾îÁö´Ù, ÆÛÁö´Ù, ºÎ¿¬ÇÏ´Ù
enlargement : n, È®´ë
enlarger : n, (»ç)È®´ë±â
enlighten : vt, ±³È­ÇÏ´Ù, °è¸ùÇÏ´Ù, ¸í¹éÇÏ°Ô ÇÏ´Ù
enlightened : a, °è¸ùµÈ, °³È­µÈ, ¹®¸íÀÇ, ¹àÀº, ÈÍÈ÷ Åë´ŞÇÑ
enlightening : a, °è¸ùÀûÀÎ, ¹àÇôÁÖ´Â, ±ú¿ìÄ¡´Â
enlightenment : n, °è¸ù
enlink : vt, ¿¬°áÇÏ´Ù
enlist : vt, vi, º´Àû¿¡³Ö´Ù, ÀÔ´ëÇÏ´Ù, Çù·ÂÇÏ´Ù
enlisted man : x, »çº´, Áö¿øº´
enlistee : n, Áö¿øº´, »çº´
enlister : n, Â¡º´°ü, ¸ğº´°ü, Çù·ÂÀÚ, ÁöÁöÀÚ
enlistment : n, º´·Â ÆíÀÔ, ÀÔ´ë, Â¡¸ğ, ÀÀ¸ğ
enliven : vt, È°±â¸¦¶ì°ÔÇÏ´Ù
en masse : ad, ÇÔ°è, ÇÑ²¨¹ø¿¡, ÅëÆ²¾î¼­
enmesh : vt, ºü¶ß¸®´Ù, ¾ôÈ÷°Ô ÇÏ´Ù
enmity : n, ÀûÀÇ, Áõ¿À
ennead : n, ¾ÆÈ©°³·Î ÀÌ·ç¾îÁø ÇÑ ¹ú, (¼­Àû, ³í¹®, ½Ã µîÀÇ)¾ÆÈ© Æí ÇÑ ¹­À½
enneagon : n, 9°¢Çü, 9º¯Çü
enneahedron : n, (¼ö)9¸éÃ¼
ennoble : vt, °í±ÍÇÏ°ÔÇÏ´Ù, ±ÍÁ·À¸·Î ¸¸µé´Ù
ennui : n, ±ÇÅÂ
ennuye : a, n, (F=wearied)±ÇÅÂ¸¦ ´À³¢°í ÀÖ´Â(»ç¶÷), ½ÈÁõ³­(»ç¶÷)
Enoch : n, ³²ÀÚ ÀÌ¸§
enology : n, =OENOLOGY
enormity : n, ±Ø¾Ç, ¹üÁË ÇàÀ§
enormous : a, °Å´ëÇÑ, ¸·´ëÇÑ, Èä¾ÇÇÑ, enormousness, n
enormously : ad, ¸·´ëÇÏ°Ô, ¾öÃ»³ª°Ô, ÅÍ¹«´Ï¾øÀÌ
Enos : n, ³²ÀÚ ÀÌ¸§, (¼º)¿¡³ë½º
enosis : n, º´ÇÕ, µ¿¸Í, ¿¡³ë½Ã½º(Å°ÇÁ·Î½º¿¡ ÀÖ¾î¼­ÀÇ ±×¸®½º¿¡ÀÇ º¹±Í ¿îµ¿)
enough : a, n, ad, ÃæºĞÇÑ, Á·ÇÑ, ÃæºĞÈ÷, ¸¹ÀÌ ÂüÀ¸·Î, Ä£ÀıÇÏ°Ôµµ ...ÇÏ´Ù, ¾Æ¹«¸® ...ÇÏ¿©µµ ºÎÁ·ÇÏ´Ù
enounce : vt, ¼º¸í(¼±¾ğ)ÇÏ´Ù, ¾ğ¸íÇÏ´Ù, (ÀÇ°ß µîÀ»)Ç¥¸íÇÏ´Ù, ¹ßÀ½ÇÏ´Ù, enouncement, n
enow : a, ad, (°í, ½Ã)=ENOUGH
en pantoufles : ad, (F=in slippers)½½¸®ÆÛ¸¦ ½Å°í, ¸¶À½ ÆíÈ÷
en passant : ad, ...ÇÏ´Â ±è¿¡
en pension : ad, a, (F=in lodging)½Ä»ç°¡ µû¸£´Â ¼÷¹Ú Á¶°ÇÀ¸·Î(µÈ)
enplane : vi, ºñÇà±â¿¡Å¸´Ù
en poste : a, (F=in an official position)(¿Ü±³°üÀÌ)ºÎÀÓ(ÁÖÀç)ÇÏ¿©
enquete : n, (F=inquiry)¾ÓÄÉÆ®, ¿©·ĞÁ¶»ç
enquire : vt, inquire
enquiry : n, =INQUIRY
enrage : vt, °İ³ëÇÏ°ÔÇÏ´Ù
enrapport : ad, µ¿Á¤ÇÏ¿©
enrapt : a, µµÃëµÈ, È²È¦ÇØÁø
enrapture : vt, ¹ÌÄ¥µíÀÌ±â»Ú°ÔÇÏ´Ù, È²È¦ÄÉÇÏ´Ù
enraptured : a, È²È¦ÇÑ, ½Å³ª´Â
enravish : vt, =ENRAPTURE
enregiment : vt, ¿¬´ë·Î Æí¼ºÇÏ´Ù, ÈÆ·Ã½ÃÅ°´Ù
en regle : ad, a, (F=in order)Á¤½Ä´ë·Î(ÀÇ), ±ÔÄ¢´ë·Î(ÀÇ)
enrich : vt, Ç³ºÎÇÏ°ÔÇÏ´Ù, Â£°ÔÇÏ´Ù, ³óÃàÇÏ´Ù, ¿µ¾ç°¡¸¦ ³ôÀÌ´Ù
enriched food : x, °­È­ ½ÄÇ°(ÀÎ°øÀûÀ¸·Î ¿µ¾ç°¡¸¦ ³ôÀÎ)
enriched uranium : x, ³óÃà ¿ì¶ó´½
enrobe : vt, ÀÇº¹À» ÀÔÈ÷´Ù
enroll : vt, µî·ÏÇÏ´Ù, ÀÔÈ¸½ÃÅ°´Ù
enrollee : n, ÀÔÈ¸ÀÚ
enrollment : n, µî·Ï
enroute : ad, (F=on (the) route)µµÁß¿¡
ens : n, (L=being)(Ã¶)Á¸Àç¹°, ½ÇÀç¹°, (Ãß»óÀû)Á¸Àç
Ens, : x, ensign
ENSA : n, Entertainment National Service Association)(¿µ)À§¹® ºÀ»çÈ¸(±º´ë¸¦ À§¹®ÇÏ´Â)
ensample : n, (°í)=EXAMPLE
ensanguine : vt, ÇÇ·Î ¹°µéÀÌ´Ù, ÇÇÅõ¼ºÀÌ°¡ µÇ°Ô ÇÏ´Ù
ensanguined : a, (¹®¾î)ÇÇÅõ¼ºÀÌ°¡ µÈ
ensconce : vt, ¸öÀ»ÆíÈ÷¾ÉÈ÷´Ù, ¾ÈÄ¡ÇÏ´Ù, ¼û±â´Ù
en secondes noces : ad, ÀçÈ¥ÇÏ¿©(À¸·Î)
ensemble : n, ÃÑÃ¼, ÀüÃ¼ÀûÈ¿°ú, ÇÕÃ¢´Ü, ¾Ó»óºí, °ø¿¬ÀÚ
ensemble acting (playing) : x, ¾Ó»óºí ¿¬Ãâ(½ºÅ¸ Áß½ÉÀÌ ¾Æ´Ñ ÀüÃ¼ ¹è¿ìÀÇ Á¾ÇÕÀû È¿°ú¸¦ ³ë¸®´Â)
enshrine : vt, ...À» »ç´ç¿¡ ¸ğ½Ã´Ù, °£Á÷ÇÏ´Ù
enshroud : vt, ¼öÀÇ¸¦ ÀÔÈ÷´Ù, µ¤¾î°¡¸®´Ù
ensiform : a, (»ı)Ä®¸ğ¾çÀÇ
ensign : n, ±º±â, ±¹±â, ±â¼ö, ÇØ±º¼ÒÀ§(national ensign ±¹±â, red ensign ¿µ±¹ »óÀÎ, whete ensign ¿µ±¹ ±ºÇÔ±â
ensigncy : n, ±â¼öÀÇ ¿ªÇÒ(ÁöÀ§)
ensilage : vt, n, ÀúÀåÇÏ´Ù
ensile : vt, »ı¸ñÃÊ¸¦ »çÀÏ·Î¿¡ ÀúÀåÇÏ´Ù
enslave : vt, ³ë¿¹·Î¸¸µé´Ù
enslaver : n, ¸ÅÈ¤½ÃÅ°´Â »ç¶÷(°Í), ³²ÀÚÀÇ ¸¶À½À» »ç·ÎÀâ´Â ¿©ÀÚ, ¿ä³à
ensnare : vt, ¿Ã°¡¹Ì¿¡ °É¾î ³Ö´Ù
ensorcell : vt, ...¿¡°Ô ¿ä¼úÀ» °É´Ù, ¸ÅÈ¤½ÃÅ°´Ù
ensoul : vt, È¥À» ºÒ¾î³Ö´Ù, ¸¶À½¿¡ ´ã¾ÆµÎ´Ù
ensphere : vt, (µÕ±Û°Ô)½Î´Ù, µÑ·¯½Î´Ù, ±¸ÇüÀ¸·Î ÇÏ´Ù
ensue : vi, °è¼ÓÇØ¼­ÀÏ¾î³ª´Ù
ensuing : a, (¹®¾î)´ÙÀ½ÀÇ, µÚÀÌÀº, µÚÀÌ¾î ÀÏ¾î³ª´Â, °á°ú·Î¼­ µû¸£´Â
ensuite : ad, (F=in sequence)¿¬´Ş¾Æ
ensure : vt, Ã¥ÀÓÁö´Ù, È®º¸ÇÏ´Ù, º¸ÁõÇÏ´Ù, ¾ÈÀüÇÏ°ÔÇÏ´Ù
enswathe : vt, ½Î´Ù, ºØ´ë¸¦ °¨´Ù, enswathement, n
ENT : x, ear, nose, and throatÀÌºñÀÎÈÄ(°ú)
ent : suf, ÇàÀ§ÀÚ¸¦ ³ªÅ¸³»´Â ¸í»ç ¾î¹Ì, ¼ºÁú, »óÅÂ¸¦ ³ªÅ¸³»´Â Çü¿ë»ç ¾î¹Ì
ent, Sta, Hall : x, Entered at Stationers' Hall ÆÇ±Ç µî·ÏÇÊ
entablature : n, µ¹¸²¶ì(Ã³¸¶¿¡¼­ ±âµÕ¸Ó¸®±îÁöÀÇ ºÎºĞÀ¸·Î cornice, frieze, architraveÀÇ ¼¼Ãş)
entablement : n, (°Ç)=ENTABLATURE, »ó´ë(±âµÕ»Ñ¸® À§¿¡¼­ ÀÔ»óÀ» ¹ŞÄ¡´Â ´ë)
entail : vt, n, ³²±â´Ù, ¼ö¹İÇÏ´Ù, »ó¼Ó±ÇÀ» ÇÑÁ¤ÇÏ´Ù, ÇÊ¿ä·ÎÇÏ´Ù, ÇÑÁ¤»ó¼Ó
entangle : vt, ¾ôÈ÷°ÔÇÏ´Ù, È¥¶õ½ÃÅ°´Ù, °ï¶õÄÉÇÏ´Ù
entanglement : n, ¾ôÈ÷°Ô ÇÔ, ¾ôÈû, (»çÅÂÀÇ)ºĞ±Ô, (±º)³ìÃ¤, ¿ïÂ¯ÀÇ Àå¾Ö¹°
entasia : n, (»ı¸®)±äÀå¼º(°­Á÷¼º)
entasis : n, ¿£Å¸½Ã½º(¿øÁÖÀÇ ºÒ·èÇÔ), Èê¸²
ENT doctor : x, (¹Ì¼Ó)ÀÌºñÀÎÈÄ°ú ÀÇ»ç
entellus (monkey) : x, (µ¿)±ä²¿¸®¿ø¼şÀÌ(µ¿ºÎ ÀÎµµ»ê)
entente : n, Çù»ó±¹
entente cordiale : x, ÇùÁ¤, Çö»ó
enter : vt, vi, , , ¿¡µé¾î°¡´Ù...¿¡µé´Ù, Âü°¡ÇÏ´Ù, ½ÃÀÛÇÏ´Ù, µé´Ù
enteric : n, ÀåÀÇ, =ENTERIC FEVER
enteric fever : x, ÀåÆ¼Çª½º
enteritis : n, Àå¿°, ÀåÄ«Å¸¸£
enterocrinin : n, ¿£Å×·ÎÅ©¸®´Ñ(¼ÒÈ­ ÃË±ì È£¸£¸ó)
enterogastrone : n, ¿£Å×·Î°¡½ºÆ®·Ğ(À§ºĞºñ¾ïÁ¦ È£¸£¸ó)
enterokinase : n, ¿£Å×·ÎÅ°³ª¾ÆÁ¦(Àå³» È¿¼ÒÀÇ ÀÏÁ¾)
enteron : n, ¼ÒÈ­°ü
enteropathogenic : a, ÀåÀÇ º´À» ÀÏÀ¸Å°´Â
enteropathy : n, (º´¸®)ÀåÁúÈ¯
enterotomy : x, (¿Ü°ú)ÀåÀı°³(¼ú)
enterotoxin : n, ¿£µ¥·ÎÅå½Å, Àåµ¶¼Ò
enterovirus : n, (¼¼±Õ)Àå±Õ
enterprise : n, »ç¾÷, ±â¾÷, ±âÈ¹, ¸ğÇè½É
enterpriser : n, ±â¾÷°¡, »ç¾÷°¡
enterprise zone : x, (ÇàÁ¤)»ç¾÷ Áö¿ª, ±â¾÷Áö±¸, ±âÈ¹ »ç¾÷ Áö´ë
enterprising : a, ±â¾÷½ÉÀÌ¿Õ¼ºÇÑ, ¸ğÇèÀûÀÎ
entertain : vt, Áñ°Ì°ÔÇÏ´Ù, ´ëÁ¢ÇÏ´Ù, Ç°´Ù
entertainer : n, ´ëÁ¢ÇÏ´Â»ç¶÷
entertaining : a, À¯ÄèÇÑ, Àç¹ÌÀÖ´Â
entertainingly : ad, Àç¹ÌÀÖ°Ô, À¯ÄèÇÏ°Ô
entertainment : n, ´ëÁ¢, ¿¬È¸, ¿©³é, ¿©ÀÀ, ¿À¶ô, ¸¶À½¿¡ Ç°À½
entertainment computer : x, ¿À¶ô¿ë ÄÄÇ»ÅÍ
entertainment tax : x, (¿µ)ÈïÇà¼¼
enthalpimetry : n, (È­)¿£Å»ÇÇ °èÃø(¹ı)
enthalpy : n, (¹°)¿£Å»ÇÇ(¿­¿ªÇĞ Æ¯¼º ÇÔ¼öÀÇ ÇÏ³ª)
enthral : vt, ¸ÅÈ¤ÇÏ´Ù, ³ë¿¹·Î¸¸µé´Ù
enthrallment : n, ³ë¿¹È­, ³ë¿¹ »óÅÂ, ¸¶À½À» »ç·ÎÀâÀ½, ¸ÅÈ¤
enthrone : vt, ¿ÕÀ§¿¡¾ÉÈ÷´Ù
enthronement : n, ÁïÀ§(½Ä), ÁÖ±³ Ãß´ë(ÃëÀÓ½Ä, ÂøÁÂ½Ä), Á¸°æ
enthronization : n, =ENTHRONEMENT
enthuse : vi, vt, (¹Ì±¸)¿­Áß(¿­±¤, °¨°İ)ÇÏ´Ù(½ÃÅ°´Ù)
enthusiasm : n, ¿­½É, ¿­Áß, ¿­±¤, ¿­ÀÇ
enthusiast : n, a, ¿­¼ºÀûÀÎ »ç¶÷, ¿­±¤ÀÚ, ...ÆÒ, ...±¤, (°í)±¤½ÄÀûÀÎ
enthusiastic : a, ¿­±¤ÀÇ
enthusiastically : ad, ¿­±¤ÀûÀ¸·Î
enthymeme : n, (³í)»ı·« »ï´Ü ³í¹ı, »ı·« Ãß¸®¹ı
entice : vt, À¯È¤ÇÏ´Ù, ²Ò´Ù, À¯È¤, ¹Ì³¢
enticement : n, À¯È¤, ²Õ, À¯È¤ÇÏ´Â °Í, ¹Ì³¢, ¸Å·Â
enticing : a, ¸¶À½À» ²ô´Â(²ø¸¸ÇÑ), À¯È¤ÀûÀÎ, enticingly, ad
entire : a, ÀüÃ¼ÀÇ, ¿ÏÀüÇÑ, ¿ÂÀüÇÑ
entirely : ad, ¿ÏÀüÈ÷
entirety : n, (¹®¾î)¿ÏÀü, ¿ÂÀüÇÔ(ÇÑ »óÅÂ), ÀüÃ¼, Àü¾×
Entisol : n, (ÁöÁú)¿£Æ¼¼Ö(ÃşÀ§°¡ °ÅÀÇ ¾ø°Å³ª Àü¿¬ º¼ ¼ö ¾ø´Â Åä¾ç)
entitle : vt, ÄªÈ£¸¦ ÁÖ´Ù, Á¦¸ñÀ» ºÙÀÌ´Ù, ±Ç¸®¸¦ ÁÖ´Ù(be entitled to...¿¡ ´ëÇÑ ±Ç¸®°¡ ÀÖ´Ù)
entity : n, ½ÇÀç, ½ÇÃ¼, º»Ã¼
entoderm : n, =ENDODERM
entomb : vt, ¸ÅÀåÇÏ´Ù
entombment : n, ¸ÅÀå
entomic : a, °ïÃæÀÇ(¿¡ °üÇÑ)
entomological : a, °ïÃæÇĞÀûÀÎ(»óÀÇ)
entomologically : ad, °ïÃæÇĞÀûÀ¸·Î, °ïÃæÇĞ»ó
entomologist : n, °ïÃæÇĞÀÚ
entomologize : vi, °ïÃæÇĞÀ» ¿¬±¸ÇÏ´Ù, °ïÃæÀ» Ã¤ÁıÇÏ´Ù
entomology : n, °ïÃæÇĞ
entomology : n, °ïÃæÇĞ
entomophilous : a, Ãæ¸ÅÀÇ
entourage : n, È¯°æ, ÁÖÀÇ, Ãø±Ù
entoutcas : n, (F=in any case)Ã»¿ì °â¿ë ¿ì»ê, ÀüÃµÈÄ¿ë Å×´Ï½º ÄÚÆ®
entozoa : n, Ã¼³» ±â»ıÃæ
entracte : n, ¸·°£ÀÇ ¿¬±â, ¿¬ÁÖ
entrails : n, ³»Àå, ³»ºÎ
entrain : vt, Àâ¾Æ ´ç±â´Ù, ¿î¹İÇØ °¡´Ù
entrain : vt, vi, ±âÂ÷¿¡ ÅÂ¿ì´Ù(Å¸´Ù
entrain : vt, vi, ¿­ÀÇ, È°±â
entrainment : n, (»ı)»ı¹°ÇĞÀû »çÀÌÅ¬ÀÇ ÀüÈ¯(º¯°æ)
entrammel : vt, ±×¹°·Î Àâ´Ù, ¼Ó¹ÚÇÏ´Ù, ¹æÇØÇÏ´Ù
entrance : n, vt, µé¾î°¨, ÀÔÀå, µîÀå, ÀÔÇĞ, ÀÔ±¸, Ãë¾÷(entrance exmination ÀÔÇĞ ½ÃÇè, entrance fee ÀÔÀå·á, ÀÔÇĞ±İ, n
entrance examination : x, ÀÔÇĞ(ÀÔ»ç)½ÃÇè
entrance fee : x, ÀÔÀå·á, ÀÔÈ¸(ÀÔÇĞ)±İ
entrancement : n, ½Ç½Å »óÅÂ, ¹«¾Æ°æ, È²È¦ÀÇ °æÁö, ±â»µ ¾îÂ¿ ÁÙ ¸ğ¸§, ±¤Èñ, È²È¦ÇÏ°Ô ÇÏ´Â °Í
entranceway : n, =ENTRYWAY
entrancing : a, È²È¦ÄÉÇÏ´Â
entrant : n, ½ÅÀÔÀÚ
entrap : vt, µ£¿¡ °É¸®°Ô ÇÑ, ÇÔÁ¤¿¡ ºü¶ß¸®´Ù, µ£À¸·Î Àâ´Ù, (»ç¶÷À»)(°ï¶õ, À§Çè µî¿¡)ºü¶ß¸®´Ù, ¸ğÇÔÇÏ´Ù, ...À» ¼ÓÀÌ´Ù, ¼Ó¿©¼­...½ÃÅ°´Ù
entreat : vt, °£ÀıÈ÷ºÎÅ¹ÇÏ´Ù, Åº¿øÇÏ´Ù
entreating : a, °£Ã»ÀÇ Åº¿øÀÇ
entreatingly : ad, ¾Ö¿øÇÏ´Ù½ÃÇÇ, °£Ã»ÇÏµíÀÌ, °£ÀıÈ÷
entreaty : n, °£¿ø
entrechat : n, (F)(¹ß·¹)¾ÓÆ®¸£»ş(¶Ù¾î¿À¸¥ µ¿¾È¿¡ ¹ßµÚÃàÀ» ¿©·¯¹ø ±³Â÷½ÃÅ°´Â µ¿ÀÛ)
entrecote : n, (F=between rib)(¿ä¸®)°¥ºø´ë »çÀÌÀÇ ½ºÅ×ÀÌÅ©¿ë °í±â
entree : ÀÔÀå(Çã°¡), ÀÔÀå±Ç, (¿ä¸®)¾ÓÆ®·¹(»ı¼±°ú °í±â»çÀÌ¿¡ ³ª¿À´Â ¿ä¸®), (¹Ì)(±¸¿î °í±â ÀÌ¿ÜÀÇ)ÁÖ¿ä ¿ä¸®, (¾Ç)(ÇàÁø°î, ¹«µµ°îÀÇ)¼­ÁÖ°î
entremets : n, (F=between dish)(¿ä¸®)¾ÓÆ®¸£¸Ş(ÁÖ¿ä ¿ä¸® »çÀÌ¿¡ ³ª¿À´Â °£´ÜÇÑ ¿ä¸®, °çµéÀÌ´Â ¿ä¸®)
entrench : vt, vi, ÂüÈ£¸¦µÎ¸£´Ù, °ß°íÇÏ°ÔÁöÅ°´Ù, Ä§ÇØÇÏ´Ù
entrenchment : n, Âü¿À ±¸Ãà ÀÛ¾÷, ÂüÈ£·Î ±»Èù º¸·ç, (±Ç¸®ÀÇ)Ä§ÇØ
entre nous : x, ¿ì¸®³¢¸®¸¸ÀÇ ¾Ö±é´Ï´Ù¸¸(between ourselves)
entrepot : n, (F=interpose)Ã¢°í, (Ç×±¸°¡ ÀÖ´Â)È­¹° Áı»êÁö, È­¹° Åë°úÇ×
entrepreneur : n, (F=enterprise)±â¾÷°¡, (Æ¯È÷)°¡±ØÀÇ ÈïÇàÁÖ, Áß°³¾÷ÀÚ
entresol : n, (F=between floor)(°Ç)1Ãş°ú 2Ãş »çÀÌÀÇ ³·Àº Áß°£Ãş
entropy : n, ¿£Æ®·ÎÇÇ
entrust : vt, ¸Ã±â´Ù, À§ÀÓÇÏ´Ù
entry : n, µé¾î°¨, ÀÔÀå, Âü°¡, ÀÔ±¸, ±âÀÔ, Á¡°Å
entrylevel : a, ÃÊº¸ÀûÀÎ, °ß½ÀÀûÀÎ
entry permit : x, ÀÔ±¹ Çã°¡
entry visa : x, ÀÔ±¹ »çÁõ
entryway : n, ÀÔ±¸ÀÇ Åë·Î
entry word : x, =HEADWORD
entwine : vi, vt, ÈÖ°¨±â´Ù
entwist : vt, ²¿´Ù, ²¿¾Æ ÇÕÄ¡´Ù
enucleate : vt, ¸í¹éÈ÷ ÇÏ´Ù, (¿Ü°ú)ÀûÃâÇÏ´Ù, (»ı)...¿¡¼­ ¼¼Æ÷ÇÙÀ» »©³»´Ù
enucleation : n, (»ı)ÇÙÀÇ Á¦°Å, (¿Ü°ú)ÀûÃâ, ¼³¸í, ÇØ¸í
enumerate : vt, ÀÏÀÏÀÌÇì¾Æ¸®´Ù, ¿­°ÅÇÏ´Ù, ¼¼´Ù
enumeration : n, (ÇÏ³ªÇÏ³ª)¼À, °è»ê, ¿­°Å, ¸ñ·Ï, ÀÏ¶÷Ç¥
enumerative : a, ¿­°ÅÇÏ´Â, °è»ê(°è¼ö)»óÀÇ
enumerator : n, (Åë°è µîÀÇ)°è»êÀÚ, °è¼öÀÚ, ¿­°ÅÀÚ
enunciate : vt, (ÀÌ·Ğ, ÁÖÀÇ µîÀ»)¼±¾ğÇÏ´Ù, ¹ßÇ¥ÇÏ´Ù, (´Ü¾î¸¦)¶È¶ÈÈ÷ ¹ßÀ½ÇÏ´Ù
enunciation : n, ¹ßÀ½(ÇÏ´Â Åõ, ¹æ½Ä), ¾ğ¸í, ¼±¾ğ
enunciative : a, ¾ğ¸í(¼±¾ğ)ÀûÀÎ, ¹ßÀ½(»ó)ÀÇ, enunciatively, ad
enunciator : n, ¼±¾ğÀÚ, ¹ßÀ½ÀÚ
enunciatory : a, =ENUNCIATIVE
enure : v, =INURE
enuresis : n, À¯´¢Áõ
env, : x, envelope
Env, Extr, : x, Envoy Extraordinary
envelop : vt, ½Î´Ù, ºÀÇÏ´Ù, Æ÷À§ÇÏ´Ù
envelope : n, ºÀÅõ, Æ÷ÀåÀç·á
envelopment : n, ½Ó, ºÀÇØ ³ÖÀ½, Æ÷À§, µ¤°³, Æ÷ÀåÁö
envenom : vt, µ¶À»³Ö´Ù, ¾ÇÀÇ¸¦°®°ÔÇÏ´Ù
envenomate : vt, (¹°°Å³ª ÇÏ¿©)µ¶¹°(µ¶¾×)À» ÁÖÀÔÇÏ´Ù
envenomation : n, µ¶¹°(µ¶¾×)ÁÖÀÔ
envenomization : n, (¹ì µîÀÌ)¹°¾î¼­ »ı±â´Â Áßµ¶
enviable : a, ºÎ·¯¿î, ¹Ù¶÷Á÷ÇÑ
envious : a, ºÎ·¯¿öÇÏ´Â, ½Ã±âÇÏ´Â
environ : vt, µÑ·¯½Î´Ù
environment : n, È¯°æ, ÁÖÀ§, µÑ·¹
environmental : a, È¯°æÀÇ, ÁÖÀ§ÀÇ, È¯°æ¿¹¼úÀÇ(environmental pollution È¯°æ ¿À¿°)
environmental art : x, È¯°æ ¿¹¼ú(°ü°´À» Æ÷ÇÔÇÏ´Â Á¾ÇÕ ¿¹¼ú)
environmental assessment : x, È¯°æ »çÀü Á¶»ç
environmental biology : x, È¯°æ »ı¹°ÇĞ, »ıÅÂÇĞ
environmental disruption : x, È¯°æ ÆÄ±«
environmental engineer : x, È¯°æ °øÇĞÀÚ(È¯°æ º¸ÀüÀÇ Àü¹® ±â¼úÀÚ)
environmental engineering : x, È¯°æ °øÇĞ
environmental impact statement : x, È¯°æ ¿µÇâ Æò°¡º¸°í¼­
environmentalism : n, È¯°æ °áÁ¤·Ğ(ÀÎ°£ Çü¼º¿¡ ÀÖ¾î¼­ À¯Àüº¸´Ù È¯°æÀ» ÁßÇÏ°Ô º½)
environmentalist : n, È¯°æ º¸È£·ĞÀÚ
environmental pollution : x, È¯°æ ¿À¿°
Environmental Protection Agency : x, (¹Ì)È¯°æ º¸È£±¹
environmental psychology : x, È¯°æ ½É¸®ÇĞ
environmental science : x, È¯°æ °úÇĞ
environmental warfart : x, È¯°æÀü(È¯°æÀ» ¹Ù²Ù°Å³ª ÆÄ±«ÇÏ´Â Àü·«)
environmentology : n, È¯°æÇĞ
environpolitics : n, È¯°æ º¸È£(º¸Àü)Á¤Ã¥
environs : n, ºÎ±Ù, ±Ù±³
envisage : vt, »ó»óÇÏ´Ù...À» ¸¶À½¼Ó¿¡ ±×¸®´Ù, Âø»óÇÏ´Ù, ²ÒÇÏ´Ù
envision : vt, (Àå·¡ÀÇ ÀÏ µîÀ»)¸¶À½¿¡ ±×¸®´Ù, »ó»óÇÏ´Ù, °èÈ¹ÇÏ´Ù
envoy : n, °á±¸, »çÀı, Àü±Ç°ø»ç
envy : vt, n, ½Ã±âÇÏ´Ù, ºÎ·¯¿öÇÏ´Ù, ºÎ·¯¿ò, ÁúÅõ, ½Å¸Á
enweave : vt, =INWEAVE
enwind : vt, ...¿¡ ¾ôÈ÷´Ù, °¨°Ü µé´Ù
enwomb : vt, ÅÂ ³»¿¡ ¹è´Ù, ½Î´Ù, ±í¼÷È÷ ¹¯´Ù(°¨Ãß´Ù)
enwrap : vt, ÈÛ½Î´Ù
enwreathe : vt, (¹®¾î)È­È¯À¸·Î(Ã³·³)ÈÖ°¨´Ù, (È­È¯Ã³·³)µÎ¸£´Ù, ¾ô´Ù, ¿«´Ù
enxounter group : x, (Á¤ÀÇ)Áı´Ü °¨¼ö¼º ÈÆ·Ã ±×·ì
enxounter grouper : x, ÀÎÄ«¿îÅÍ ±×·ì Âü°¡ÀÚ
Enzed : n, =NEW ZEALAND
enzootic : a, n, (µ¿¹°ÀÇ º´ÀÌ)Áö¹æ(Ç³Åä)¼ºÀÇ, (µ¿¹°ÀÇ)Áö¹æ(Ç³Åä)º´
enzymatic : a, È¿¼ÒÀÇ(¿¡ ÀÇÇÑ), enzymatically, ad
enzyme : n, È¿¼Ò
enzyme detergent : x, È¿¼Ò ¼¼Á¦
enzyme engineering : x, È¿¼Ò °øÇĞ(È¿¼Ò(ÀÛ¿ë)ÀÇ ³ó°ø¾÷¿¡ÀÇ ÀÀ¿ë)
enzymologist : n, È¿¼ÒÇĞÀÚ
enzymology : n, È¿¼ÒÇĞ
EO : x, Education Officer, Engineering Office Åä¸ñ±¹, Executive Order
Eocene : n, a, (ÁöÁú)(Á¦3±âÀÇ)½Ã½Å¼¼(ÀÇ)
EOD : x, explosive ordnance disposal Æø¹ß¹° Ã³¸®
eohippus : n, ¿¡¿ÀÈ÷Çª½º(¹Ì±¹ ¼­ºÎ¿¡¼­ ¹ß±¼µÈ ½Ã½Å¼¼ Àü±âÀÇ È­¼®¸¶
Eolian : a, =AEOLIAN
Eolic : a, n, =AEOLIC
eolith : n, (°í°í)¿ø½Ã ¼®±â
Eolithic : a, (°í°í)¿ø½Ã ¼®±â ½Ã´ëÀÇ
eon : n, =AEON
eonian : a, =AEONIAN
eonism : n, ³²ÀÚÀÇ¿©¼º¸ğ¹æº®
eonsold : a, ¾ÆÁÖ ¸Õ ¿¾³¯ºÎÅÍÀÇ, ¸Ó³ª¸Õ ¿¾³¯ÀÇ
Eos : n, (±×½Å)¿¡¿À½º(¿©¸íÀÇ ¿©½Å, ·Î¸¶ ½ÅÈ­ÀÇ aurora¿¡ ÇØ´ç)
eosin : n, (È­)¿¡¿À½Å(¼±¸íÇÑ ºÓÀº»öÀÇ »ê¼º »ö¼Ò, ¼¼Æ÷ÁúÀÇ ¿°»ö µî¿¡ ¾²ÀÓ)
eosinophile : n, (ÇØ)È£»ê±¸
eous : suf, ...¿Í °°Àº, ...ºñ½ÁÇÑ)ÀÇ ¶æ
Eozoic : n, a, (ÁöÁú)=PRECAMBRIAN, RPOTEROZOIC
EP : n, (·¹ÄÚµå)ÀÌÇÇÆÇ(¸ÅºĞ 45È¸ÀüÀÇ ·¹ÄÚµå)
EP : x, European Plan
Ep, : x, Epistle
ep- : pref, (À§, ´õÇÏ¿©, ¿Ü)ÀÇ ¶æ(¸ğÀ½ ¾Õ¿¡¼­´Â ep-)
EPA : x, Environmental Protection Agency(¹Ì)È¯°æ º¸È£Ã»
epact : n, ÅÂ¾ç·ÂÀÇ 1³âÀÌ ÅÂÀ½·Âº¸´Ù ÃÊ°úÇÏ´Â ³¯Â¥ ¼ö(¾à 11ÀÏ), 1¿ù1ÀÏÀÇ ¿ù·É
Epaminondas : n, ¿¡ÆÄ¹Ì³í´Ù½º(±×¸®½º ThebesÀÇ Á¤Ä¡°¡, ±ºÀÎ)
eparch : n, (¿¾ ±×¸®½ºÀÇ)ÁÖÁö»ç, (±Ù´ë ±×¸®½ºÀÇ)±º¼ö, (Èñ¶ø Á¤±³ÀÇ)´ëÁÖ±³, ÁÖ±³
eparchy : n, (¿¾ ±×¸®½ºÀÇ)ÁÖ, (±Ù´ë ±×¸®½ºÀÇ)±º, (Èñ¶ø Á¤±³ÀÇ)ÁÖ±³±¸, ´ë±³±¸
epaulet : n, °ßÀå
Epcot Center : x, (¹Ì)µğÁî´Ï ¹Ì·¡µµ½Ã
epee : n, (FÄ®³¡¿¡¼­)ÀÇ ¶æ¿¡¼­, (Ææ½Ì)¿¡Æä(³¡ÀÌ »ÏÁ·ÇÑ ½ÃÇÕ¿ë Ä®)
epeeist : n, (F)(Ææ½Ì)¿¡Æä °æ±âÀÚ
Epeirus : n, =EPIRUS
epenthesis : n, (¾ğ, À½¼º)»ğÀÔ ¹®ÀÚ, »ğÀÔÀ½
epergne : n, ½ÄÅ¹ Áß¾Ó¿¡ ³õ´Â Àå½Ä¿ë ½ºÅÄµå(°úÀÏ, ²É µîÀ» ¾ñ¾î µÒ)
epexegesis : n, (¼ö)¼³¸íÀû º¸Á·(¾î)
Eph, : x, Ephesians
eph- : prdf, =EP, ephemeral
ephah, : n, ¿¡ÆÄ(°í´ë È÷ºê¸®ÀÇ °Ç·® ´ÜÀ§)
ephedrine : n, (È­)¿¡Æäµå¸°(°¨±â, Ãµ½Ä Ä¡·áÁ¦)
ephememron : n, =EPHEMERA
ephemera : n, ÇÏ·ç»ìÀÌ
ephemeral : a, ÇÏ·ç¹Û¿¡¸ø»ç´Â, ´Ü¸íÇÑ, ¸Ú¾ø´Â
ephemerality : n, ´Ü¸í, µ¡¾øÀ½, µ¡¾ø´Â ÀÏ(°Í)
ephemeralization : n, ´Ü±â ¼Ò¸ğ »óÇ° Á¦Á¶, »óÇ°ÀÇ ´Ü¸íÈ­
ephemerid : n, ÇÏ·ç»ìÀÌ
ephemeris : n, (Ãµ)(ÃµÃ¼ÀÇ)Ãß»ê À§Ä¡Ç¥, Ãµ¹®·Â, (°í)´Ş·Â, ÀÏÁö
Ephes, : x, (¼º)Ephesians
Ephesian : a, EPHESUSÀÇ
Ephesus : n, ¿¡º£¼Ò(¼Ò¾Æ½Ã¾Æ ¼­ºÎÀÇ ¿¾ µµ½Ã)
ephod : n, À¯´ë Á¦»çÀåÀÇ Á¦ÀÇ
ephor : n, (¿¹ ±×¸®½º)¹Î¼± Àå°ü, (Æ¯È÷)°ø°ø »ç¾÷ °¨µ¶°ü
Ephraim : n, ³²ÀÚ ÀÌ¸§, (¼º)¿¡ºê¶óÀÓ, ¿¡ºê¶óÀÓÁ·(ÀÌ½º¶ó¿¤ ºÎÁ·ÀÇ ÇÏ³ª), ºÏ¿Õ±¹ ÀÌ½º¶ó¿¤
epi- : pref, =EP
epiblast : n, (»ı)³¶¹èÀÇ ¿ÜÇÇ(¿Ü¹è¿±ÀÌ µÊ)
epic : n, a, ¼­»ç½Ã(ÀÇ)
epical : a, =EPIC
epicalyx : n, (½Ä)¾Ç»óÃÑÆ÷
epicanthic fold : x, (ÇØ)³»¾È°¢ÃéÇÇ
epicanthus : n, =EPICANTHIC FOLD
epicardium : n, (ÇØ)¿Ü½É¸·
epicarp : n, (½Ä)¿Ü°úÇÇ
epic drama : x, ¿¡ÇÈ µå¶ó¸¶(°ü°´ÀÇ ºñÆÇÀû »ç°í¸¦ ÃË±¸ÇÏ´Â ¼­»ç±Ø)
epicedium : n, Àå¼Û°¡, ¾Ö°¡
epicene : a, n, (¶óÆ¾, ±×¸®½º ¹®¹ı)Åë¼ºÀÇ, ³²³à ¾ç¼ºÀ» ÇÔ²² °¡Áø, ³²³àÃß´Ï, Åë¼º¾î
epicenter : n, Áø¾Ó
epicentral : a, (ÁöÁø)Áø¾ÓÀÇ
epicentrum : n, (¿µ)=EPICENTER
epiclesis : n, (±×¸®½ºÁ¤±³)¿¡ÇÇÅ¬·¹½Ã½º(¼º·É °­¸²À» Èñ¿øÇÏ´Â ±âµµ)
epicotyl : n, (½Ä)»ó¹èÃà
epicritic : a, (»ı¸®)(ÇÇºÎ °¨°¢ µîÀÌ)(Á¤¹Ğ)½Äº°(ÆÇº°)¼ºÀÇ
Epictetus : n, ¿¡ÇÈÅ×Åä½º(±×¸®½ºÀÇ ½ºÅä¾ÆÇĞÆÄ Ã¶ÇĞÀÚ)
epicure : n, ¹Ì½Ä°¡, Äè¶ôÁÖÀÇÀÚ
epicurean : a, n, Çâ¶ôÁÖÀÇÀÇ(»ç¶÷), ½Äµµ¶ôÀÇ»ç¶÷
Epicureanism : n, Çâ¶ôÁÖÀÇ, =EPICURISM
epicurism : n, Çâ·«ÁÖÀÇ, ¹Ì½ÄÁÖÀÇ, ½Äµµ¶ô
Epicurus : n, ¿¡ÇÇÄí·Î½º(Äè¶ôÀ»ÀÎ»ıÀÇÃÖ°í¼±À¸·Î¿©±ä±×¸®½ºÀÇÃ¶ÀÎ)
epicycle : n, (Ãµ, ¼ö)ÁÖÀü¿ø
epicyclic : a, ÁÖÀü¿øÀÇ
epicycloid : n, ¿Ü»çÀÌÅ¬·ÎÀÌµå
epicycloidal : a, 
epidemic : n, a, À¯Çàº´, (Áúº´, »ç»óÀÇ)À¯Çà, À¯Çà¼ºÀÇ
epidemical : a, =EPIDEMIC
epidemic pleurodynia : x, (º´¸®)Àü¿°¼º ÈäÅëÁõ(¹ÙÀÌ·¯½º µî¿¡ ÀÇÇÑ)
epidemiology : n, À¯Çà(Àü¿°)º´ÇĞ
epidermal : a, »óÇÇ(Ç¥ÇÇ)ÀÇ
epidermin : n, (»ı)¿¡ÇÇ´õ¹Î(µ¿½Ä¹° Ç¥ÇÇÀÇ ÁÖ ±¸¼º ¿ä¼ÒÀÎ ¼¶À¯»ó ´Ü¹éÁú)
epidermis : n, (¸öÀÇ)Ç¥ÇÇ
epidermoid : a, Ç¥ÇÇ ºñ½ÁÇÑ, Ç¥ÇÇ ¸ğ¾çÀÇ
epidiascope : n, ½Ç¹°È¯µî±â(Åõ¸íÃ¼, ºÒÅõ¸íÃ¼¾ç¿ëÀÇ)
epigastric : a, »óº¹ºÎÀÇ
epigastrium : n, »óº¹ºÎ(À§ÀÇ ¾ÈÂÊ)
epigene : a, (ÁöÁú)(¾Ï¼®ÀÌ)Ç¥¸é¿¡¼­ »ı¼ºµÈ, ¿Ü·ÂÀûÀÎ, Ç¥¼ºÀÇ
epigenesis : n, (»ı)ÈÄ¼º¼³(»ı¹°ÀÇ ¹ß»ıÀº Á¡Â÷Àû ºĞÈ­¿¡ ÀÇÇÑ´Ù´Â ¼³), (ÁöÁú)ÈÄ»ı
epigenous : a, (½Ä)Ç¥¸é¿¡ »ı±â´Â, ÀÙÀÇ Ç¥¸é¿¡ ¹ß»ıÇÏ´Â
epiglottis : n, È¸¿°(¿¬°ñ)
epigone : n, (Á¶»óº¸´Ù ¸øÇÑ)ÀÚ¼Õ, (¹®¿¹)(ÀÏ·ù ¿¹¼ú°¡, »ç»ó°¡ µîÀÇ)¸ğ¹æ(ÃßÁ¾)ÀÚ, ¾Æ·ù
epigonic : a, 
epigonism : n, ¿­µî ¸ğ¹æ
epigram : n, °æ±¸, °æ±¸ÀûÇ¥Çö, (Â©¸·ÇÑ)Ç³ÀÚ½Ã
epigrammatic : a, °æ±¸ÀÇ, Ç³ÀÚÀûÀÎ
epigrammatist : n, °æ±¸°¡, Ç³ÀÚ ½ÃÀÎ
epigrammatize : vi, vt, °æ±¸·Î ¸¸µé´Ù
epigraph : n, Á¦¸í, Á¦»ç, ºñ¹®
epigrapher : n, =EPIGRAPHIST
epigraphic : a, EPIGRAPHÀÇ, EPIGRAPHYÀÇ
epigraphist : n, ºñ¸íÇĞÀÚ, ±İ¼®ÇĞÀÚ
epigraphy : n, ºñ¹®¿¬±¸
epigynous : a, (½Ä)(²ÉÀÌ)ÀÚ¹æ ÇÏÀ§ÀÇ
epil, : x, epilepsy, epileptic, epilog(ue)
epilepsy : n, Áö¶öº´, °£Áú
epileptic : a, n, °£Áúº´ÀÇ È¯ÀÚ
epilog(ue) : n, (Ã¥ÀÇ)¹ß¹®, ¸ÎÀ½¸», ÈÄ±â, ¹ß½Ã, ³¡¸ÎÀ½¸»
epilogist : n, EPILOG(UE)ÀÇ ÀÛÀÚ(³¶µ¶ÀÚ)
epinephrine : n, =ADRENALINE
Epiph, : x, Epiphany
Epiphany : n, ÁÖÇöÀı(1¿ù 6ÀÏ)
epiphenominon : n, ºÎ¼ö Çö»ó
epiphyte : n, Âø»ı½Ä¹°(ÀÌ³¢µûÀ§)
epiphytology : n, ½Ä¹° ±â»ıº´ÇĞ
Epirus : n, ¿¡ÇÇ·ç½º(±×¸®½º ºÏ¼­ºÎÀÇ Áö¹æ, ±× Áö¿ª°ú ÇöÀçÀÇ ¾Ë¹Ù´Ï¾Æ ³²ºÎÀÇ °í´ë±¹°¡)
Epis(c), : x, Episcopal, Episcopalian
Epis, : x, (¼º)Epistle
episcopacy : n, (±³È¸ÀÇ)°¨µ¶Á¦µµ
episcopal : a, °¨µ¶ÀÇ
Episcopal Church : x, ¿µ±¹ ¼º°øÈ¸
Episcopalian : a, n, °¨µ¶°úÀÇ »ç¶÷)
episcopally : ad, ÁÖ±³(°¨µ¶)·Î¼­, ÁÖ±³¿¡ ÀÇÇÏ¿©
episcope : n, ¹İ»ç Åõ¿µ±â(ºÒÅõ¸íÃ¼ÀÇ È­»óÀ» ½ºÅ©¸°¿¡ ¿µ»çÇÏ´Â È¯µîÀåÄ¡)
episememe : n, ¹®¹ı ÀÇ¹Ì¼Ò
episode : n, »ğÈ­, ¿¡ÇÇ¼Òµå
episodic : a, ¿¡ÇÇ¼ÒµåÇ³ÀÇ, »ğÈ­ÀûÀÎ, »ğÈ­·Î ÀÌ·ç¾îÁø, ÀÏ½ÃÀûÀÎ
episome : n, À¯ÀüÀÚºÎÃ¼
epispastic : a, n, (ÀÇ)ÇÇºÎ ÀÚ±Ø¼ºÀÇ, ¹ßÆ÷¼ºÀÇ, ¹ßÆ÷Á¦, ÇÇºÎÀÚ±ØÁ¦
epistaxis : n, (ÀÇ)ÄÚÇÇ
episteme : n, Áö½Ä, ÀÎ½Ä
epistemic : a, Áö½Ä(ÀÎ½Ä)ÀÇ(¿¡ °üÇÑ)
epistemological : a, ÀÎ½Ä·Ğ(»ó)ÀÇ
epistemology : n, ÀÎ½Ä·Ğ
epistemophilia : n, È£ÇĞ, ÇĞ¹®¿¡ ´ëÇÑ ºñ»óÇÑ Èï¹Ì
epistle : n, ¼­°£
epistler : n, (Æ¯È÷ ½Å¾à ¼º¼­ ÁßÀÇ)¼­°£ÀÇ ÆÈÀÚ, (¼ºÂù½ÄÀÇ)»çµµ ¼­°£ÀÇ ³¶µ¶ÀÚ
epistle side : x, (Á¦´ÜÀÇ)³²ÂÊ, (Á¦´ÜÀ» ÇâÇØ)¿À¸¥ÂÊ
epistolary : a, ¼­°£Ã¼ÀÇ
epistolary novel : x, ¼­°£Ã¼ ¼Ò¼³
epistoler : n, =EPISTLER 2
epistrophe : n, (¼ö)°á±¸, ¹İº¹, Ã¸±¸
epistyle : n, (°Ç)=ARCHITRAVE
episxopate : n, ÁÖ±³(°¨µ¶)ÀÇ ÁöÀ§(°è±Ş, ÀÓ±â), °¨µ¶(ÁÖ±³, »ç±³)´Ü
epitaph : n, (¹¦)ºñ¸í
epitazial layer : x, (ÀüÀÚ)¿¡ ÇÇÅÃ¼È Ãş
epithalamion : n, =EPITHALAMIUM
epithalamium : n, °áÈ¥ÃàÇÏ½Ã, °áÈ¥ÃàÇÏÀÇ ³ë·¡
epithelioid : a, »óÇÇ(Á¶Á÷)¸ğ¾çÀÇ
epithelium : n, »óÇÇ, (½Ä)½ÅÇÇ, ÇÇ¸· Á¶Á÷, »óÇÇ
epithet : n, º°¸í, Çü¿ë»ç, ÅëÄª
epithetic : a, Çü¿ëÇÏ´Â, Çü¿ë»çÀûÀÎ
epitome : n, ¹ßÃé, ´ë¿ä, ´ëÇ¥ÀûÀÎ °Í
epitomist : n, ¿ä¾àÀÚ
epitomize : vt, ...ÀÇ ÀüÇüÀÌ´Ù, ...ÀÇ ¹ßÃé(°³¿ä)¸¦ ¸¸µé´Ù, ¿ä¾àÇÏ´Ù
epitope : n, (»ıÈ­)¿¡ÇÇÅäÇÁ(Ç×¿ø °áÁ¤±â)
epizoon : n, Ã¼¿Ü±â»ıÃæ
epizootic : n, °¡Ãà À¯Çàº´(ÀÇ)
epluribus unum : , ´Ù¼ö·Î ÀÌ·ç¾îÁø ¾ÆÇÏ(one out of many)(¹Ì±¹ÀÇ ¸ğÅä)
EPN : x, ethyl paranitrophenyl »ìÃæÁ¦ÀÇ ÀÏÁ¾
EPNdB : x, effective perceived noise decibels °¨°¢ ¼ÒÀ½ È¿°ú µ¥½Ãº§
epoch : n, ½Å±â¿ø, ½Å½Ã´ë, (Áß´ë»ç°ÇÀÌ ÀÖ´ø)½Ã´ë
epochal : a, »õ·Î¿î ±â¿øÀÇ, È¹±âÀûÀÎ
epoche : n, (Ã¶)ÆÇ´Ü ÁßÁö
epochmaking : a, È¹±âÀûÀÎ
epode : n, ±æ°íÂªÀºÇàÀÌ¹ø°¥¾ÆÀÖ´Â¼­Á¤½Ã
eponym : n, ÀÌ¸§ÀÇ½ÃÁ¶(ÀÎÁ¾, ÅäÁö, ½Ã´ëµûÀ§ÀÇÀÌ¸§ÀÇÀ¯·¡°¡µÈÀÎ¹°)
eponymous : a, ÀÌ¸§ÀÇ ½ÃÁ¶°¡ µÈ
epopee : n, ¼­»ç½Ã, »ç½Ã
epos : n, (±¸Àü¿¡ ÀÇÇÑ)¿ø½ÃÀû ¼­»ç½Ã, ¼­»ç½Ã
epoxy : n, vt, (È­)¿¡Æø½Ã ¼öÁö, ¿¡Æø½Ã ¼öÁö·Î Á¢ÂøÇÏ´Ù
Epping Forest : x, ¿¡ÇÎ Æ÷·¹½ºÆ®
Eprime : n, beµ¿»ç¸¦ ¾²Áö ¾Ê´Â ¿µ¾î(¹Ì±¹¿¡¼­ Ã¢¾È)
epris : a, (F=in love)...¿¡ ¹İÇÑ
EPROM : n, (Àü»ê)¼Ò°Å ÇÁ·Î±×·¥ °¡´É ROM
epsilon : n, ±×¸®¾î ¾ËÆÄºªÀÇ ´Ù¼¸Â° ±ÛÀÚ(E ¿µ¾îÀÇ short'e'¿¡ ÇØ´ç)
Epsom : n, À×±Û·£µå SurryÁÖÀÇ µµ½Ã
Epsom salts : x, »ç¸®¿°
EpsteinBarr virus : x, ¿¦½ºÅ¸ÀÎ ¹Ù ¹ÙÀÌ·¯½º
ept : a, À¯´ÉÇÑ, ¼Ø¾¾ÀÖ´Â, È¿À²ÀûÀÎ
eptitude : n, ´É·Â, ¼Ø¾¾
eq, : x, equal, equation, equivalent
equability : n, (¿Âµµ, ±âÈÄ µîÀÇ)ÇÑ°á°°À½, ±Õµî¼º, (±âºĞ, ¸¶À½ÀÇ)Æò¾È, Ä§Âø
equable : a, ÇÑ°á°°Àº, ±ÕµîÇÑ, ÆòÁ¤ÇÑ
equal : °°Àº, ÇÑ°á°°Àº, ÇÊÀûÇÏ´Â, ~¿¡ ÁöÁö ¾Ê´Â, ~¿¡ °ßµğ¾î  ³¾ ¼ö ÀÖ´Â, ÆòÁ¤ÇÑ, ´ëµîÇÑ ¹°°Ç, ÇÊÀûÀÚ, °°Àº ¶Ç·¡, ~¿¡ ÇÊÀûÇÏ´Ù, ~°ú ¶È°°´Ù
equal(s) sign : x, ÀÌÄ÷ ±âÈ£
equalarea : a, (Áöµµ°¡)µîÀûÀÇ, Á¤ÀûÀÇ
equalitarian : n, a, \EGALIARLAN
equality : n, µ¿µî, Æòµî, ´ëµî
Equality State : x, ¹Ì±¹ WyomingÁÖÀÇ ¼ÓÄª
equalization : n, µ¿µîÈ­, ÆòµîÈ­, ±ÕµîÈ­
equalize : vt, vi, ¶È°°°ÔÇÏ´Ù, ÆòµîÇÏ°Ô ÇÏ´Ù, °°¾ÆÁö´Ù, ÆòµîÇØÁö´Ù, (°æ±â¿¡¼­)µ¿Á¡ÀÌ µÇ´Ù
equalizer : n, µîÈ­±â, ÆòÇü ÀåÄ¡, ±Õ¾Ğ¼±
equally : ad, ¶È°°°Ô, ÆòµîÇÏ°Ô, ±ÕÀÏÇÏ°Ô, (Á¢¼Ó»çÀû)±×¿Í µ¿½Ã¿¡, ±×·³¿¡µµ ºÒ±¸ÇÏ°í
equal opportunity : x, (Ã¤¿ë½ÃÀÇ)±âÈ¸ ±Õµî
Equal Rights Amendment : x, (¹Ì)³²³à Æòµî Çå¹ı ¼öÁ¤¾È
equal time : x, (Á¤°ß ¹ßÇ¥¿¡¼­)ÆòµîÇÑ ¹æ¼Û½Ã°£ ÇÒ´ç, ÆòµîÇÑ ¹ß¾ğ ±âÈ¸
equanimity : n, (¸¶À½ÀÇ)ÆòÁ¤, Ä§Âø, ³ÃÁ¤
equate : vt, ¹æÁ¤½ÄÀ»¼¼¿ì´Ù, (´Ù¸¥ ¼öÄ¡¿Í)°°´Ù°í Ç¥½ÃÇÏ´Ù
equation : n, °°°ÔÇÔ, ±ÕºĞ¹ı, ¹æÁ¤½Ä
equational : a, ±ÕµîÇÑ, ¹æÁ¤½ÄÀÇ, (»ı)2Â÷ ¼¼Æ÷ ºĞ¿­ÀÇ, (¹®¹ı)µî½Ä °ü°èÀÇ, ÁÖ¾î¿Í º¸¾î·Î ÀÌ·ç¾îÁø
equator : n, Àûµµ
equatorial : a, n, Àûµµ(ºÎ±Ù)ÀÇ, ÀûµµÀÇ
Equatorial Guinea : x, Àûµµ ±â´Ï(Àûµµ ¾ÆÇÁ¸®Ä« ¼­´ÜÀÇ °øÈ­±¹)
equerry : n, ¿Õ°¡, ±ÍÁ·ÀÇ ¸» ±¤¤¤¸®ÀÎ, ÁÖ¸¶°ü, ¿µ±¹ ¿Õ½ÇÀÇ ½ÃÁ¾ ¹«°ü
equestrian : a, n, ±â¸¶ÀÇ, ¸» Åº, ½Â¸¶ÀÚ
equestrianism : n, ¸¶¼ú, °î¸¶¼ú, ½Â¸¶ ¿¬½À
equestrienne : n, ¿©ÀÚ¸¶¼ú°¡, ¿©ÀÚ °î¸¶»ç
equi- : x, (¿¬°áÇü)(°°Àº)ÀÇ ¶æ
equiangular : a, µî°¢ÀÇ
equidistance : n, µî°Å¸®
equidistant : a, °°Àº°Å¸®ÀÇ
equidistant diplomacy : x, µî°Å¸® ¿Ü±³
equigravisphere : n, (Áö±¸¿Í ´Ş »çÀÌ ¶Ç´Â µÎ ÃµÃ¼°£ÀÇ)Áß·Â ÆòÇü±Ç
equilateral : a, n, µîº¯ÀÇ, µîº¯Çü
equilibrant : n, (¹°)ÆòÇü·Â
equilibrate : vi, vt, ÆòÇüµÇ´Ù, ÆòÇü½ÃÅ°´Ù
equilibration : n, ÆòÇü, ±ÕÇü, Æò±Õ(»óÅÂ)
equilibrator : n, ±ÕÇüÀ» À¯Áö½ÃÅ°´Â °Í, ÆòÇü ÀåÄ¡, (°ø)¾ÈÁ¤ ÀåÄ¡
equilibrist : n, ÁÙÅ¸´Â »ç¶÷, °î¿¹»ç
equilibrium : n, ÆòÇü, ±ÕÇü, (¸¶À½ÀÇ)ÆòÁ¤
equimultiple : n, µî¹è¼ö, µî¹è·®
equine : n, a, ¸», ¸»ÀÇ, ¸»°ú°°Àº
equinoctial : a, n, ÁÖ¾ßÆòºĞÀÇ, ÃáºĞ, ÃßºĞÀÇ, ÁÖ¾ßÆòºĞ¼±
equinoctial circle (line) : x, (Ãµ)ÁÖ¾ß ÆòºĞ¼±
equinoctial point : x, (Ãµ)ºĞÁ¡, ÁÖ¾ß ÆòºĞÁ¡
equinoctial year : x, (Ãµ)ºĞÁ¡³â
equinox : n, ÁÖ¾ßÆòºĞ½Ã, ³·°ú ¹ãÀÌ ¶È°°Àº ¶§
equip : vt, °®Ãß´Ù, ÁØºñÇÏ´Ù, ²Ù¹Ì´Ù, ÀåºñÇÏ´Ù
equip, : x, equipment
equipage : n, ¸¶Â÷, ¸¶ºÎµûÀ§ÀÇÇÑ°®Ãã, ¸¶Â÷ Àåºñ ÀÏÃ¼, ¿ë±¸ÀÏ½À
equipe : n, ½ºÆ÷Ã÷ÀÇ ÆÀ°ú Àåºñ
equipment : n, Ã¤ºñ, ÁØºñ, ¼³ºñ(¼±¹ÚÀÇ ÀÇÀåÇ°), (¾Ë¿¡ ÇÊ¿äÇÑ)´É·Â, ±â¼ú
equipoise : n, ±ÕÇü, ÆòÇü(»óÅÂ)
equipollence : n, ÈûÀÇ ±Õµî, ±Õ¼¼, µîÄ¡
equipollent : a, n, Èû(¼¼·Â, È¿·Â, Áß·®)ÀÌ °°Àº (°Í), È¿°ú(°á°ú, ¶æ)°¡ °°Àº(°Í), equipollently, ad
equiponderance : n, ¹«°Ô(¼¼·Â, ±Ç·Â)ÀÇ ±ÕÇü, ÆòÇü
equiponderant : a, ¹«°Ô(¼¼·Â, ±Ç·Â)°¡ Æò±Õ(ÆòÇü)µÈ
equiponderate : vt, (¹«°Ô µîÀ»)Æò±Õ(ÆòÇü)½ÃÅ°´Ù
equipotential : a, n, µî¾Ğ¼±ÀÇ, µîÀüÀ§ÀÇ, µî¾Ğ¼±, µîÀüÀ§
equiprobable : a, (³í)°°Àº Á¤µµÀÇ °³¿¬¼º(È®·ü)ÀÌ ÀÖ´Â
equisetum : n, ¼Ó»õ·ù
equitable : a, °øÆòÇÑ, °øÁ¤ÇÑ, ÇüÆò¹ı»óÀÇ
equitably : ad, °øÁ¤(Á¤´ç)ÇÏ°Ô
equitation : n, ¸¶¼ú, ½Â¸¶
equites : n, (°í´ë ·Î¸¶ÀÇ)±â»ç °è±Ş
equitime point : x, Çàµ¿ÇÑ°èÁ¡, ÁøÃâ ÇÑ°èÁ¡
equity : n, °øÆò, °øÁ¤, ÇüÆò¹ı
equity capital : x, (°æ)ÀÚ±â ÀÚº», ÅõÀÔ ÀÚº»
equiv, : x, equivalent
equivalence : n, (°¡Ä¡, Èû ¾çÀÌ)°°À½, µî°¡, µ¿·®, (È­)(¿øÀÚÀÇ)µî°¡, µî·®, (¸», Ç¥ÇöÀÇ)µî°¡¼º, µ¿ÀÇ¼º
equivalent : a, n, µ¿µîÀÇ, ~¿¡ »ó´çÇÏ´Â, µ¿µîÇÑ °¡Ä¡ÀÇ, µî·®ÀÇ, µ¿ÀÇÀÇ, µ¿µîÇÑ ¹°°Ç, ´ëµîÇÑ ¹°°Ç, µ¿ÀÇ¾î
equivocal : a, ¸ğÈ£ÇÑ, µÎ°¡Áö ¶æÀ¸·Î ÇØ¼®µÉ ¼ö ÀÖ´Â, ÀÇ½É½º·¯¿î, ¸í¹éÇÏÁö ¾ÊÀº
equivocality : n, ´ÙÀÇ¼º, ¸ğÈ£, ¹Ì½É½º·¯¿ò, =EQUIVOQUE
equivocate : vi, ¸ğÈ£ÇÑ¸»À»¾²´Ù, ÀÌ·¸°Ôµµ Àú·¸°Ôµµ ÇØ¼®µÉ ¼ö ÀÖ´Â ¸»À» ¾²´Ù, ¼ÓÀÌ´Ù
equivocation : n, ¸ğÈ£ÇÑ ¸»(À» ¾²±â), ¾ó¹ö¹«¸²
equivocator : n, ¸ğÈ£ÇÑ ¸»À» ¾²´Â »ç¶÷, ¾ó¹ö¹«¸®´Â »ç¶÷
equivoque : n, ¸ğÈ£ÇÑ ¸»Åõ(¾î±¸), Àç´ã
er : int, ¿¡¿¡, Àú¾î(¸Á¼³ÀÌ°Å³ª ¸»ÀÌ ¸·ÇûÀ» ¶§ ³»´Â ¼Ò¸®)
Er : x, (È­)erbium
ER : x, (¾ß)earned run, enroute
er : suf, (µ¿»ç¿Í ¸í»ç¿¡¼­ µ¿ÀÛÀÚ)¸í»ç¸¦ ¸¸µë, ...ÇÏ´Â °Í, ¹İº¹À» Ç¥½ÃÇÏ´Â µ¿»ç¸¦ ¸¸µê
era : n, ±â¿ø, ¿¬´ë, ½Ã´ë, ´ë, ±â
ERA : x, earned run average(¾ß±¸)(Åõ¼öÀÇ)¹æ¾îÀ², Educational Research Administration, Emergency Relief Administration±ä±Ş ±¸Á¦±¹
eradiate : vt, (ºû, ¿­À»)¹æ»çÇÏ´Ù
eradiation : n, ¹æ»ç
eradicable : a, ±ÙÀıÇÒ¼öÀÖ´Â
eradicant : n, (±â»ı »ı¹°)±ÙÀıÁ¦
eradicate : vt, ±ÙÀıÇÏ´Ù
eradication : n, ±ÙÀı, ¹Ú¸ê
eradicative : a, ±ÙÀı(±ÙÄ¡)½ÃÅ°´Â
eradicator : n, Á¦ÃÊ±â, ¾ó·è»©´Â ¾à, À×Å© Áö¿ì°³
erasable : a, Áö¿ï ¼ö ÀÖ´Â
erasable bond : x, ÀÌ·¹ÀÌÀúºí º»µåÁö(½±°Ô Áö¿ï ¼ö ÀÖ°Ô ÇÑ ÄÚµùÁö)
erase : vt, Áö¿ö¹ö¸®´Ù, ¸»»ìÇÏ´Ù, »èÁ¦ÇÏ´Ù
eraser : n, Ä¥ÆÇ Áö¿ì°³, °í¹« Áö¿ì°³, À×Å© Áö¿ì°³
Erasian : a, n, À¯¶ó½Ã¾ÆÀÇ, À¯¶ó½Ã¾Æ È¥Ç÷¾Æ
erasion : n, »èÁ¦, ¸»¼Ò, (¿Ü°ú)(ÅÂ¾ÆÀÇ)¼ÒÆÄ, Á¦°Å
Erasmian : a, ERASMUSÀ¯ÆÄÀÇ, ¿¡¶ó½º¹«½º ÇĞµµ
Erasmus : n, ¿¡¶ó½º¹«½º
Erastian : n, ERASTUSÀ¯ÆÄÀÇ, ¿¡¶ó½ºÅõ½º¼³ÀÇ ½ÅºÀÀÚ
Erastianism : n, ¿¡¶ó½ºÅõ½º¼³(Á¾±³´Â ±¹°¡¿¡ Á¾¼ÓÇÏ¿©¾ß ÇÑ´Ù´Â ¼³)
Erastus : n, ³²ÀÚ ÀÌ¸§, ¿¡¶ó½ºÅõ½º
erasure : n, Áö¿ö ¾ø¾Ú, ¸»¼Ò, »èÁ¦ ºÎºĞ(¾î±¸), Áö¿î ÀÚ±¹
Erato : n, (±×½Å)¿¡¶óÅä
erbium : n, (È­)¿¡¸£ºç(ÈñÅä·ù ¿ø¼Ò)
ERDA : x, Energy Research and Development Administration (¹Ì)¿¡³ÊÁö ¿¬±¸ °³¹ß±¹
ere : prep, conj, ~ÀÇÀü¿¡, ~ÀÌÀü¿¡, ~º¸´Ù Â÷¶ó¸®
Erebus : n, (±×½Å)¿¡·¹º¸½º
erect : a, vt, ²Æ²ÆÀÌ¼±, ²Æ²ÆÀÌ ¼¼¿ì´Ù, °Ç¸³ÇÏ´Ù
erectile : a, ²Æ²ÆÀÌ¼³¼öÀÖ´Â, ¹ß±âÇÒ ¼ö ÀÖ´Â
erection : n, °Ç¸³, Á÷¸³, ¼³¸³, °Ç¹°, ¹ß±â
erective : a, Á÷¸³·ÂÀÌ ÀÖ´Â
erectly : ad, Á÷¸³ÇÏ¿©, ¼öÁ÷À¸·Î
erectness : n, Á÷¸³(·Â), ¼öÁ÷¼º
erector : n, °Ç¼³ÀÚ, Ã¢¼³(¼³¸³)ÀÚ
erelong : ad, ¸ÓÁö¾Ê¾Æ
eremite : n, ÀºÀÚ
eremitic : a, ÀºÀÚÀûÀÎ
eremitism : n, ÀºÀÚ(ÀºµĞ)»ıÈ°
erethism : n, (º´¸®)½Å°æ °ú¹Î, ½Å°æ¼º ÈïºĞ
erewhile : ad, Á¶±İÀü¿¡
erg : n, ¿¡¸£±×
erg- : x, (¿¬°áÇü)(ÀÏ)ÀÇ ¶æ
ergate : n, ÀÏ°³¹Ì
ergatocracy : n, ³ëµ¿ÀÚ Á¤Ä¡
ergo : ad, (ÀÍ»ì)±×·±°í·Î
ergograph : n, ÀÛ¾÷ ±â·Ï±â(±ÙÀ°ÀÇ ÀÛ¾÷ ´É·Â, ÇÇ·Îµµ µîÀÇ)
ergolatry : n, ³ëµ¿¼ş¹è
ergometer : n, Ãø·Â°è, ¿¡¸£±× ÃøÁ¤±â
ergon : n, ¿­ÀÇ ÀÛ¿ëÀ¸·Î ÀÌ·ç¾îÁö´Â ÀÏÀÇ¾ç
ergonomic : a, ÀÎ°£ È¯°æ °øÇĞÀÇ
ergonomics : n, ÀÛ¾÷´É·ü(È¿°ú)¿¬±¸, ÀÎ°£°øÇĞ
ergonomist : n, ÀÎ°£ °øÇĞ ¿¬±¸ÀÚ
ergosphere : n, (Ãµ)ÀÛ¿ë±Ç(ºí·¢È¦À» µÑ·¯ ½Ñ °¡»óÀÇ ´ë)
ergosterol : n, ¿¡¸£°í½ºÅ×·Ñ(ÀÚ¿Ü¼± Á¶»ç·Î ºñÅ¸¹Î D·Î º¯È¯ÇÔ)
ergot : n, (È£¹ĞÀÇ)¸Æ°¢º´, ¸Æ°¢(ÁöÇ÷Á¦, ÀÚ±Ã¼öÃàÁ¦)
ergotism : n, (ÀÇ)¸Æ°¢ Áßµ¶
Eric : n, ³²ÀÚ ÀÌ¸§
Erica : n, ¿©ÀÚ ÀÌ¸§
ericaceous : a, (½Ä)Ã¶Âß°úÀÇ
Ericsson method : x, ¿¡¸¯½¼ ¹ı(ÀÎ°ø ¼öÁ¤¹ıÀÇ ÇÏ³ª)
Erie : n, ¹Ì±¹ºÏµ¿ºÎÀÇ¿À´ëÈ£ÀÇÇÏ³ª
Erin : n, Ireland
Erinyes : n, (±×½Å)=FURIES
Eris : n, ´ÙÅù°úºÒÈ­ÀÇ¿©½Å
eristic : a, n, ³íÀï»óÀÇ, ³íÀïÀûÀÎ, ³íÀïÀÚ, ³íÀï¼ú
Eritrea : n, ¿¡¸®Æ®·¹¾Æ(¾ÆÇÁ¸®Ä« ºÏµ¿ºÎ, È«ÇØ¿¡ ÀÓÇÑ ¿¡Æ¼¿ÀÇÇ¾Æ ÀÚÄ¡·É)
erk : n, ½Åº´, Áö»ó±Ù¹«¿ø, ¾ó°£ÀÌ
erlking : n, (ÆøÇ³¿ì¸¦ÀÏÀ¸Å°°í, ¶Ç¾î¸°ÀÌ¸¦ÇØÄ¡´Â)¸¶¿Õ
ermine : n, Èò´ãºñ, Èò´ãºñÀÇ ¸ğÇÇ·Î ¾ÈÀ» ´í¹ıº¹, ¹ı°üÀÇ ÁöÀ§, Èò ¹ÙÅÁ¿¡ °ËÀº Á¡¹ÚÀÌ ¹«´Ì(Ä«µåÀÇ kinÀÇ ±ê¿¡ º¼ ¼ö ÀÖÀ½)
ermined : a, ¾î¹ÌÀÇ ÅĞ·Î µ¤ÀÎ(Àå½ÄÇÑ), ¾î¹Î ¸ğÇÇ¸¦ ÀÔÀº
ern : suf, (...ÂÊÀÇ)ÀÇ ¶æ
erne : n, (Á¶)Èò²¿¸®¼ö¸®
Ernest : n, ³²ÀÚ ÀÌ¸§
Ernestine : n, ¿©ÀÚ ÀÌ¸§
Ernie : n, »ó±İºÎ Ã¤±ÇÀÇ ´ç¼± ¹øÈ£¸¦ ÃßÃ·ÇÏ´Â ÀåÄ¡
erode : vt, ºÎ½ÄÇÏ´Ù, Ä§½ÄÇÏ´Ù
erodible : a, Ä§½Ä °¡´ÉÇÑ
erogenous : a, (ÀÇ)¼º¿åÀ» ÀÚ±ØÇÏ´Â, ¼ºÀûÀ¸·Î ¹Î°¨ÇÑ
Eros : n, ¿¡·Î½º(»ç¶ûÀÇ½Å, ·Î¸¶½ÅÈ­ÀÇCupid¿¡ÇØ´çÇÔ)
erose : a, °í¸£Áö ¾ÊÀº, ¿ïÅüºÒÅüÇÑ, (½Ä)(ÀÙµîÀÇ °¡ÀåÀÚ¸®°¡)Åé´Ï ¸ğ¾çÀ¸·Î Â°Áø
erosion : n, ºÎ½Ä, Ä§½Ä
erosive : a, ºÎÄ§½Ä¼ºÀÇ
erotic : a, ¼º¾ÖÀÇ, ¾Ö¿åÀÇ
erotica : n, ¼º¾Ö¸¦´Ù·é¹®ÇĞ
eroticism : »öÁ¤Àû °æÇâ, È£»ö, ¼ºÀû, 
eroticist : n, ¼º¿åÀÌ °­ÇÑ »ç¶÷, ¿¡·Î ÀÛ°¡(¹è¿ì)
erotism : n, (ÀÇ)=EROTICISM
erotogenic : a, =EROGENOUS
erotological : a, 
erotology : n, È£»ö¹®ÇĞ(¿¹¼ú)
erotomania : n, »öÁ¤±¤
erotophobic : a, ¼ºÀû Ç¥ÇöÀ» °Ì³»´Â, ¼ºÀû ÇàÀ§¸¦ Çø¿ÀÇÏ´Â
ERP : x, European Recovery Program À¯·´ ºÎÈï °èÈ¹
err : vi, Àß¸øÇÏ´Ù, ±×¸£Ä¡´Ù, ÁË¸¦ ¹üÇÏ´Ù
errable : a, 
errancy : n, (ÆÇ´Ü µîÀÇ)Àß¸ø, »ó±Ô¸¦ ¹ş¾î³², ½Ç¼öÇÏ±â ½¬¿ò, °æ¼Ö, º¯´ö
errand : n, ½ÉºÎ¸§(´Ù´Ï±â), º¼ÀÏ, »ç¸í
errand boy : x, ½ÉºÎ¸§²Û¼Ò³â, º¼ÀÏ, »ç¸í(go errands ½ÉºÎ¸§´Ù´Ï´Ù, go on an errand ½ÉºÎ¸§ °¡´Ù)
errant : a, (¸ğÇèÀ»Ã£¾Æ)Æí·ÂÇÏ´Â, Àß¸øµÈ
errantry : n, ¹«¿¹¼ö·Ã, Æí·Â, ¹æ¶û
errata : n, erratumÀÇ º¹¼ö
erratic : a, º¯´ö½º·¯¿î, ÀÏÁ¤Ä¡ ¾ÊÀº, ºÒ±ÔÄ¢ÇÑ, º°³­, »ó±Ë¸¦ ¹ş¾î³­
erratical : a, =ERRATIC
erratum : n, ¿ÀÀÚ, ¿À½Ä, Àß¸ø
erroneous : a, Àß¸øµÈ, Æ²¸°
error : n, Àß¸ø, Æ²¸², Àß¸ø»ı°¢, °ú½Ç, ½ÇÃ¥, ¿¡·¯, ÁË, ¿ÀÂ÷, ¿À½É
error catastrophe : x, (»ıÈ­)¿¡·¯ Ä«Å¸½ºÆ®·ÎÇÇ(³ëÈ­ Çö»ó ÀÌ·ĞÀÇ ÇÏ³ª)
error message : x, (Àü»ê)¿¡·¯ ¸Ş½ÃÁö(ÇÁ·Î±×·¥¿¡ Àß¸øÀÌ ÀÖÀ» ¶§ Ãâ·ÂµÇ´Â ¸Ş½ÃÁö)
ersatz : n, ´ë¿ëÀÇ, ´ë¿ëÇ°
Erse : n, a, ¾î½º¸»(½ºÄÚÆ²·£µåÀÇ °ÔÀÏ¸», ¶Ç´Â ¾ÆÀÏ·£µåÀÇ ÄÌÆ®¾î)
erst : ad, ÀÌÀü¿¡, ¿¾³¯¿¡
erstwhile : ad, a, ÀÌÀü¿¡, ÀÌÀüÀÇ, ¿¾³¯ÀÇ
ERTS : x, ¾îÃ÷(Áö±¸ ÀÚ¿ø Å½»ç À§¼º Á¦1È£, µÚ¿¡ LandsatÀ¸·Î °³Äª)
erubescence : n, (ÇÇºÎ°¡)ºÓ¾îÁü, ºÓÀº ºûÀ» ¶ï, È«Á¶
erubescent : a, (ÇÇºÎ°¡)ºÓÀº ºûÀ» ¶í, ºÓ¾îÁö´Â
eruct : vi, vt, Æ®¸²ÇÏ´Ù, ºĞÃâÇÏ´Ù
eructation : n, Æ®¸², (È­»êÀÇ)ºĞÃâ(¹°)
eructative : a, Æ®¸²ÀÌ ³ª´Â, (È­»ê)ºĞÃâÀÇ(¿¡ °üÇÑ)
erudite : a, n, ¹Ú½ÄÇÑ(»ç¶÷)
erudition : n, ¹Ú½Ä, ÇØ¹Ú
Eruoradio : n, À¯·Î¶óµğ¿À(¼­À¯·´ ±¹°¡ °øµ¿ °æ¿µÀÇ ¶óµğ¿À ¹æ¼Û±¹)
erupt : vi, vt, ºĞÃâÇÏ´Ù, ºĞÃâ½ÃÅ°´Ù, ºĞÈ­ÇÏ´Ù, ¹ßÁøÇÏ´Ù
eruption : n, Æø¹ß, ºĞÃâ, ºĞÈ­, µ¹¹ß, ¹ßÁø
eruptional : a, ºĞÈ­ÀÇ, Æø¹ßÀÇ
eruptive : a, Æø¹ß(µ¹¹ß)ÀûÀÎ, ¹ßÁø¼ºÀÇ
ERW : x, enhanced radiation weapon
Erwin : n, ³²ÀÚ ÀÌ¸§
ery : x, (¼ºÁú, Çà»ö, ½À°ü)ÀÇ ¶æ, (...»ó, ...¾÷, ...¼ú)ÀÇ ¶æ
erysipelas : n, ´Üµ¶
erythema : n, (º´¸®)È«Áø, È«¹İ
erythorbate : n, (È­, ¾à)¿¡¸®¼Ò¸£ºó»ê¿°(½ÄÇ°ÀÇ »êÈ­ ¹æÁöÁ¦)
erythr- : x, (¿¬°áÇü)(Àû, ÀûÇ÷±¸)ÀÇ ¶æ
erythrocyte : n, ÀûÇ÷±¸
erythroid : a, ÀûÇ÷±¸ÀÇ(¸¦ ¸¸µå´Â)
erythroleukemia : n, (ÀÇ)Àû¹éÇ÷º´
erythromycin : n, ¿¡¸®½º·Î¸¶ÀÌ½Å(Ç×»ı ¹°Áú)
erythron : n, (»ı¸®)¿¡¸®Æ®·Ğ(°ñ¼ö ¾ÈÀÇ ÀûÇ÷±¸¿Í ±× Àü½Å)
erythrophobia : n, (Á¤ÀÇ)Àû¸é, °øÆ÷Áõ, Àû»ö °øÆ÷Áõ
erythropoiesis : n, (»ı¸®)(°ñ¼ö¿¡¼­ÀÇ)ÀûÇ÷±¸ »ı¼º
erythropoietin : n, (»ı¸®)¿¡¸®½º·ÎÆ÷ÀÌ¿¡Æ¾(ÀûÇ÷±¸ »ı¼º ÃËÁø ÀÎÀÚ)
Es : x, (È­)einsteinium
es : x, ¸í»çÀÇ º¹¼ö ¾î¹Ì, µ¿»çÀÇ Á¦ 3ÀÎÄª ´Ü¼ö, ÇöÀçÇüÀÇ ¾î¹Ì
es- : pref, =EX
ESA : x, European Space Agency
Esau : n, ¿¡¼­(ÀÌ»èÀÇÅ«¾Æµé)
ESB : x, electrical stimulation of the brain³úÀÇ Àü±â ÀÚ±Ø
esbat : n, ¸¶³àÀÇ ÁıÈ¸
Esc : x, escueo(s)
ESC : x, Economic and Social Council, escape(Àü»ê)È®Àå
escadrille : n, ºñÇà´ë, ¼ÒÇÔ´ë
escalade : vt, n, »ç´Ú´Ù¸®·Î¿À¸£´Ù, »ç´Ú´Ù¸®·Î ¿À¸§, ¼ºº®À» ±â¾î¿À¸§(±â¾î¿À¸£´Ù)
escalate : vt, vi, (±º»çÇàµ¿µûÀ§¸¦)´Ü°èÀûÀ¸·ÎÈ®´ëÇÏ´Ù, ´Ü°èÀûÀ¸·Î °­È­ÇÏ´Ù, Á¡ÁõÇÏ´Ù
escalation : n, (°¡°İ, ÀÓ±İ, ¿îÀÓµîÀÇ)¿¡½ºÄ®·¹ÀÌÅÍ½Ä¼öÁ¤
escalator : n, a, ¿¡½ºÄÃ·¹ÀÌÅÍ, ÀÚµ¿°è´Ü, ¿¡½ºÄÃ·¹ÀÌÅÍ½ÄÀÇ
escalator clause : , ·±´ø ÇØ±º Á¶¾à(1930)ÀÇ ½ÅÃà Á¶Ç×, ÀÓ±İ°è¾àÀÇ ¿¡½ºÄÃ·¹ÀÌÅÍ Á¶Ç×(¹°°¡ º¯µ¿¿¡ µû¶ó ÀÓ±İÀ» Áõ°¨ÇÑÁğ ±ÔÁ¤)
escalator scale : x, ¿¡½ºÄÃ·¹ÀÌÅÍ Á¶Ç×¿¡ ÀÇÇÑ ÀÓ±İ Ã¼°è
escalatory : a, (Æ¯È÷ ÀüÀïÀÇ)±Ô¸ğ È®´ë¿¡ ¿¬°èµÇ´Â
escallop : n, =SCALLOP
ESCAP : x, Economic and Social Commission of Asia and Pacific (À¯¿£)¾Æ½Ã¾Æ ÅÂÆò¾ç °æÁ¦ »çÈ¸ À§¿ø
escapable : a, µµ¸ÁÄ¥ ¼ö ÀÖ´Â, ÇÇÇÒ ¼ö ÀÖ´Â
escapade : n, ¸Ú´ë·Î±¸´ÂÁş, ¾û¶×ÇÑ Áş, Àå³­, µµÇÇ, Å»Ãâ
escape : vi, vt, n, a, ´Ş¾Æ³ª´Ù, Å»ÃâÇÏ´Ù, ¸éÇÏ´Ù, (±â¾ï¿¡)³²Áö¾Ê´Ù, (°¡½ºµûÀ§°¡)»õ´Ù, µµ¸Á, µµÇÇ
escape artist : x, µ¿¾ÆÁÙ, ÅëÀ» ºüÁ® ³ª°¡´Â °î¿¹»ç, Å»¿ÁÀÇ ¸í¼ö
escape clause : x, ¸éÁ¦Á¶Ç×, ¸éÃ¥Á¶Ç×
escaped : a, Å»ÁÖÇÑ, µµ¸ÁÇÑ
escapee : n, µµÇÇÀÚ, Å»¿ÁÀÚ
escape hatch : x, (ºñÇà±âµûÀ§ÀÇ)ÇÇ³­¿ëºñ»ó±¸, (¾î·Á¿î »çÅÂ µî¿¡¼­ÀÇ)µµÇÇ±¸
escape literature : x, µµÇÇ¹®ÇĞ
escape mechanism : x, (½É)µµÇÇ ±âÁ¦
escapement : n, µµÆÄ±¸, ½Ã°è Åé´Ï¹ÙÄûÀÇ Å»Áø ÀåÄ¡
escape pipe : x, (escape valve¿¡¼­ ¹èÃâµÇ´Â ¾×Ã¼, Áõ±âÀÇ)¹èÃâ°ü
escape ramp : x, ÇÇ³­µµ·Î
escape valve : x, ¹è±â¹ëºê
escape velocity : x, (·ÎÄÏÀÇ)Å»Ãâ¼Óµµ
escape wheel : x, (½Ã°è Åé´Ï¹ÙÄûÀÇ)¹æÅ» ÀåÄ¡
escapism : n, Çö½ÇµµÇÇ(ÁÖÀÇ)
escapist : n, a, µµÇÇÁÖÀÇÀÚ, Çö½Ç µµÇÇ(ÁÖÀÇ)ÀÇ
escapologist : n, µ¿¾ÆÁÙ(¹Ù±¸´Ï)À» ºüÁ® ³ª°¡´Â °î¿¹»ç
escapology : n, µ¿¾ÆÁÙ(¹Ù±¸´Ï)À» ºüÁ® ³ª°¡´Â °î¿¹(±â¼ú), Å»ÁÖ¹ı, Å»Ãâ¼ú
escargot : n, ½Ä¿ë´ŞÆØÀÌ
escarole : n, ²É»óÃßÀÇÀÏÁ¾
escarp : n, vt, ESCARP
escarpment : n, ±Ş»ç¸é, º­¶û
esce : suf, (...ÇÏ±â ½ÃÀÛÇÏ´Ù, ...À¸·Î µÇ´Ù, È­ÇÏ´Ù)ÀÇ ¶æ
escence : suf, (...ÇÏ´Â ÀÛ¿ë, °æ°ú, °úÁ¤, º¯È­, ...»óÅÂ)ÀÇ ¶æ
escent : suf, (...±âÀÇ, ...¼ºÀÇ)ÀÇ ¶æ
eschalot : n, (½Ä)=SHALLOT
eschatological : a, (½ÅÇĞ)Á¾¸»·ĞÀÇ
eschatology : n, (¼¼°è)Á¾¸»·Ğ, ³»¼¼°ü
escheat : vi, vt, n, (ÅäÁöµûÀ§°¡±¹¿Õ, ¿µÁÖ¿¡°Ô)±Í¼ÓÇÏ´Ù, ±Í¼Ó½ÃÅ°´Ù, ¸ô¼öÇÏ´Ù, ÅäÁöÀÇ º¹±Í, ÅäÁöÀÇ ¸ô¼ö, ¸ô¼öÁö
escheatage : n, (¹ı)(ºÎµ¿»ê)º¹±Í±Ç
escheator : n, (¹ı)¸ô¼ö(º¹±Í)Áö °ü¸®ÀÚ
Escherichia coli : n, ´ëÀå±Õ
eschew : vt, ÇÇÇÏ´Ù
eschscholtzia : n, (½Ä)±İ¿µÈ­
Escorial : n, ¿¡½ºÄÚ¸®¾Ë
escort : n, vt, È£À§ÀÚ, È£À§, È£¼Û, È£À§ÇÏ´Ù, È£¼ÛÇÏ´Ù
escort agency : x, »ç±³Àå µî¿¡ µ¿¹İÇÒ ³²³à¸¦ ¼Ò°³ÇÏ´Â ¾Ë¼±¼Ò
escort carrier : x, È£À§¿ë ¼ÒÇü Ç×°ø ¸ğÇÔ
escort figher : x, (Æø°İ±âÀÇ)È£À§ ÀüÅõ±â
escribe : vt, (¼ö)¹æÁ¢¿øÀ» ±×¸®´Ù
escritoire : n, (¼­¶ø´Ş¸°)Ã¥»ó
escrow : n, (¹ı)Á¶°ÇºÎ ³¯ÀÎ Áõ¼­
escudo : n, Æ÷¸£Åõ°¥ÀÇÈ­Æó´ÜÀ§, ¿¡½ºÄíµµ ±İ(Àº)È­
esculent : a, n, ½Ä¿ë¿¡¾Ë¸ÂÀº, ½Ä¿ëÇ°, (Æ¯È÷)¾ßÃ¤
escutcheon : n, ¹æÆĞ¸ğ¾çÀÇ¹°°Ç, ¹æÆĞ ¸ğ¾çÀÇ ¹®Àå ¹ÙÅÁ
Esd, : x, (¼º)Esdras
Esdras : n, °æ¿Ü ¼º¼­ÀÇ Ã³À½ µÎ ±Ç Áß ¾î´À ÇÏ³ª
ESE : x, eastsoutheast
ese : x, (Áö¸í¿¡ ºÙ¿©¼­)(...ÀÇ, ...¸»(ÀÇ)), (ÀÛ°¡, ´ÜÃ¼ ÀÌ¸§¿¡ ºÙ¿©¼­)(...Ç³ÀÇ, ...¿¡ Æ¯À¯ÇÑ)ÀÇ ¶æ
Esk, : x, Eskimo
Eskimo : n, ¿¡½ºÅ°¸ğ
Eskimoan : a, ¿¡½ºÅ°¸ğ »ç¶÷(¸¸)ÀÇ
Eskimo dog : x, ¿¡½ºÅ°¸ğ °³(½ä¸Å °³)
Eskimo roll : x, ¿¡½ºÅ°¸ğ½Ä Àüµµº¹¿ø
Esky : n, (¿À½º)¿¡½ºÅ°(Âù À½·á¸¦ ´ã´Â ÈŞ´ë ¿ë±â, »óÇ¥¸í)
ESL : x, English as a second language
ESOL : x, (¹Ì, Ä³³ª´Ù)English for Speakers of Other Languages
ESOP : n, Á¾¾÷¿ø ÁöÁÖ Á¦µµ
esophageal : a, ½ÄµµÀÇ
esophageal : a, ½Äµµ(esophageal cancer ½Äµµ¾Ï)
esophagus : n, ½Äµµ
esoteric : a, ¼Ò¼öÀÇÇĞÀÚ¿¡°Ô¸¸Àü¼öµÇ´Â, ºñÀüÀÇ, ºñ±³ÀÇ, ºñ¹ĞÀÇ
ESP : x, extrasensory perception, (½É)ÃÊ°¨°¢Àû°¨Áö, ¿µ°¨
espadrille : n, ¿¡½ºÆÄµå¸®À¯(²öÀ» ¹ß¸ñ¿¡ °¨°í ½Å´Â Äµ¹ö½ºÈ­)
espalier : n, °ú¼ö(³ª¹«)¸¦¹ŞÄ¡´Â½Ã··
Espana : n, ½ºÆäÀÎ
esparto : x, (½Ä)¾ÆÇÁ¸®Ä« ¼ö¿°»õ
especial : a, Æ¯º°ÇÑ, °¢º°ÇÑ
especially : ad, Æ¯È÷, À¯´Ş¸®, À¯º°³ª°Ô
Esperantist : n, ¿¡½ºÆä¶õÅä¾î ÇĞÀÚ
Esperanto : n, ¿¡½ºÆä¶õÅä
espial : n, Á¤Âû, °¨½Ã
espiegle : a, (F)Àå³­²Ù·¯±âÀÇ
espionage : n, Å½»ö, °£Ã¸ÇàÀ§, °£Ã¸À» ¾¸
esplanade : n, (Æ¯È÷¹Ù´å°¡, È£¼ı°¡µûÀ§ÀÇ)»êÃ¥±æ, (¿ä»õ¿Í ½Ã³» ¹Î°¡ »çÀÌ¸¦ °İ¸®ÇÏ´Â)°øÅÍ
espousal : n, ¾àÈ¥, È¥·Ê, Ã¤¿ë, ÁöÁö, ¿ËÈ£
espouse : vt, ~¿Í°áÈ¥ÇÏ´Ù, ½ÃÁıº¸³»´Ù, Ã¤¿ëÇÏ´Ù, (ÀÇ°ß, ÇĞ¼³ µîÀ»)ÁöÁöÇÏ´Ù
espresso : n, ¿¡½ºÇÁ·¹¼Ò Ä¿ÇÇ(ºĞ¸»¿¡ ½ºÆÀÀ» Åë°ú½ÃÄÑ ¸¸µê), ¿¡½ºÇÁ·¹¼Ò Ä¿ÇÇÁ¡
espress wagon : x, Áö±Ş ¼ö¿ë¿ë ¿Ö°Ç
esprit : n, Á¤½Å, ¿¡½ºÇÁ¸®, ÀçÄ¡
esprit d'escalier : x, =wit on the staircase »çÈÄÀÇ ¸í¾È
esprit de corps : x, ´ÜÃ¼ Á¤½Å, ´Ü°á½É(¾Ö±³½É µûÀ§)
esprit fort : n, (F)ÀÇÁö°¡ °­ÇÑ »ç¶÷, ÀÚÀ¯ »ç»ó°¡
espy : vt, Ã£¾Æ³»´Ù, ¹ß°ßÇÏ´Ù, ¾Ë¾ÆÃ¤´Ù
Esq, : x, Esquire
esque : suf, (...½ÄÀÇ, ...¸ğ¾çÀÇ)ÀÇ ¶æ
Esquimau : n, =ESKIMO
esquire : n, ´Ô, ±ÍÇÏ
esquisse : n, (F)(¹Ì)¿¡½ºÅ°½º, È­°í, (¼³°èµµÀÇ)ÃÊ¹ú ±×¸²
ESR : x, electron spin resonance
ESRO : x, European Space Research Organization À¯·´ ¿ìÁÖ ¿¬±¸ ±â±¸
ess : n, SÀÚ
ess : suf, ¿©¼º ¸í»ç¸¦ ¸¸µê
Ess, : x, Essex
ESSA : , Environmental Science Services Administration
essay : n, vt, vi, ¼öÇÊ, ¼Ò·Ğ, ½Ã·Ğ, Æò·Ğ, ½Ãµµ, ½ÃµµÇÏ´Ù, ½ÃÇèÇÏ´Ù
essayette : n, ÂªÀº¼öÇÊ
essay examination : x, ³í¹®(³í¼ú)½ÃÇè
essayist : n, ¼öÇÊ°¡, Æò·Ğ°¡
essayistic : a, ¼öÇÊ(°¡)ÀÇ, ¼öÇÊÁ¶ÀÇ, ¼³¸íÀûÀÎ, °³ÀÎ »öÃ¼°¡ Â£Àº
esse : n, (Ã¶)Á¸Àç, ½ÇÀç
essence : n, º»Áú, Á¤¼ö, ½ÇÃ¼, ¿¡¼¾½º, ¿¢½º, Á¤, Çâ¼ö
Essene : n, ¿¡¼¼³×ÆÄ(°í´ë À¯´ëÀÇ ±İ¿å, ½ÅºñÁÖÀÇÀÇ ÇÑ ÆÄ)ÀÇ ½Åµµ
essential : a, n, º»ÁúÀûÀÎ, ½ÇÁúÀÇ, ÇÊ¼öÀÇ, Á¤¼öÀÇ, ¿¡¼¾½ºÀÇ, ±âº»ÀÇ, º»Áú, ¿äÁ¡, ¿ä¼Ò
essential amino acid : x, (È­)ÇÊ¼ö ¾Æ¹Ì³ë»ê
essentialism : n, (¹Ì)(±³À°)º»ÁúÁÖÀÇ, (Ã¶)½ÇÀç·Ğ, º»ÁúÁÖÀÇ
essentiality : n, º»¼º, º»Áú, ¿äÁ¡, °ñÀÚ
essentially : ad, º»ÁúÀûÀ¸·Î
essential oil : x, (½Ä¹°¼º)Á¤À¯, ¹æÇâÀ¯(Çâ¼öÀÇ ¿ø·á)
essentic : a, °¨Á¤À» ¹ÛÀ¸·Î ³ªÅ¸³»´Â
Essex : n, ¿µ±¹³²µ¿ºÎÀÇÁÖ
Essie : n, ¿©ÀÚ ÀÌ¸§
Esst African Community : x, µ¿¾ÆÇÁ¸®Ä« °øµ¿Ã¼
est : x, ½É½Å ÅëÀÏ ÈÆ·Ã(Áı´Ü °¨¼ö¼º ÈÆ·ÃÀÇ ÇÏ³ª)
EST : x, Eastern standard time(¹Ì)µ¿ºÎ Ç¥ÁØ½Ã, electroshock therapy
est : suf, Çü¿ë»ç, ºÎ»çÀÇ ÃÖ»ó±Ş ¾î¹Ì
est, : x, established, estate, estimated, estuary
establish : ¼³¸³ÇÏ´Ù, È®¸³ÇÏ´Ù, Á¦Á¤ÇÏ´Ù, (»ç¶÷ÀÇ)±â¹İÀ» Àâ°ÔÇÏ´Ù, (ÁöÀ§¿¡)¾ÉÈ÷´Ù, °³¾÷½ÃÅ°´Ù, ¾ÈÁ¤µÈ  ÁöÀ§¿¡ ³õÀÌ°Ô ÇÏ´Ù, Á¤ÇÏ´Ù, ÀÎÁ¤ÇÏ´Ù, ÀÔÁõÇÏ´Ù, È®ÁõÇÏ´Ù
established : a, È®¸³µÈ, È®Á¤µÈ, ¸¸¼ºÀÇ
Established Church : x, ¿µ±¹ ±¹±³È¸
establishmentarian : n, a, ¿µ±¹±¹±³È¸(ÀÇ), ±× ½ÅºÀÀÚ(ÀÇ), Ã¼Á¦ÁÖÀÇÀÚ(ÀÇ), Ã¼Á¦ÆÄ(ÀÇ)
estaminet : n, ÀÛÀº ¼úÁı, ÀÛÀº Ä«Æä
estate : Àç»ê, À¯»ê, ¼ÒÀ¯±Ç, Àç»ê±Ç, ÅäÁö, ¼ÒÀ¯Áö, »ì¸²»ìÀÌ, Ã³Áö, »çÈ¸Àû  ÁöÀ§, »çÈ¸Àû ½ÅºĞ, (Á¤Ä¡, »çÈ¸Àû)°è±Ş(personal  estate µ¿»ê, the 
estate agent : x, ºÎµ¿»ê°ü¸®ÀÎ, Áß°³¾÷ÀÚ
estate car : x, =STATION WAGON
estated : a, Àç»êÀÌ ÀÖ´Â
Estates General : x, =STATES GENERAL
estate tax : x, »ó¼Ó¼¼
estavlishment : n, ¼³¸³, ¼³Á¤, ¼³Ä¡, È®¸³, ¼³¸³¹°, ½Ã¼³, ¼¼´ë, Á¶Á÷, Á¦µµ, È¸»ç, Á¡Æ÷, °íÁ¤ ¼öÀÔ
esteem : vt, n, Á¸°æÇÏ´Ù, Á¸ÁßÇÏ´Ù, ±ÍÁßÈ÷ ¿©±â´Ù, ~ÀÌ¶ó°í »ı°¢ÇÏ´Ù, °£ÁÖÇÏ´Ù, Á¸°æ, Á¸Áß(hold in esteem Á¸°æÇÏ´Ù)
ester : n, ¿¡½ºÅ×¸£
Esth, : x, (¼º)Esther, Esthonia
Esther : n, ¿©ÀÚÀÌ¸§, ¿¡½º´õ¼­
esthesia : n, °¨°¢, Áö°¢, °¨¼ö¼º
esthesiophysiology : n, °¨°¢ »ı¸®ÇĞ
esthete : n, =AESTHETE
esthetic : n, =AESTHETICS
Esthonia(n) : n, a, =ESTONIA(N)
estimable : a, Á¸°æÇÒ¸¸ÇÑ, Æò°¡ÇÒ ¼ö ÀÖ´Â, ¾î¸²ÇÒ ¼ö ÀÖ´Â
estimate : vt, vi, n, Æò°¡ÇÏ´Ù, ¾î¸²ÇÏ´Ù, °ßÀû¼­¸¦ ÀÛ¼ºÇÏ´Ù, °³»êÇÏ´Ù, °ßÀûÇÏ´Ù, Æò°¡, °ßÀû¼­, °³»ê, ÆÇ´Ü
estimated : a, °ßÀûÀÇ, ÃßÃøÀÇ
estimation : n, ÆÇ´Ü, ÀÇ°ß, Æò°¡, Á¸Áß, °ßÀû, °³»ê
estimative : a, Æò°¡ÇÒ ¼ö ÀÖ´Â, Æò°¡ÀÇ, °ßÀûÀÇ
estimator : n, Æò°¡ÀÚ, °ßÀûÀÎ
Estonia : n, ¿¡½ºÅä´Ï¾Æ(¹ßÆ®ÇØ¿¡ ¸éÇÑ ¼Òºñ¿¡Æ® ¿¬¹æÀÇ ÇÑ °øÈ­±¹)
Estonian : a, n, ¿¡½ºÅä´Ï¾Æ(»ç¶÷, ¸»)ÀÇ, ¿¡½ºÅä´Ï¾Æ »ç¶÷, ¿¡½ºÅä´Ï¾Æ ¸»
estop : vt, (¹ı)±İ¹İ¾ğÀ¸·Î ±İÁöÇÏ´Ù
estoppage : n, (¹ı)±İ¹İ¾ğ¿¡ ÀÇÇÑ ÀúÁö
estoppel : n, (¹ı)±İ¹İ¾ğ, ¿¡½ºÅäÆç(¸ÕÀú ÇÑ ÁÖÀå¿¡ ¹İ´ëµÇ´Â Áø¼úÀ» µÚ¿¡ ÇÏ´Â °ÍÀ» ±İÁöÇÔ)
estovers : n, (¹ı)ÇÊ¿ä¹°, º°°Å ¼ö´ç
estrade : n, ±³´Ü, ´Ü
estrange : vt, ¼Ò¿øÇÏ°ÔÇÏ´Ù, ¸Ö¸®ÇÏ´Ù
estranged : a, ¼Ò¿øÇØÁø, »çÀÌ°¡ Æ²¾îÁø
estrangement : n, ¼Ò¿ø, ÀÌ°£, ºÒÈ­
estray : n, (¹ı)(ÁÖÀÎÀ» ¾Ë ¼ö ¾ø´Â)±æ ÀÒÀº °¡Ãà(¸», ¾ç µî)
estreat : n, vt, (¿µ¹ı)(¹ú±İ, °í·á ¼±°í µîÀÇ)ÀçÆÇ ±â·ÏÀÇ ºÎº»(ÃÊº»), (¹ú±İ µîÀ»)Â¡¼öÇÏ´Ù
estriol : n, ¿¡½ºÆ®¸®¿Ã(¿©¼ºÈ£¸£¸óÀÇÀÏÁ¾)
estrogen : n, ¹ßÁ¤È£¸£¸ó
estrogenic : a, (»ıÈ­)¹ßÁ¤À» ÃËÁøÇÏ´Â, ¹ßÁ¤¼ºÀÇ
Estron : n, ¿¡½ºÆ®·Ğ(ÃÊ»ê ¼¶À¯¼Ò ¿¡½ºÅ×¸£·Î ¸¸µå´Â ¹İÇÕ¼º ¼¶À¯, »óÇ¥¸í)
estrone : n, ¿¡½ºÆ®·Ğ(¿©¼ºÈ£¸£¸óÀÇ ÀÏÁ¾)
estrous : a, (µ¿)¹ßÁ¤(±â)ÀÇ
estrous cycle : x, (µ¿)¹ßÁ¤±â
estrus : n, ¹ßÁ¤±â(estrus cycle ¼ºÁÖ±â)
estuarine : a, °­¾î±Í(Áö¿ª)ÀÇ, ÇÏ±¸¿¡ Çü¼ºµÈ, ÇÏ±¸(Áö¿ª)¿¡ ¾Ë¸ÂÀº
estuary : n, °­¾î±Í, ³»Æ÷
esurience : n, ±¾ÁÖ¸², °Ô°É, Å½¿å
esurient : a, (°í)°Ô°É½º·¯¿î, Å½¿å½º·¯¿î
ESV : x, experimental safety vehicle ¾ÈÀü ½ÇÇèÂ÷
Et : x, (È­)ethyl
ET : x, Eastern Time, Ester term, extraterrestrial
et : suf, ÁÖ·Î ÇÁ¶û½º¾î°èÀÇ Áö¼Ò ¾î¹Ì
eta : n, ±×¸®½º¾î¾ËÆÄºªÀÇÀÏ°öÂ°±ÛÀÚ
ETA : x, estimated time of arrival µµÂø ¿¹Á¤ ½Ã°¢
et al, : x, dt alibi
eta meson : x, (¹°)¿¡Å¸ Áß°£ÀÚ
etc, : x, =ET CETERA
et cetera : x, and the rest µûÀ§
etceteras : n, ±âÅ¸ ¿©·¯°¡Áö(»ç¶÷), ±âÅ¸ µîµî
etch : vt, vi, ...¿¡ ¿¡ÄªÇÏ´Ù..., À»½Ä°¢ÇÏ´Ù, ½Ä°¢¹ıÀ» ÇàÇÏ´Ù
etcher : n, (¿¡Äª¿¡ ÀÇÇÑ)µ¿ÆÇ È­°ø, ¿¡Äª(µ¿ÆÇ)È­°¡
etching : n, ½Ä°¢¹ı, ¿¡Äª, ºÎ½Ä µ¿ÆÇ
etching needle (point) : x, ¿¡Äª¿ë Á¶°¢Ä§
etch pit : x, (Ãµ)¿¡Ä¡ ÇÇÆ®(È­¼º Ç¥¸é¿¡ º¸ÀÌ´Â Á¶±×¸¶ÇÑ ±¸µ¢ÀÌ)
ETD : x, estimatec time of departure Ãâ¹ß ¿¹Á¤ ½Ã°¢
Eteocles : n, (±×½Å)¿¡Å×¿ÀÅ¬·¹½º
eternal : a, ¿µ¿øÇÑ, ¿µ±¸ÇÑ, ºÒ¸êÀÇ, ³¡¾ø´Â, º¯ÇÔ¾ø´Â, Æò»ó½ÃÀÇ, ¿¹ÀÇ
Eternal City : x, ºÒ¸êÀÇ µµÀ¾(·Î¸¶)
eternalize : vt, =ETERNIZE
eternally : ad, ¿µ¿øÈ÷, ³¡¾øÀÌ, ²÷ÀÓ¾øÀÌ
eternal recurrence : x, (Ã¶)(´ÏÃ¼ Ã¶ÇĞÀÇ)¿µ°Ì È¸±Í
eternal triangle : x, (³²³àÀÇ)»ï°¢ °ü°è
eternity : n, ¿µ¿ø, ¿µ±¸, ³»¼¼
eternity ring : x, ÀÌÅÍ´ÏÆ¼¸µ(º¸¼®À» µ¹¾Æ°¡¸ç Æ´ ¾øÀÌ ¹ÚÀº ¹İÁö, ¿µ¿øÀ» »óÂ¡)
eternization : n, 
eternize : vt, ºÒ¸êÇÏ°ÔÇÏ´Ù, ¿µ¿øÈ÷ ÀüÇÏ´Ù
etesian : a, (ÁöÁßÇØ µ¿ºÎÀÇ ¹Ù¶÷ÀÌ)ÇØ¸¶´ÙÀÇ, °èÀıÀûÀ¸·Î ºÎ´Â
Etesian winds : x, °èÀıÇ³
eth : n, =EDH
eth : suf, µ¿»çÀÇ Á¦3ÀÎÄª
eth, : x, ethical, ethics
Eth, : x, Ethiopia
ethacrynic acid : x, (¾à)¿¡Å¸Å©¸°»ê
ethambutol : n, (¾à)¿¡Å½ºÎÅç(ÇÕ¼º Ç×°áÇÙ¾à)
ethane : n, ¿¡Åº(¼®À¯¿¡¼­³ª´Â°¡½º)
ethanol : n, ¿¡Åº¿Ã(¾ËÄÚ¿ÃÀ» ¸»ÇÔ)
Ethel : n, ¿©ÀÚ ÀÌ¸§
Ethelbert : n, ³²ÀÚ ÀÌ¸§
ethene : n, =ETHYLENE
ethephon : n, ¿¡Å×Æù(½Ä¹° »ıÀå Á¶ÀıÁ¦)
ether : n, ¿¡Å×¸£, Á¤±â, ÇÏ´Ã
ethereal : a, °ø±â¿Í°°Àº, °¡º­¿î, ¿µ±âÀÇ, ¿µ¹¦ÇÑ, Ãµ»óÀÇ, »ó°øÀÇ, ¿¡Å×¸£°°Àº
ethereality : n, ¿¡Å×¸£ °°Àº ¼ºÁú, ¿µ¹¦ÇÑ °Í, ¿µ¼º
etherealization : n, ¿¡Å×¸£È­, ±âÈ­, ¿µÈ­
etherealize : vt, ¿µÈ­ÇÏ´Ù, ¿¡Å×¸£È­ÇÏ´Ù
ethereal oil : x, Á¤À¯, ÈÖ¹ßÀ¯
etherial : a, =ETHEREAL
etherification : n, 
etherify : vt, (¾ËÄÚ¿Ã µîÀ»)¿¡Å×¸£È­ÇÏ´Ù
etherization : n, (ÀÇ)¿¡Å×¸£ ¸¶Ãë(¹ı(»óÅÂ))
etherize : vt, ¿¡Å×¸£¸¶Ãë¸¦½ÃÇàÇÏ´Ù, ¿¡Å×¸£È­ÇÏ´Ù
ethic : a, n, =ETHICAL, =ETHICS
ethical : a, µµ´ö»óÀÇ, À±¸®ÀûÀÎ(ethical drug Ã³¹æ¾à(ÀÇ»çÀÇ Ã³¹æÀü ¾øÀÌ´Â ½ÃÆÇÀ» Çã¿ëÄ¡ ¾Ê´Â ¾àÁ¦)
ethical dative : x, (¹®¹ı)½É¼ºÀû ¿©°İ
ethically : ad, À±¸®(ÇĞ)ÀûÀ¸·Î, (¹®Àå ÀüÃ¼¸¦ ¼ö½ÄÇÏ¿©)À±¸®ÀûÀ¸·Î´Â, À±¸®ÀûÀ¸·Î ¸»ÇÏ¸é
ethicist : n, À±¸®ÇĞÀÚ, µµÇĞÀÚ, µµ´ö°¡
ethicize : vt, À±¸®ÀûÀÌ µÇ°Ô ÇÏ´Ù, ...¿¡ À±¸®¼ºÀ» ºÎ¿©ÇÏ´Ù
ethics : n, À±¸®ÇĞ, µµ´ö
Ethiop : n, a, (°í)=ETHIOPIAN
Ethiopia : n, ¿¡Æ¼¿ÀÇÇ¾Æ
Ethiopian : a, n, (°í´ë)¿¡Æ¼¿ÀÇÇ¾ÆÀÇ, (°í´ë)¿¡Æ¼¿ÀÇÇ¾Æ »ç¶÷ÀÇ, (°í´ë)¿¡Æ¼¿ÀÇÇ¾Æ »ç¶÷
Ethiopic : a, n, (°í´ë)¿¡Æ¼¿ÀÇÇ¾ÆÀÇ, (°í´ë)¿¡Æ¼¿ÀÇÇ¾Æ¸»
ethmoid : n, a, »ç°ñ(ÀÇ)
ethn, : x, ethnology
ethnarch : n, (»ç)(ºñÀÜÆ¾Á¦±¹ µî ÇÑ Áö¹æ(¹ÎÁ·)ÀÇ)ÇàÁ¤ Àå°ü
ethnarchy : n, ethnarchÀÇ ÅëÄ¡(ÁöÀ§, Á÷±Ç)
ethnic : a, ÀÎÁ¾ÀÇ, ¹ÎÁ·ÀÇ, ÀÎÁ¾ÇĞÀÇ, ÀÌ±³ÀÇ(edthnic group ÀÎÁ¾, ¹ÎÁ·)
ethnical : =ETHNIC 1, 2, 
ethnically : ad, ¹ÎÁ·(ÇĞ)ÀûÀ¸·Î, (¹®Àå ÀüÃ¼¸¦ ¼ö½ÄÇÏ¿©)¹ÎÁ·(ÇĞ)ÀûÀ¸·Î´Â(À¸·Î ¸»ÇÏ¸é)
ethnic group : x, (»çÈ¸)ÀÎÁ¾ Áı´Ü
ethnicism : n, ¹ÎÁ·¼º Áß½ÃÁÖÀÇ, ¹ÎÁ· ºĞ¸®ÁÖÀÇ
ethnicon : n, Á¾Á·(ºÎÁ·, ÀÎÁ¾, ¹ÎÁ·, ±¹¹Î)ÀÇ ¸íÄª
ethnic purity : x, (Áö¿ª, Áı´Ü ³»ÀÇ ¼Ò¼ö ¹ÎÁ·ÀÇ)¹ÎÁ·Àû ¼ø¼ö¼º
ethnics : n, =ETHNOLOGY
ethno- : x, (¿¬°áÇü)(ÀÎÁ¾, ¹ÎÁ·)
ethnocentric : a, ÀÚ¹ÎÁ·Áß½ÉÁÖÀÇÀÇ
ethnocentrism : n, (»çÈ¸)ÀÚ±â ¹ÎÁ· Áß½É ÁÖÀÇ
ethnocide : n, (¹®È­Àû µ¿È­ Á¤Ã¥À¸·Î¼­)Æ¯Á¤ ¹ÎÁ· Áı´ÜÀÇ ¹®È­ ÆÄ±«(¸»»ì)
ethnogeny : n, dlÀÎÁ¾ ±â¿øÇĞ, ¹ÎÁ· ¹ß»ıÇĞ
ethnographer : a, ¹ÎÁ·ÁöÀûÀÎ, ¹ÎÁ·ÁöÇĞ»óÀÇ
ethnographic : a, 
ethnography : n, ¹ÎÁ·Áö, (Æ¯È÷ ±â¼úÀû)¹ÎÁ·ÁöÇĞ
ethnol, : x, ethnologic(al), ethnology
ethnolinguistics : n, ¹ÎÁ· ¾ğ¾îÇĞ
ethnologic : a, ¹ÎÁ·ÇĞÀÇ, ÀÎÁ¾ÇĞÀûÀÎ
ethnology : n, ÀÎÁ¾ÇĞ
ethnologyical : a, 
ethnomusicology : n, ¹ÎÁ· À½¾ÇÇĞ, À½¾Ç ÀÎ·ùÇĞ
ethnopsychology : n, ¹ÎÁ· ½É¸®ÇĞ
ethnos : n, =ETHNIC GROUP
ethnoscience : n, ¹ÎÁ· °úÇĞ, ¹ÎÁ·ÁöÇĞ
ethology : n, ÀÎ¼ºÇĞ, µ¿¹°Çàµ¿ÇĞ
ethos : n, (½Ã´ë, ¹ÎÁ·, »çÈ¸, Á¾±³´ÜÃ¼µûÀ§ÀÇ, µ¶Æ¯ÇÑ)±âÇ³, ¹ÎÁ·Á¤½Å, (¿¹¼úÀÛÇ°ÀÇ)±âÇ°
ethyl : n, ¿¡Æ¿
ethyl alcohol : x, ¿¡Æ¿¾ËÄÚ¿Ã, ÁÖÁ¤
ethylate : n, vt, vi, (È­)¿¡Æ¿·¹ÀÌÆ®(¿¡Æ¿¾ËÄÚ¿ÃÀÇ ±İ¼Ó À¯µµÃ¼), ¿¡Æ¿È­ÇÏ´Ù
ethylation : n, (È­)¿¡Æ¿È­
ethylene : n, ¿¡Æ¿·»
ethylene glycol : x, (È­)¿¡Æ¿·» ±Û¸®Äİ(ºÎµ¿¾×À¸·Î ¾²ÀÓ)
etic : a, ¿¡Æ½ÇÑ
etier : n, (F)¿¡Æ®¸®¿¡(µî¹İ¿ë ÂªÀº ÁÙ»ç´Ù¸®)
etiogical : a, ¿øÀÎÀ» ¹àÈ÷´Â, ÀÎ°ú °ü°èÇĞÀÇ, º´ÀÎÇĞÀÇ
etiolate : vt, (½Ä¹° µîÀ»)(ÀÏ±¤À» Â÷´ÜÇÏ¿©)¿¬Çª¸£°Ô ÇÏ´Ù, ´©·¸°Ô ¶ß°Ô ÇÏ´Ù
etiolation : n, (½Ä)(±¤¼± ºÎÁ·¿¡ ÀÇÇÑ)È²È­, (ÇÇºÎ µîÀÌ)Ã¢¹éÇØÁö±â
etiology : n, º´ÀÎÇĞ, ¿øÀÎÇĞ
etiopathogenesis : n, (ÀÇ)¿øÀÎ º´¸®·Ğ
etiquette : n, ¿¡Æ¼ÄÏ, ¿¹ÀÇ, ¿¹¹ı, °ü·Ê(medical etiquette ÀÇ»çµéÀÇ ºÒ¹®À²)
Etna : n, Sicily¼¶ÀÇÈ­»ê, ¾ËÄÚ¿Ã·Î ¹° ²úÀÌ´Â ±â±¸
ETO : x, European Theater of Operations
Eton : n, ·±´ø ¼­ÂÊÀÇ µµ½Ã
Eton blue : x, ¹àÀº Ã»·Ï»ö
Eton collar : x, (¿ô¿ÊÀÇ ±ê¿¡ ´Ù´Â)Æø³ĞÀº Ä®¶ó
Eton College : x, ÀÌÆ°±³
Eton crop : x, (¿©ÀÚ ¸Ó¸®ÀÇ)Ä¡ÄÑ ±ğÀº ´Ü¹ß
Etonian : a, n, EtonÀÇ Eton ±³ ÇĞ»ı)
Eton jacket (coat) : x, ÀÌÆ°±³(½Ä)ÀÇ ÂªÀº ¿ô¿Ê
Etrog : n, ÀÌÆ®·Î±×»ó
Etruria : n, ÀÌÅ»¸®¾Æ ¼­ºÎ¿¡ ÀÖ´ø ¿¾ ³ª¶ó
Etruscan : a, n, EtruriaÀÇ , Etruria »ç¶÷
ETS : x, (¹Ì)Educational Testing Service
ETS : x, (¹Ì±º¼Ó)¸¸±â Á¦´ëÇÏ´Ù
et seq, : x, ...ÀÌÇÏ ÂüÁ¶
et seqq, : x, et sequentes
Etta : n, ¿©ÀÚ ÀÌ¸§
ette : suf, Áö¼Ò¾î¹Ì, ¿©¼ºÇü ¸í»ç ¾î¹Ì, (»ó)(¸ğÁ¶..., ...´ë¿ëÇ°)ÀÇ ¶æ
etude : n, (È¸È­, Á¶°¢µûÀ§ÀÇ)½ÀÀÛ, ¿¬½À°î, ¿¡Æ¢µå
etui, : n, ¹æ¹° »óÀÚ, ¼Õ±×¸©
ETV : x, educational television
ety, : x, etymology
etym, : x, etymological, etymology
etymological : a, ¾î¿øÀÇ, ¾î¿ø(ÇĞ)»óÀÇ
etymologist : n, ¾î¿øÇĞÀÚ, ¾î¿ø ¿¬±¸°¡
etymologize : vt, vi, ...ÀÇ ¾î¿øÀ» Á¶»çÇÏ´Ù, ¾î¿ø(ÇĞ)À» ¿¬±¸ÇÏ´Ù, ¾î¿øÀûÀ¸·Î Á¤ÀÇÇÏ´Ù
etymology : n, ¾î¿øÇĞ
etymon : n, ¾î±Ù, ¸»ÀÇ¿øÇü
Eu : x, (È­)europium
eu- : x, (¿¬°áÇü)(ÁÁÀº...)ÀÇ ¶æ
eucaine : n, (È­)¿ÀÀÌÄ«ÀÎ(±¹ºÎ¸¶ÃëÁ¦)
eucalyptus : n, À¯Ä®¸®³ª¹«(³ôÀÌ 90m, ¿À½ºÆ®·¹ÀÏ¸®´Ù ¿ø»ê)
eucalyptus oil : x, À¯Ä®¸® ±â¸§(ÀÇ¾à, Çâ¼ö¿ë)
eucaryote : n, (»ı)À¯ÇÙ¼¼Æ÷, ÁøÇÙ»ı¹°
Eucharist : n, ¼ºÃ¼¼º»ç, ¼ºÃ¼¿ëÀÇ, »§°ú Æ÷µµÁÖ
Eucharistic : a, ¼º¸¸ÂùÀÇ, ¼ºÃ¼ÀÇ
euchlorine : n, (È­)À¯Å¬·Î¸°(¿°¼Ò¿Í ÀÌ»êÈ­¿°¼ÒÀÇ Æø¹ß¼º È¥ÇÕ±âÃ¼)
euchre : n, vt, À¯Ä¿(Ä«µå³îÀÌÀÇÀÏÁ¾, À¯Ä¿¿¡¼­ Áö°Ô ÇÏ´Ù, Ã¥·«À¸·Î ÀÌ±â´Ù, ¾ÕÁö¸£´Ù
euchromatin : n, (»ı)ÁøÁ¤¿°»öÁú
Euclid : n, ±×¸®½ºÀÇ ¼öÇĞÀÚ, À¯Å¬¸®µå ±âÇÏÇĞ
Euclidean : a, À¯Å¬¸®µåÀÇ, (À¯Å¬¸®µå)±âÇÏÇĞÀÇ
Euclidean geometry : x, À¯Å¬¸®µå ±âÇÏÇĞ
eudaemonia : n, Çàº¹, º¹¸®
eudaemonics : n, Çàº¹·Ğ, =EUDAEMONISM
eudaemonism : n, (Ã¶, À±)Çàº¹ÁÖÀÇ, Çàº¹¼³
eudiometer : n, À¯µğ¿À¹ÌÅÍ(ÁÖ·Î°ø±âÁßÀÇ»ê¼Ò·®À»ÃøÁ¤ÇÔ)
Eugene : n, ³²ÀÚ ÀÌ¸§
eugenic : a, ¿ì»ıÇĞÀûÀÎ
eugenicist : n, ¿ì»ıÇĞÀÚ
eugenics : n, (ÁÁÀº ÅÂ»ıÀÇ)ÀÇ ¶æ¿¡¼­, ¿ì»ıÇĞ, ÀÎÁ¾ °³·®¹ı
euglena : n, (µ¿)À¯±Û·¹³ª, ¿¬µÎ¹ú·¹
euglenoid : a, n, (»ı)À¯±Û·¹³ª ¹«¸®ÀÇ(°¢Á¾ Æí¸ğÃş)
eulogist : n, Âù»ç¸¦ ¿Ã¸®´Â »ç¶÷, Âù¹ÌÀÚ, ¿¹ÂùÀÚ, ÄªÂùÀÚ
eulogistic : a, Âù¹ÌÀÇ, Âù¾çÇÏ´Â, eulogistically, ad
eulogium : n, =EULOGY
eulogize : vt, ÄªÂùÇÏ´Ù
eulogy : n, ÄªÂù, Âù¾ç, Âù»ç
Eumenides : n, (±×½Å)=FURIES
Eunice : n, ¿©ÀÚ ÀÌ¸§
eunuch : n, °Å¼¼µÈ ³²ÀÚ, È¯°ü, ³»½Ã, µ¶½ÅÀÚ
eupepsia : n, ¼ÒÈ­¾çÈ£
eupeptic : a, ¼ÒÈ­¾çÈ£ÀÇ, ¼ÒÈ­¸¦ µ½´Â
euphem, : x, euphemism, duphemistic(ally)
Euphemia : n, ¿©ÀÚ ÀÌ¸§
euphemism : n, ¿Ï°î¾î¹ı
euphemist : n, ¿Ï°îÇÑ ¸»À» (Àß)¾²´Â »ç¶÷
euphemistic : a, ¿Ï°î ¾î¹ıÀÇ, ¿Ï°îÇÑ, euphemistically, ad
euphemize : vt, vi, ¿Ï°îÇÏ°Ô Ç¥ÇöÇÏ´Ù(¸»ÇÏ´Ù, ¾²´Ù)
euphenics : n, ÀÎ°£ °³Á¶ÇĞ
euphobia : n, (ÀÍ»ì)±æº¸(³¶º¸)°øÆ÷Áõ(µÚµû¶ó Èäº¸°¡ ¿Â´Ù°í ÇØ¼­)
euphonic : a, À½ÆíÀÇ, ¹ßÀ½ ÆíÀÇ»óÀÇ=EUPHONIOU
euphonical : a, (°í)=EUPHONIC
euphonious : a, À½Á¶°¡ÁÁÀº, µè±â ÁÁÀº
euphonium : n, À¯Æ÷´½(Æ©¹Ù ºñ½ÁÇÑ ³ò¼è ¾Ç±â)
euphonize : vt, À½Á¶(¾îÁ¶)¸¦ ÁÁ°Ô ÇÏ´Ù
euphony : n, µè±âÁÁÀºÀ½Á¶, ¾îÁ¶°¡ ÁÁÀ½, À½Æí
euphorbia : n, µî´ëÇ®(ÀÇ¹«¸®)
euphoria : n, Çàº¹°¨, °Ç°­, (¸¶¾à¿¡ ÀÇÇÑ)µµÃë°¨
euphoriant : a, n, ´ÙÇàÁßÀÇ, Çàº¹°¨À» ÁÖ´Â, (¾à)µµÃë¾à
euphorigenic : a, Çàº¹°¨(µµÃë°¨)À» ÀÏÀ¸Å°´Â
euphory : n, =EUPHORIA
euphrasy : n, (½Ä)Á¼½ÒÇ®
Euphrates : n, MesopotamiaÁö¹æÀÇ°­
Euphrosyne : n, ±â»İÀÇ¿©½Å
euphuism : n, °ú½ÄÃ¼, ¹Ì¹®Ã¼
euphuistic : a, ¹Ì»ç ¿©±¸¸¦ ÁÁ¾ÆÇÏ´Â, °ú½ÄÃ¼ÀÇ, euphuistically, ad
eupn(o)ea : n, (º´¸®)Á¤»ó È£Èí
Eur, : x, Europe, European
Eur- : x, (¿¬°áÇü)(À¯·´ÀÇ, À¯·´°ú...ÀÇ)ÀÇ ¶æ, (À¯·´ ±İÀ¶ ½ÃÀåÀÇ)ÀÇ ¶æ, (À¯·´ °æÁ¦ °øµ¿Ã¼ÀÇ)ÀÇ ¶æ
Eurafrican : a, À¯¶óÇÁ¸®Ä«(È¥Ç÷)ÀÇ
Eurailpass : n, À¯·´Ã¶µµÁÖÀ¯±Ç
Euramerican : a, ±¸¹Ì(°øÅë)ÀÇ
Eurasia : n, À¯¶ó½Ã¾Æ, ±¸¾Æ
Euratom : n, À¯·´ ¿øÀÚ·Â °øµ¿Ã¼, À¯¶óÅè
EURCO : x, European Composite Unit À¯·´ °è»ê ´ÜÀ§
eureka : int, (ÀÍ»ì)¾Ë¾Ò´Ù, µÆ´Ù, ¹Ì±¹ CaliforniaÁÖÀÇ Ç¥¾î
eureka : int, n, ¾Ë¾Ò´Ù!, ¹ß°ßÀÇ ±â»İÀÇ ¼Ò¸®
eurhythmics : n, ¸®µëÃ¼Á¶
Euripides : n, ±×¸®½ºÀÇºñ±Ø½ÃÀÎ
Euro- : x, (¿¬°áÇü)=EUR-
EuroAmerican : a, =EURAMERICAN
Eurobank : n, À¯·Î¹ğÅ©(À¯·Î ½ÃÀå¿¡¼­ °Å·¡ÇÏ´Â À¯·´ÀÇ ±¹Á¦ ÀºÇà)
Eurobond : n, À¯·ÎÃ¤
Eurocentric : a, À¯·´(ÀÎ)Áß½ÉÀÇ
Eurocheque : n, (¿µ)À¯·ÎÃ¼Å©(À¯·´¿¡¼­ Åë¿ëµÇ´Â Å©·¹µğÆ® Ä«µå)
Euroclear : n, À¯·´ ½ÃÀåÀÇ ¾îÀ½ ±³È¯¼Ò
Eurocommunism : n, À¯·ÎÄÚ¹Â´ÏÁò(¼­À¯·´ °ø»ê´çÀÇ ÀÚÁÖ, ÀÚÀ¯, ¹ÎÁÖ ³ë¼±)
Eurocracy : n, (ÁıÇÕÀû)À¯·´ °øµ¿ ½ÃÀå ÇàÁ¤°ü
Eurocrat : n, À¯·´°øµ¿Ã¼ÀÇÇàÁ¤°ü
Eurocredit : n, À¯·ÎÅ©·¹µğÆ®(À¯·Î¹ğÅ©¿¡ ÀÇÇÑ ´ëÃâ)
Eurocurrency : n, À¯·Î¸Ó´Ï(À¯·´½ÃÀå¿¡¼­ ¾²ÀÌ´Â °¢±¹ÀÇ ÅëÈ­)
Eurocurrency market : x, À¯·Î¸Ó´Ï ½ÃÀå
Eurodollars : n, À¯·Î´Ş·¯(À¯·´¿¡¼­ ±¹Á¦ °áÁ¦¿¡ ¾²ÀÌ´Â US dollar)
Eurogroup : n, À¯·Î±×·ì(ÇÁ¶û½º¿Í ¾ÆÀÌ½½¶õµå¸¦ Á¦¿ÜÇÑ NATO ±¹¹æ Àå°ü ±×·ì)
Euromarket : n, =Aommon Market
Euromoney : n, (°æ)=EUROCURRENCY
Euronet : n, À¯·Î³×Æ®
Europa : n, À¯·ÎÆÄ(PhoeniciaÀÇ¿Õ³à)
Europabus : n, À¯·ÎÆÄ¹ö½º(À¯·´ µµ½Ã°£ÀÇ Àå°Å¸® ¹ö½º)
europe : n, À¯·´(ÁÖ)
european : a, n, À¯·´ÀÇ, À¯·´»ç¶÷(ÀÇ)
european common market : x, À¯·´°øµ¿½ÃÀå
european community : x, À¯·´°øµ¿Ã¼
european defense community : x, À¯·´¹æÀ§°øµ¿Ã¼
european economic community : x, À¯·´°æÁ¦°øµ¿Ã¼
european free trade association : x, À¯·´ÀÚÀ¯¹«¿ª¿¬ÇÕ
Europeanism : n, À¯·´ ÁÖÀÇ, À¯·´ Á¤½Å, (Ç³½À µîÀÇ)À¯·´Ç³, À¯·´ °øµ¿½ÃÀåÁÖÀÇ
Europeanization : n, 
Europeanize : vt, À¯·´Ç³À¸·Î ÇÏ´Ù
European Monetary System : x, À¯·´ ÅëÈ­ Á¦µµ
European Parliament : x, À¯·´ ÀÇÈ¸(EC°¢±¹ ±¹¹ÎÀÌ Á÷Á¢ ¼±ÃâÇÑ ÀÇ¿øÀ¸·Î ±¸¼º)
European plan : x, À¯·´½Ä(È£ÅÚ¿¡¼­ ¹æ°ª°ú ½Ä»ç ´ë±İÀ» µû·Î °ì»êÇÏ´Â °Í)
european political community : x, À¯·´Á¤Ä¡°øµ¿Ã¼
European Recovery Program : x, ¹Ì±¹ ±¹¹«Àå°ü MarshallÁ¦¾ÈÀÇ À¯·´ ºÎÈï °èÈ¹
European roliticsal Community : x, À¯·´ Á¤Ä¡ °øµ¿Ã¼
europium : n, À¯·ÎÇ¾(ÈñÅä·ù¿ø¼Ò)
Europlug : n, (Àü)À¯·ÎÇÃ·¯±×(À¯·´ °¢±¹ÀÇ °¢Á¾ ¼ÒÄÏ¿¡ Åë¿ëµÇ´Â ÇÃ·¯±×)
Europocentric : a, À¯·´(ÀÎ) Áß½É(ÁÖÀÇ)ÀÇ
Europort : n, À¯·ÎÆ÷Æ®(À¯·´ °øµ¿Ã¼ÀÇ ¼öÃâÀÔÇ×)
eurosat : n, À¯·¯»û(À¯·´Åë½ÅÀ§¼ºÈ¸»ç)
eurospace : n, À¯·¯½ºÆäÀÌ½º(À¯·´¿ìÁÖ»ê¾÷¿¬ÇÕÈ¸)
Eurovision : n, À¯·¯ºñÁ¯(¼­À¯·´ ¿ìÁÖ »ê¾÷ ¿¬ÇÕÈ¸)
Eurydice : n, (±×½Å)¿¡¿ì¸®µğÄÉ
eurythmic : a, (À½¾Ç, ¹«¿ëÀÌ)°æÄèÇÑ ¸®µëÀÇ, À²µ¿ÀûÀÎ
eurythmics : n, À²µ¿ Ã¼Á¶
eurythmy : n, À²µ¿ÀûÀÎ ¿îµ¿, Á¶È­µÈ(±ÕÇü ÀâÈù)µ¿ÀÛ
eusol : n, (¾à)(Ç¥¹éºĞ°ú ºØ»êÀ» ¼¯Àº ¿Ü»ó ¼Òµ¶¾×)
Eustace : n, ³²ÀÚ ÀÌ¸§
Eustachian tube : n, À¯½ºÅ¸Å°°ü, ±¸¾¾°ü
eutectic : a, (ÇÕ±İ, ¿ë¾×ÀÌ)³·Àº ¿Âµµ¿¡¼­ À¶ÇØÇÏ´Â, °ø¿ëÀÇ
Euterpe : n, À½¾ÇÀÇ¿©½Å
euthanasia : n, (ºÒÄ¡ÀÇ º´°í·Î ºÎÅÍ ±¸¿øÇÏ´Â)¾È¶ô»ç
euthanize : vt, ¾È¶ô»ç½ÃÅ°´Ù
euthenics : n, È¯°æ¿ì»ıÇĞ, »ıÈ°°³¼±ÇĞ
eutrophic : a, (»ıÅÂ)(È£¼Ò, ÇÏÃµÀÌ)ºÎ¿µ¾çÀÇ
eutrophicate : vi, (»ıÅÂ)(È£¼ö µîÀÌ)ºÎ¿µ¾çÈ­µÇ´Ù, (Ã³¸® Æó¼ö µîÀ¸·Î)¿µ¾ç ¿À¿°µÇ´Ù
eutrophication : n, (È£¼öÀÇ)ºÎ¿µ¾çÈ­, ¿µ¾ç ¿À¿°, ºÎ¿µ¾ç¼ö
eutrophy : n, ¿µ¾ç¾çÈ£, (ÇÏÃµ µîÀÇ)ºÎ¿µ¾ç
eV : x, electron volt(s)
Eva : n, ¿©ÀÚ ÀÌ¸§
EVA : x, extravehicular activity
evac, : x, evacuation
evacuant : a, n, (ÀÇ)¹è¼³À» ÃËÁøÇÏ´Â, ¹è¼³ ÃËÁøÁ¦, ÇÏÁ¦
evacuate : vt, vi, ºñ¿ì´Ù, ¹è¼³ÇÏ´Ù, ¸íµµÇÏ´Ù, Ã¶ÅğÇÏ´Ù, Ã¶º´ÇÏ´Ù, Åğ°Å½ÃÅ°´Ù
evacuation : n, ¸íµµ, ºñ¿ò, ¼Ò°³, ÇÇ³­, ¹è¼³, ¹èÃâ, (±º)Ã¶¼ö
evacuee : n, ÇÇ³­ÀÚ, ¼Ò°³ÀÚ
evade : vt, ~À»¸éÇÏ´Ù, ~À¸·ÎºÎÅÍ ±³¹¦ÇÏ°Ô ºüÁ® ³ª°¡´Ù, µÑ·¯´ë¾î ¸ğ¸éÇÏ´Ù
evaluate : vt, Æò°¡ÇÏ´Ù, ~ÀÇ °ªÀ» ±¸ÇÏ´Ù
evaluation : n, Æò°¡, »çÁ¤, (¼ö)°ªÀ»±¸ÇÔ
evanesce : vi, (Á¡Â÷·Î)»ç¶óÁö´Ù
evanescence : n, (¹®¾î)¼Ò½Ç, µ¡¾øÀ½
evanescent : a, (¹®¾î)(Á¡Á¡)»ç¶óÁ® °¡´Â, ¼ø°£ÀÇ, µ¡¾ø´Â, Áö±ØÈ÷ ¹Ì¹ÌÇÑ, (½Ä)°ğ ½Ãµé¾î ¶³¾îÁö´Â, (¼ö)¹«ÇÑ¼ÒÀÇ
evangel : n, º¹À½, (¼º¼­ÀÇ)º¹À½¼­
evangelic : a, n, º¹À½ÀÇ, ÀüµµÀÇ, º¹À½ÁÖÀÇÀÚ
evangelical : a, n, º¹À½(¼­)ÀÇ, º¹À½ ÀüµµÀÇ, º¹À½ÁÖÀÇÀÇ, =EVANGELISTIC2, º¹À½ÁÖÀÇÀÚ, º¹À½ÆÄÀÇ »ç¶÷
Evangelicalism : n, º¹À½ÁÖÀÇ
Evangeline : n, ¿©ÀÚ ÀÌ¸§
evangelism : n, º¹À½Àüµµ(ÁÖÀÇ)
evangelist : n, º¹À½ÀüµµÀÚ, ½Å¾à º¹À½¼­ÀÇ ÀúÀÚ
evangelistic : a, º¹À½¼­ÀúÀÚÀÇ, º¹À½ ÀüµµÀÚÀÇ
evangelization : n, º¹À½ Àüµµ
evangelize : vt, vi, º¹À½À»ÀüÇÏ´Ù, ÀüµµÇÏ´Ù
evanish : vi, (¹®¾î, ½Ã)¼Ò½Ç(¼Ò¸ê)ÇÏ´Ù
evaporable : a, Áõ¹ßÇÏ±â ½¬¿î
evaporate : vi, vt, Áõ¹ßÇÏ´Ù, ±èÀ» ³»´Ù, »ç¶óÁ® ¾ø¾îÁö´Ù, Áõ¹ß½ÃÅ°´Ù
evaporated milk : x, ¹«°¡´ç ¿¬À¯
evaporating dish (basin) : x, (È­)Áõ¹ß Á¢½Ã
evaporation : n, 
evaporative : a, Áõ¹ßÀÇ, Áõ¹ßÀ» ÀÏÀ¸Å°´Â, Áõ¹ß¿¡ ÀÇÇÑ
evaporator : n, Áõ¹ß
evaporimeter : n, Áõ¹ß°è
evapotranspiration : n, (±â»ó)Áõ¹ß»ê
evasion : n, µµÇÇ, È¸ÇÇ, µÑ·¯´ï
evasive : a, Æ÷ÂøÇÏ±â¾î·Á¿î, È¸ÇÇÀûÀÎ, µÑ·¯´ë(±â ÀßÇÏ)´Â
evasive action : x, (Àü½Ã¿¡ ¼±¹Ú, Ç×°ø±â°¡ ÃëÇÏ´Â)È¸ÇÇ Çàµ¿
evasively : ad, 
evasiveness : n, È¸ÇÇÀûÀÓ, ÆÄ¾ÇÇÏ±â ¾î·Á¿ò, ¾Ö¸ÅÇÔ
Eve : n, ÀÌºê, ÇÏ¿Í(adamÀÇ ¾Æ³», ½ÅÀÌ Ã¢Á¶ÇÑ ¿©ÀÚ)(daughter of eve ¿©ÀÚ¶ó´Â °Í)
eve : n, Àü¾ß(Á¦), ¸íÀıÀÇ Àü³¯ ¹ã, (»ç°ÇµîÀÇ)Á÷Àü, Àú³á, ¹ã
Eve's pudding : x, ¸Ç ¹ØÃşÀÌ °úÀÏ·Î µÇ¾î ÀÖ´Â ½ºÆİÁö ÄÉÀÌÅ©
evection : n, (Ãµ)ÃâÂ÷(ÅÂ¾ç ÀÎ·Â¿¡ ÀÇÇÑ ´Ş ¿îÇàÀÇ ÁÖ±âÀû Â÷ÀÌ)
Evelina : n, ¿©ÀÚ ÀÌ¸§
Eveline : n, ¿©ÀÚ ÀÌ¸§
Evelyn : n, ¿©ÀÚ ÀÌ¸§, ³²ÀÚ ÀÌ¸§
even : a, ad, vt, ÆòÆòÇÑ, ¼öÆòÀÇ, ÇÑ°á°°Àº, ±ÔÄ¢ÀûÀÎ, °øÆòÇÑ, Ä§ÂøÇÑ, ÆòÁ¤ÇÑ
evenement : n, (F)»ç°Ç, (Æ¯È÷)»çÈ¸Àû, Á¤Ä¡Àû ´ë»ç°Ç
evenfall : n, È²È¥
evenhanded : a, °øÆòÇÑ
evening : n, Àú³á, ÇØÁú³á, ¹ã, ¿ÀÈÄ
evening class : x, ¾ß°£ ÇĞ±Ş(¼ö¾÷), ¾ßÇĞ
evening dress : x, ¾ßÈ¸º¹, ÀÌºê´×µå·¹½º
evening glow : x, Àú³á³î
evening gown : x, ¿©¼º¿ë¾ßÈ¸º¹
evening paper : x, ¼®°£
evening party : x, ¾ßÈ¸
Evening Prayer : x, (¿µ±¹ ±¹±³È¸ÀÇ)Àú³á ±âµµ
evening primrose : x, (±İ)´Ş¸ÂÀÌ²É
evenings : ad, ¸ÅÀÏÀú³á
evening school : x, =NIGHT SCHOOL
evening star : x, °³¹ä¹Ù¶ó±â, ±İ¼º, ÅÂ¹é¼º
evenly : ad, °í¸£°Ô, ÆòÅºÇÏ°Ô, ÆòµîÇÏ°Ô, °øÆòÇÏ°Ô
evenminded : a, ¸¶À½ÀÌ Æò¿ÂÇÑ, Â÷ºĞÇÑ
even money : x, ´ëµîÇÏ°Ô ÅÂ¿ì´Â µ·
evenness : n, ¹İ¹İÇÔ, Æòµî, ±Õµî¼º, °øÆò, Ä§Âø
evens : ad, a, n, (¿µ±¸)Æòµî(µ¿µî)ÇÏ°Ô(ÇÑ), =EVEN MONEY
evensong : n, (¿µ±¹±¹±³È¸ÀÇ)¸¸µµ
even steven : x, (±¸)´ëµîÇÑ, µ¿Á¡ÀÎ, ºñ±ä
event : n, »ç°Ç, Å« »ç°Ç, °æ°ú, °á°ú, °æ¿ì, Á¾¸ñ, ½ÃÇÕ(at all events ÁÂ¿ì°£, ÇÏ¿©Æ°, in any event ¹«½¼ ÀÏÀÌ ÀÖ¾îµµ, ÇÏ¿©Æ°)
eventempered : a, ¸¶À½ÀÌ ¾ÈÁ¤µÈ, ¿ÂÈ­ÇÑ ¼ºÁúÀÇ, Ä§ÂøÇÑ
eventful : a, »ç°Ç(ÆÄ¶õ)¸¹Àº, ´Ù»çÇÑ, (»ç°Ç µîÀÌ)Áß´ëÇÑ, eventfully, ad, eventfulness, n
eventide : n, ¶¥°Å¹ÌÁú¶§
eventless : a, »ç°Ç ¾ø´Â, Æò¿ÂÇÑ
eventual : a, Á¾±¹ÀÇ, (°æ¿ì¿¡ µû¶ó¼­´Â)ÀÏ¾î³¯ ¼öµµ ÀÖ´Â, ÀÖÀ» ¼ö ÀÖ´Â
eventuality : n, ¿¹Ãø¸øÇÒ»ç°Ç, ¸¸ÀÏÀÇ °æ¿ì, ¿ì¹ß¼º
eventually : ad, °á±¹Àº, ÇÊ°æ¿¡´Â
eventuate : vi, °á±¹~ÀÌµÇ´Ù, ÀÏ¾î³ª´Ù, »ı±â´Ù
ever : ad, ¾ğÁ¨°¡, ÀÏÂî±â, ¾ğÁ¦³ª, µµ´ëÃ¼, Àû¾îµµ(than erer Áö±İ ±îÁöº¸´Ù Á¡Á¡ ´õ, ever and anon, erer since ±× ÈÄ ÁÙ°ğ)
Everard : n, ³²ÀÚ ÀÌ¸§
Everest : n, MountÈ÷¸»¶ó¾ß »ê¸Æ ÁßÀÇ ¼¼°è ÃÖ°íºÀ
Everest mount : x, È÷¸»¶ó¾ß»ê¸ÆÁßÀÇ¼¼°èÃÖ°íºÀ
Everett : n, ³²ÀÚ ÀÌ¸§
everglade : n, ½ÀÁö´ë(the Everglades, Florida ³²ºÎÀÇ ¼ÒÅÃÁö)
Everglade State : x, ¹Ì±¹ FloridaÁÖÀÇ ¼ÓÄª
evergreen : a, n, »ó·ÏÀÇ, »ó·Ï¼ö(Evergeen State ¹Ì±¹ WashingtonÁÖÀÇ ¼ÓÄª), ¿µ¿ø, ¿µ°ã(eternity)
Evergreen State : x, ¹Ì±¹ WashingtonÁÖÀÇ ¼ÓÄª
everlasting : a, n, ¿µ¿øÇÑ, ¿µ±¸ÇÑ, ³¡¾ø´Â, º¯ÇÔ¾ø´Â, Áö·çÇÑ, ¿µ¿ø, ¿µ°Ì
everlasting flower : x, (½Ä)¶±¾¦ ¹«¸®
everlastingly : ad, ¿µ±¸È÷, ³¡¾øÀÌ
evermore : ad, ¾ğÁ¦³ª, Ç×»ó, ¿µ¿øÈ÷, ¿µ±¸È÷(for evermore ¿µ±¸È÷)
everpresent : a, Ç×»ó Á¸ÀçÇÏ´Â
everready : a, n, Ç×»ó ÁØºñµÇ¾î ÀÖ´Â, »óºñ±º
eversible : a, (¹ÛÀ¸·Î)µÚÁıÀ» ¼ö ÀÖ´Â, (±â°ü µîÀ»)¿Ü¹øÇÒ ¼ö ÀÖ´Â
eversion : n, (ÀÇ)(´«²¨Ç® µîÀÇ)¿ÜÀü, ¹ÛÀ¸·Î µÚÁı±â, (±â°üÀÇ)¿Ü¹ø
evert : vt, (´«²¨Ç®µûÀ§¸¦)µÚÁı´Ù, ¿Ü¹ø½ÃÅ°´Ù
evertor : n, ¿ÜÀü±Ù
every : a, ¸ğµç, ÀÏÃ¼ÀÇ, ¾î´À~ÀÌ³ª ´Ù, °¢~¸¶´Ù, ¶§¶§·Î, °¡²û
everybody : pron, ´©±¸³ª, °¢»ç¶÷(¸ğµÎ)
everyday : a, ¸ÅÀÏÀÇ, ÀÏ»óÀÇ(everyday clothes Æò»óº¹)
Everyman : n, º¸Åë»ç¶÷(15¼¼±âÀÇ ¿µ±¹ÀÇ ±Ç¼± Â¡¾Ç±Ø EverymanÀÇ ÁÖÀÎ°ø¿¡¼­)
everyone : pron, everybody
everyplace : ad, (¹Ì)=EVERYWHERE
everything : pron, ¹«¾ùÀÌµçÁö¸ğµÎ, ¸¸»ç, °¡Àå ¼ÒÁßÇÑ °Í
everyway : ad, ¾î´ÀÁ¡À¸·Îº¸¾Æµµ
everywhere : ad, ¾îµğ¿¡³ª, µµÃ³¿¡
Everywoman : n, ÀüÇüÀûÀÎ ¿©¼º, ¿©ÀÚ´Ù¿î ¿©ÀÚ
evg, : x, evening
Evgeni : n, ³²Àå ÀÌ¸§
evict : vt, Åğ°Å½ÃÅ°´Ù, ÂÑ¾Æ³»´Ù, µÇÃ£´Ù
evictee : n, Åğ°Å´çÇÑ »ç¶÷
eviction : n, Åğ°Å
eviction order : x, Åğ°Å ¸í·É
evictor : n, Åğ°Å½ÃÅ°´Â »ç¶÷
evidence : n, vt, Áõ°Å, Áõ¾ğ, Â¡ÈÄ(give evidence of ...ÀÇ ÇüÀûÀ» º¸ÀÌ´Ù, give evidenc Áõ¾ğÇÏ´Ù), Áõ¸íÇÏ´Ù, Áõ¾ğÇÏ´Ù
evident : a, ¸í¹éÇÑ, ¶Ñ·ÇÇÑ
evidential : a, Áõ°Å»óÀÇ, Áõ°Å°¡µÇ´Â
evidentiary : a, =EVIDENTIAL
evidently : ad, ºĞ¸íÈ÷, ¸í¹éÈ÷, º¸¸Å, ¾Æ¹«·¡µµ(...µíÇÏ´Ù)
evil : a, n, ad, ³ª»Û, »ç¾ÇÇÑ, ÇØ·Î¿î, ºÒ¿îÇÑ, ºÒ±æÇÑ, ¾Ç, ¾ÇÇà, ÇØ¾Ç, º´, ³ª»Ú°Ô, »ç¾ÇÇÏ°Ô, ÇØ·Ó°Ô, ºÒÇàÇÏ°Ô
evildisposed : a, ÁúÀÌ³ª»Û
evildoer : n, ¾ÇÀÎ
evildoing : n, ³ª»ÛÁş, ¾ÇÇà
evil eye : x, ¾ÇÀÇ¿¡ Âù ´«ÃÊ¸®
evileyed : a, ¾Ç¸¶ÀÇ ´«À» ÇÑ, µ¶±â ¼­¸° ´«ÀÇ
evillooking : a, ÀÎ»óÀÌ ³ª»Û
evilly : ad, °£¾ÇÇÏ°Ô, À¶¾ÇÇÏ°Ô
evilminded : a, Èæ½ÉÀÌÀÖ´Â, »ç¾ÇÇÑ
evilness : n, ¾Ç, ºÒ¼±, »ç¾Ç
Evil One : x, ¸¶¿Õ
evilstarred : a, ¿î¼ö ³ª»Û, ºÒÇàÇÑ
eviltempered : a, ¸÷½Ã ¾ğÂ¨Àº
evince : vt, (¸í¹éÈ÷)³ªÅ¸³»´Ù
evincive : a, ¸í½ÃÀûÀÎ, Áõ¸íÇÏ´Â
evirate : vt, °Å¼¼ÇÏ´Ù, ¿¬¾àÇÏ°Ô ÇÏ´Ù
eviscerate : vt, Ã¢ÀÚ¸¦²ôÁı¾î³»´Ù, °ñÀÚ¸¦ »©¹ö¸®´Ù
evisceration : n, ³»Àå ÀûÃâ, °ñÀÚ¸¦ »©¹ö¸²
evitable : a, ÇÇÇÒ¼öÀÖ´Â
evocation : n, (°­½Å, ¿µÈ¥ÀÇ)ºÒ·¯³¿, ÃÊÈ¥, (±â¾ï µîÀÇ)È¯±â, (¹ı)(»ó±Ş ¹ı¿øÀ¸·ÎÀÇ)¼Ò±ÇÀÌ¼Û
evocative : a, (...À»)È¯±â½ÃÅ°´Â
evocator : n, EVOKEÇÏ´Â »ç¶÷(°Í), ¿µ¸Å, (¹ß»ı)È¯±â ÀÎÀÚ
evoke : vt, (¿µ, ±â¾ï, °¨Á¤µûÀ§¸¦)ºÒ·¯ÀÏÀ¸Å°´Ù, È¯±âÇÏ´Ù
evolute : a, n, vi, vt, (¼ö)ÃàÆóÇÑ, (¼ö)ÃàÆó¼±, ÁøÈ­(¹ßÀü)ÇÏ´Ù(½ÃÅ°´Ù)
evolution : n, (»ı¹°ÀÇ)ÁøÈ­, (»ç°Ç, ÀÇ·Ğ µûÀ§ÀÇ)Àü°³, ¹ßÀü, (ºû, ¿­ µûÀ§ÀÇ)¹ß»ı, ¹æÃâ, °³¹æ, ¼±È¸
evolutional : a, =EVOLUTIONARY, evolutionally, ad
evolutionary : a, ¹ß´ŞÀÇ, ÁøÈ­ÀÇ, ÁøÈ­ÀûÀÎ
evolutionism : n, ÁøÈ­·Ğ
evolutionistic : a, ÁøÈ­·ĞÀÚÀÇ, ÁøÈ­·ĞÀûÀÎ
evolutive : a, ÁøÈ­ÀÇ(ÇÏ´Â)
evolve : vi, vt, Àü°³ÇÏ´Ù, ÁøÈ­ÇÏ´Ù, ÁøÈ­½ÃÅ°´Ù, ¹ß´ŞÇÏ´Ù, ¹ßÀü½ÃÅ°´Ù, (ºû, ¿­ µûÀ§¸¦)¹ß»ıÇÏ´Ù
EVP : x, executive vice president Àü¹« ÀÌ»ç
EVR : x, electronic video recorder
evulsion : n, »Ì¾Æ³¿, »©³¿
evzone : n, (±×¸®½ºÀÇ)Á¤¿¹ º¸º´
EW : x, electronic warfare, enlisted woman
ewe : n, ¾Ï¾ç
ewenecked : a, ¸ñÀÌ °¡´Ã°í ¾Æ·¡·Î Ã³Áø(¸», °³)
ewer : n, (ÁÖµÕÀÌ°¡³ĞÀº)¹°º´
ewigkeit : n, (G)¿µ¿ø, (ÀÍ»ì)°£µ¥¾øÀÌ, Çã°øÀ¸·Î
ex : prep, ...À¸·ÎºÎÅÍ, º»¼± ÀÎµµ, ...¶§¹®¿¡
ex, g(r), : x, exempli gratia
exacerbate : vt, ¾ÇÈ­½ÃÅ°´Ù, ºĞ°İ½ÃÅ°´Ù
exacerbation : n, °İÈ­, ¾ÇÈ­, ºĞ³ë
exact : a, vt, Á¤È®ÇÑ, ¾ö¹ĞÇÑ, Á¤¹ĞÇÑ, ²Ä²ÄÇÑ, ¾ö°İÇÑ, ±î´Ù·Î¿î, ¾öÇÏ°Ô ¿ä±¸ÇÏ´Ù, °­¿äÇÏ´Ù
exacta : n, (¹Ì)½Ö½Â½Ä(°æ¸¶ÀÇ 1, 2ÂøÀ» µµÂø ¼ø¼­´ë·Î ¸ÂÈ÷´Â ³»±â)
exactable : a, °­¿äÇÒ ¼ö ÀÖ´Â, °­Á¦·Î °ÅµÎ¾îµéÀÏ ¼ö ÀÖ´Â
exacting : a, °­Á¦·Î Â¡¼öÇÏ´Â, °¡È¤ÇÑ, ¾ö°İÇÑ, (ÀÏÀÌ)°íµÈ, Èûµå´Â, ¾²¶ó¸°, exactingly, ad
exaction : n, °­Ã», °­¿ä, °­Á¦ Â¡¼ö, °¡È¤ÇÑ ¿ä±¸, °­Á¦ Â¡¼ö±İ, °¡È¤ÇÑ ¼¼±İ
exactitude : n, Á¤È®, Á¤¹Ğ, ¾ö°İÇÔ, ²Ä²ÄÇÔ
exactly : ad, Á¤È®ÇÏ°Ô, ²À, ¹Ù·Î ±×´ë·Î, Á¶±İµµ Æ²¸²¾øÀÌ, ±×·¸¼Ò, ¹Ù·Î ±×·¸½À´Ï´Ù
exactor : n, °­¿äÇÏ´Â »ç¶÷, (Æ¯È÷)°¡È¤ÇÏ°Ô Â¡¼öÇÏ´Â »ç¶÷
exact science : x, Á¤¹Ğ °úÇĞ(¼öÇĞ, ¹°¸®ÇĞ µûÀ§)
exact science : n, Á¤¹Ğ °úÇĞ(¼öÇĞ, ¹°¸®ÇĞ µî)
exaggerate : vt, °úÀåÇÏ´Ù, ÇãÇ³¶³´Ù
exaggerated : a, °úÀåµÈ, ¶°¹ú¸°, ºñÁ¤»óÀûÀ¸·Î È®ÀåµÈ, exaggeratedly, ad
exaggeration : n, °úÀå, °úÀåÀû Ç¥Çå
exaggerative : a, °úÀåÀûÀÎ, Ä§¼Ò ºÀ´ëÀÇ, exaggeratively, ad
exaggerator : n, °úÀåÇØ¼­ ¸»ÇÏ´Â »ç¶÷, °úÀåÀûÀÎ °Í
exalt : vt, (½ÅºĞ, °üÁ÷, Ç°À§, ¸í¿¹µûÀ§¸¦)³ôÀÌ´Ù, ÀÇ±â ¾ç¾çÇÏ°Ô ¸¸µé´Ù, Ä¡»ì¸®´Ù, (ºû±òÀ»)Â£°Ô ÇÏ´Ù
exaltation : n, ³ôÀÓ, ½ÂÁø
exalted : a, ÁöÀ§(½ÅºĞ)°¡ ³ôÀº, °í±ÍÇÑ, °í¾çµÈ, °í»óÇÑ, ¼ş°íÇÑ, ±â»µ ³¯¶Ù´Â
exam : n, (±¸)½ÃÇè
exam, : x, examination, examined
examinant : n, ½ÃÇè°ü, ½É»ç¿ø, ½É»ç¹Ş´Â »ç¶÷
examination : n, ½ÃÇè, °Ë»ç, Á¶»ç, ½É»ç, ½É¹®, ½É¸®
examination paper : x, ½ÃÇè¿ëÁö, ½ÃÇè¹®Á¦
examinatorial : a, ½ÃÇè°üÀÇ, °í½Ã À§¿øÀÇ, ½É»ç¿øÀÇ
examine : vt, vi, Á¶»çÇÏ´Ù, °Ë»çÇÏ´Ù, °ËÁ¤ÇÏ´Ù, ½É»çÇÏ´Ù, ½ÃÇèÇÏ´Ù, ½É¹®ÇÏ´Ù, ÁøÂûÇÏ´Ù, Á¶»çÇÏ´Ù
examinee : n, ¼öÇèÀÚ
examineinchief : vt, (¹ı)Á÷Á¢ ½É¹®ÇÏ´Ù
examiner : n, ½ÃÇè°ü, °Ë»ç°ü, ½É»ç¿ø, (¹ı)ÁõÀÎ ½É¹®°ü
example : n, ½Ç·Ê, º¸±â, °ßº», Ç¥º», ¸ğ¹ü, º»º¸±â, º»¶§, °æ°è
exanimate : a, Á×Àº È°±â°¡ ¾ø´Â, ³«´ãÇÑ
ex animo : ad, a, (L)Ãæ½ÉÀ¸·ÎºÎÅÍ(ÀÇ), ¼º½É ¼ºÀ¸·Î(ÀÇ)
exanthem : n, (º´¸®)¹ßÁø
exanthemata : n, ¹ßÁø, ÇÇÁø
exarch : n, (ºñÀÜÆ¾ Á¦±¹ÀÇ)ÅÂ¼ö, ÃÑµ¶
exarchate : n, EXARCHÀÇ Á÷(±ÇÇÑ, ÁöÀ§), ±× °üÇÒ±¸
exasperate : vt, °İ³ëÄÉÇÏ´Ù, °¨Á¤À» ÀÚ±ØÇÏ´Ù, ¾ÇÈ­½ÃÅ°´Ù, ´õÇÏ°Ô ÇÏ´Ù
exasperating : a, ºĞÅëÀÌ ÅÍÁö´Â, È­°¡ ³ª´Â
exasperatingly : ad, ºĞÅëÀÌ ÅÍÁö°Ô, È­°¡ ³ª°Ô
exasperation : n, °İºĞ, ºĞ³ë, °İÈ­, ¾ÇÈ­
exc, : x, excellent, except(ed), exception
Exc, : x, Excellency
Excalibur : n, Athur¿ÕÀÇ ¸¶¹ıÀÇ°Ë
excathedra : , ±ÇÀ§¸¦ °¡Áö°íÀÖ´Â, ±ÇÀ§ÀÖ´Â
ex cathedre : x, ±ÇÀ§¸¦°¡Áö°í, ±ÇÀ§ÀÖ´Â
excavate : vt, ÆÄ´Ù, µµ·Á³»´Ù, ¹ß±¼ÇÏ´Ù
excavation : n, ±¼ ÆÄ±â, °³Âø 2±¼, ±¸µ¢ÀÌ, (°í°í)¹ß±¼, ¹ß±¼¹°, À¯Àû
excavator : n, ±¼ÂøÀÚ(±â), (Ä¡°ú¿ë)ÈÄº­³»´Â ±â±¸, ¹ß±¼ÀÚ
exceed : vt, vi, (ÇÑµµ¸¦)³Ñ´Ù, ÃÊ°úÇÏ´Ù, ~º¸´Ù ³´´Ù, ~À» ´É°¡ÇÏ´Ù
exceeding : a, ¾öÃ»³­, ´ë´ÜÇÑ, ±²ÀåÇÑ
exceedingly : ad, ¸Å¿ì, ´ë´ÜÈ÷, ±²ÀåÈ÷, ¾öÃ»³ª°Ô
excel : vt, vi, ´É°¡ÇÏ´Ù, ¶Ù¾î³ª´Ù
excellence : n, ¿ì¼ö, Å¹¿ù, ÀåÁ¡, ¹ÌÁ¡
Excellency : n, Àå°ü, ´ë»çµî¿¡´ëÇÑÁ¸Äª
excellent : a, ¿ì¼öÇÑ, Å¹¿ùÇÑ
excelsior : int, ´õ ÇÑÃş³ôÀÌ!, ¿ÀÁ÷Çâ»ó!
Excelsior State : x, New YorkÁÖÀÇ ¼ÓÄª
excentric : a, =eccentric
except : vt, vt, prep, Á¦¿ÜÇÏ´Ù, ¹İ´ëÇÏ´Ù, ±âÇÇÇÏ´Ù, ~À» Á¦¿ÜÇÏ°í´Â, ~ÀÌ¿Ü¿¡´Â
excepted : a, Á¦¿ÜµÇ¾î, ¿¹¿ÜÀÎ
excepting : prep, ...À» »©°í, ...¸»°í´Â, ...À» Á¦¿ÜÇÏ¸é
exception : ¿¹¿Ü, Á¦¿Ü, ÀÌÀÇtake exception to ...¿¡ ¹İ´ëÇÏ´Ù, with the exception of ...À» Á¦¿ÜÇÏ°í´Â), 
exceptional : a, ¿¹¿ÜÀûÀÎ, Æ¯º°ÇÑ, º¸ÅëÀÌ ¾Æ´Ñ(exception al child(½É½ÅÀå¾Ö·ÎÀÎÇÑ)ºñÁ¤»ó¾Æ)
exceptional child : x, (±³À°)Æ¯¼ö ¾Æµ¿(ºñ¹üÇÏ°Å³ª ½É½Å Àå¾Ö·Î Æ¯¼ö ±³À°ÀÌ ÇÊ¿äÇÑ
exceptionally : ad, ¿¹¿ÜÀûÀ¸·Î, Æ¯º°È÷, À¯³­È÷, ¸Å¿ì
exceptionless : a, ¿¹¿Ü(ÀÌÀÇ)¾ø´Â
exceptive : a, Á¦¿ÜÀÇ, ¿¹¿ÜÀûÀÎ
excerpt : n, vt, ¹ßÃé, ÀÎ¿ë±¸, ÃÊ·Ï, ¹ßÃé ÀÎ¼â¹°, ¹ßÃéÇÏ´Ù, ÀÎ¿ëÇÏ´Ù
excerption : n, ¹ßÃé, ¹ßÃé·Ï
excess : n, °úµµ, °ú´Ù, °úÀ×, ÃÊ°ú, ÃÊ°ú·®, ºÎÀıÁ¦, Áö³ªÄ§, ³­Æø, ÆøÀ½Æø½Ä(excess of imports over exports ¼öÀÔ ÃÊ°ú)
excess baggage : x, Á¦ÇÑ ÃÊ°ú ¼öÇÏ¹°
excess charge : x, ÁÖÂ÷ ½Ã°£ ÃÊ°ú ¿ä±İ
excessdemand inflation : x, ¼ö¿äÀÎÇÃ·¹
excess fare : x, Ã¶µµÀÇ °Å¸® ÃÊ°ú ¿ä±İ, ÃÊ°ú ¿ä±İ
excessive : a, °úµµÇÑ, ±Ø´ÜÀûÀÎ, ÅÍ¹«´Ï¾ø´Â
excess luggage : x, =EXCESS BAGGAGE
excess postage : x, ¿ìÇ¥ ºÎÁ· ¿ä±İ
excessprofits tax : x, ÃÊ°ú ÀÌµæ¼¼
excess reserves : x, (ÀºÇà)ÃÊ°ú ÁØºñ±İ
excess supply : x, (°æ)°ø±Ş ÃÊ°ú(°úÀ×)
exch, : x, exchange, exchequer
exchange : vt, vi, n, ±³È¯ÇÏ´Ù, ÁÖ°í¹Ş´Ù, È¯ÀüÇÏ´Ù, È¯ÀüÇÒ ¼ö ÀÖ´Ù, ±³È¯ÇÏ´Ù, ±³È¯, ÁÖ°í¹ŞÀ½, È¯Àü, ¾îÀ½±³È¯°í, °Å·¡¼Ò, ÀüÈ­ ±³È¯±¹
exchangeability : n, ±³È¯(±³¿ª)ÇÒ ¼ö ÀÖÀ½, ±³È¯ °¡Ä¡
exchangeable : a, ±³È¯(±³¿ª)ÇÒ ¼ö ÀÖ´Â
exchange bank : x, ¿ÜÈ¯ ÀºÇà
exchange control : x, È¯°ü¸®
exchange force : x, (¹°)±³È¯·Â
exchange market : x, ¿ÜÈ¯ ½ÃÀå
exchange order : x, Ç×°øÇ¥ ÀÎÈ¯Áõ(Ç×°ø»ç°¡ ¹ßÇàÇÏ´Â)
exchange parity : x, ¿ÜÈ¯ Æò°¡
exchange professor : x, ±³È¯ ±³¼ö
exchange rate : x, È¯À²
exchange reaction : x, (¹°)±³È¯ ¹İÀÀ
exchange student : x, ±³È¯ÇĞ»ı
exchange ticket : x, »óÇ°±Ç
exchange value : x, (°æ)±³È¯ °¡Ä¡
exchequer : n, ±¹°í, (°³ÀÎÀÇ)Àç¿ø, ¼Òµæ, Àç¹«¼º
exchequer bill : x, Àç¹«¼ºÁõ±Ç
exchequer bond : x, ±¹°íÃ¤±Ç
excisable : a, ¼Òºñ¼¼¸¦ ºÎ°úÇÒ, °ú¼¼ÇÏ¿©¾ß ÇÒ
excisable : a, ÀıÁ¦ÇÒ ¼ö ÀÖ´Â
excise : n, vt, ¹°Ç°¼¼, ¹°Ç°¼¼¸¦ ºÎ°úÇÏ´Ù, ¾öÃ»³ª°Ô ¹Ş´Ù, Ã»±¸ÇÏ´Ù, Àß¶ó³»´Ù
excise laws : x, (¹Ì)ÁÖ·ù Á¦Á¶ ÆÇ¸Å ±ÔÁ¦¹ı, ¼Òºñ¼¼¹ı
exciseman : n, (¿µ)(°£Á¢¼¼)Â¡¼ö¿ø(´ã´ç°ü)
excision : n, Àı´Ü, ÀıÁ¦, »èÁ¦, ÆÄ¹®
excitability : n, °İÇÏ±â ½¬¿î ¼ºÁú, ÈïºĞ¼º
excitable : a, ÈïºĞÇÏ±â½¬¿î
excitant : a, n, ÀÚ±Ø¼ºÀÇ, ÀÚ±Ø¹°, ÈïºĞÁ¦
excitation : n, ÀÚ±Ø, ÈïºĞ
excitative : a, ÀÚ±ØÀûÀÎ
excite : vt, ÀÚ±ØÇÏ´Ù, ÀÚ±ØÇÏ¿© ÀÏÀ¸Å°´Ù, ÈïºĞ½ÃÅ°´Ù, °İ·ÁÇÏ´Ù, ¼³·¹°Ô ÇÏ´Ù, ¼±µ¿ÇÏ´Ù
excited : a, ÈïºĞÇÑ, ¿©±âÇÑ(excited atoms ¿©±â ¿øÀÚ)
excitedly : ad, 
excited state : x, (¹°)¿©±â »óÅÂ
excitement : ad, ÀÚ±Ø, °İ¾Ó, ÈïºĞ, ¹ı¼®, µ¿¿ä, ÀÚ±ØÇÏ´Â °Í
exciter : n, ÀÚ±ØÇÏ´Â »ç¶÷(°Í), (Àü)¿©ÀÚ±â, (ÀÇ)ÀÚ±Ø(ÈïºĞ)Á¦, ¿©Áø±â
exciting : a, ÈïºĞ½ÃÅ°´Â, ÀÚ±ØÀûÀÎ, ¼Õ¿¡ ¶¡À» Áã°Ô ÇÏ´Â, ÇÇ²ú´Â, ¾àµ¿ÇÏ´Â
exciton : n, ¿©±âÀÚ
excitor : n, (»ı¸®)ÀÚ±Ø ½Å°æ
excl, : x, exclamation, excluded, excluding, exclusive(ly)
exclaim : vi, vt, ¿ÜÄ¡´Ù, Å« ¼Ò¸®·Î ¸»ÇÏ´Ù, ºñ³­ÇÏ´Ù
exclam, : x, exclamation, exclamatory
exclamation : n, ¿ÜÄ§, Àı±Ô, °¨Åº, °¨Åº»ç, °¨ÅººÎÈ£
exclamation mark : x, ´À³¦Ç¥, °¨Åº ºÎÈ£(!)
exclamatory : a, Àı±ÔÀÇ, °¨ÅºÀÇ
exclave : n, Å¸±¹ ³»¿¡ °í¸³µÇ¾î ÀÖ´Â ÀÚ±¹ÀÇ ¿µÅä
exclosure : n, ¿ïÅ¸¸®·Î µÑ·¯½Ñ °÷(°¡Ãà µîÀÇ Ä§ÀÔÀ» ¸·À½)
exclude : vt, ¸ô¾Æ³»´Ù, ¹èÃ´ÇÏ´Ù, Á¦¿ÜÇÏ´Ù, Ãß¹æÇÏ´Ù
excluding : prep, ...À» Á¦¿ÜÇÏ°í(ÇÑ)
exclusion : n, ¸ô¾Æ³¿, Á¦¿Ü, ¹èÃ´
exclusionary rule : x, (¹Ì¹ı)(À§¹ı ¼öÁı Áõ°Å)¹èÁ¦ÀÇ ¿øÄ¢
exclusion clause : x, (º¸Çè)Á¦¿Ü Á¶Ç×
exclusive : a, ¹èÅ¸ÀûÀÎ, µ¶Á¡ÀûÀÎ, µ¶Æ¯ÇÑ, À¯ÀÏÀÇ, °í±ŞÀÇ, ÀÏ·ùÀÇ
exclusive distribution : x, µ¶Á¡Àû À¯Åë
exclusive economic zone : x, ¹èÅ¸Àû °æÁ¦¼ö¿ª
exclusive fishing zone : x, ¾î¾÷ Àü°ü ¼ö¿ª
exclusive interview : x, ´Üµ¶ È¸°ß
exclusively : ad, µ¶Á¡ÀûÀ¸·Î, ¿À·ÎÁö
exclusive OR : x, (Àü»ê)¹èÅ¸Àû ³í¸®ÇÕ
exclusivism : n, ¹èÅ¸(¼â±¹, µ¶Á¡)ÁÖÀÇ
exclysionism : n, ¹èÅ¸ÁÖÀÇ
excogitate : vt, ¾ÈÃâÇÏ´Ù
excogitation : n, 
excommunicate : vt, ÆÄ¹®ÇÏ´Ù, Á¦¸íÇÏ´Ù
excommunication : n, (±âµ¶±³)ÆÄ¹®, Á¦¸í, Ãß¹æ
excommunicative : a, ÆÄ¹®ÀÇ
excommunicator : n, ÆÄ¹®½ÃÅ°´Â »ç¶÷, ÆÄ¹® ¼±°íÀÚ
exconvict : n, Àü°úÀÚ
excoriate : vt, ~ÀÇ°¡Á×À»¹ş±â´Ù, ²®ÁúÀ» ±î´Ù, È¤ÆòÇÏ´Ù, ½ÉÇÑ ¿åÀ» ÆÛº×´Ù
excoriation : n, (ÇÇºÎÀÇ)¹ş±è, ¹ş°ÜÁü, Åë·ÄÇÑ ºñ³­
excrement : n, ¹è¼³¹°
excrementitious : a, ¹è¼³¹°ÀÇ, ´ëº¯ÀÇ
excrescence : , ÀÚ¿¬¹ß»ı¹°(¼ÕÅé, ¹ßÅé, ¸Ó¸®ÅĞ µûÀ§), ÀÌ»ó ¹ß»ı¹°(È¤, »ç¸¶±Í µûÀ§), ¹«¿ëÁö¹°
excrescent : a, ±º, °¡¿ÜÀÇ, È¤ °°Àº
excreta : n, ¹è¼³¹°, ´ëº¯
excrete : vt, ¹è¼³ÇÏ´Ù
excretion : n, ¹è¼³¹°
excretive : a, ¹è¼³ÀÇ
excretory : a, n, ¹è¼³ÀÇ, ¹è¼³±â°ü
excruciate : vt, ~À»°í¹®ÇÏ´Ù, ½ÉÇÑ °íÅëÀ» ÁÖ´Ù, ¸÷½Ã ±«·ÓÈ÷´Ù
excruciating : a, °í¹®¹Ş´Â(µíÇÑ), ¸÷½Ã ±«·Î¿î, (±«·Î¿ö)°ßµô ¼ö ¾ø´Â, ¸Í·ÄÇÑ, ´ë´ÜÇÑ, ±ØµµÀÇ, excruciationly, ad
excruciation : n, ÀÚÃ¥°¨, °í¹®, °İ·ÄÇÑ °íÅë, °í¹Î, ±«·Î¿ò
exculpate : vt, ¹«ÁË·ÎÇÏ´Ù, ¹«ÁË¸¦ Áõ¸íÇÏ´Ù(exculpate oneself ÀÚ±âÀÇ ¹«Á¶¸¦ ÀÔÁõÇÏ´Ù)
exculpation : n, ¹«ÁË
exculpatory : a, ¹«ÁË º¯¸íÀÇ, º¯¸íÀÇ, º¯¸íÇÏ´Â
excurrent : a, À¯Ãâ¼ºÀÇ, ½ÉÀå¿¡¼­ Èê·¯ ³ª¿À´Â, (½Ä)¿ÜÁÙ±âÀÇ, (ÀÙ¸Æ µî)¿¬ÃâÇÏ´Â
excurse : vi, ¾Õ±æ·Î »õ´Ù, Àá±ñ ¿©ÇàÇÏ´Ù, ¼ÒÇ³°¡´Ù
excursion : n, ¼ÒÇ³, ¼öÇĞ¿©Çà, ´ÜÃ¼¿©Çà, °ü±¤´Ü, ÀÏÅ», ½À°İ
excursionist : n, 
excursion ticket : x, À¯¶÷Â÷Ç¥
excursion train : x, À¯¶÷ ¿­Â÷
excursive : a, ¹èÈ¸ÇÏ´Â, »ê¸¸ÇÑ, Áö¿±ÀûÀÎ
excursus : n, (Ã¥µÚ¿¡ ºÙÀÎ)¿©Àû, ¿©·Ï, ºÎ¼³
excusable : a, ¿ë¼­ÇÒ¼öÀÖ´Â, º¯¸íÀÌ ¼­´Â
excusatory : a, º¯¸íÀÇ
excuse : º¯¸íÇÏ´Ù, ¿ë¼­ÇÏ´Ù, º¸¾ÆÁÖ´Ù, ¸éÁ¦ÇÏ´Ù(excuse oneself º¯¸íÇÏ´Ù, excuse oneself from »çÅğÇÏ´Ù, ±×¸¸µÎ°í ½Í´Ù°í ¸»ÇÏ´Ù), º¯¸í, »ç°ú, ¹ß»­, ±¸½Ç, ÇÎ°è
excuseme(dance) : x, ³²ÀÇ ÆÄÆ®³Ê¿Í ÃãÃß¾îµµ µÇ´Â ´í½º
excuser : n, ¿ë¼­ÇÏ´Â »ç¶÷, º¯¸íÀÚ
Excutive Mansion : x, ´ëÅë·É(ÁÖÁö»ç) °üÀú
exdirectory : a, (¿µ)ÀüÈ­ ¹øÈ£ºÎ¿¡ ½Ç¸®Áö ¾ÊÀº
ex div, : x, ex dividend
exdividend : x, ¹è´ç¶ô
exeat : n, (L=let him go out)(ÇĞ±â Áß¿¡ ÁÖ´Â)´Ü±â ÈŞ°¡, ¿Ü¹Ú Çã°¡
exec : n, (±¸)°£ºÎ
exec, : x, executive, executor
execrable : a, ¹Ó»ì½º·¯¿î, ±ÍÂúÀº, ¸÷½Ã ½ÈÀº
execrate : vt, ÀúÁÖÇÏ´Ù, ¸÷½Ã ½È¾îÇÏ´Ù, Çø¿ÀÇÏ´Ù
execration : n, ÀúÁÖ, ¸÷½Ã ½È¾îÇÔ, ÁÖ¹®, ÀúÁÖÀÇ ¸», ¸Åµµ, ÀúÁÖ¹ŞÀº »ç¶÷(°Í), ¸÷½Ã ½ÈÀº °Í
execratory : a, ÀúÁÖÀÇ
executable : a, ½ÇÇà(¼öÇà, ÁıÇà)ÇÒ ¼ö ÀÖ´Â
executant : n, ¿¬ÁÖÀÚ, ½ÇÇàÀÚ
execute : ½ÃÇàÇÏ´Ù, ¼öÇàÇÏ´Ù, ½Ç½ÃÇÏ´Ù, (¹Ì¼úÇ°À»)Á¦ÀÛÇÏ´Ù, (°îÀ»)¿¬ÁÖÇÏ´Ù, (À¯¾ğÀ»)ÁıÇàÇÏ´Ù, ¼­¸í ³¯ÀÎÇÏ´Ù, (»çÇüÀ»)ÁıÇàÇÏ´Ù, ¼­¸í ³¯ÀÎÇÏ´Ù, »çÇüÀ» ÁıÇàÇÏ´Ù
executer : n, =executor
execution : n, ½ÇÇà, ¼öÇà, ÀÌÇà, »çÇü ÁıÇà, Ã³Çü, ÀÛ¼º, ¼­¸í ³¯ÀÎ, ¼Ø¾¾, È¿°ú, (¹Ì¼úÇ°ÀÇ)Á¦ÀÛ, ¿¬ÁÖ
Execution Dock : x, (¿µ»ç)ÇØÀû Ã³ÇüÀå(ÅÛ½º °­º¯ WappingºÎ±Ù¿¡ ÀÖ¾úÀ½)
executioner : n, ½ÇÇàÀÚ, »çÇü ÁıÇàÀÎ
executive : a, n, ½ÃÇàÀÇ, ½ÇÇà·ÂÀÌ ÀÖ´Â, ÇàÁ¤»óÀÇ, ÇàÁ¤ºÎ, °£ºÎ, °£»ç, Áö¹èÀÎ, ´ëÅë·É, ÁÖÁö»ç
executive agreement : x, (¹Ì)ÇàÁ¤ ÇùÁ¤
executive clemency : x, (¹Ì)ÇàÁ¤°ü °¨Çü(´ëÅë·É, ÁÖÁö»ç¿¡ ÀÇÇÑ °¨Çü)
executive committee : x, ÁıÇàÀ§¿øÈ¸
executive council : x, (ÃÖ°íÁıÇà±ÇÇÑÀ»°®´Â)ÆòÀÇÈ¸, (Á¤ºÎ ¼ö¹İ ±Ç°í¸¦ À§ÇÑ)ÆòÀÇÈ¸
executive officer : x, ÇàÁ¤°ü
executive order : x, ´ëÅë·É¸í·É, ÇàÁ¤ ¸í·É
executive privilege : x, (¹Ì)(±â¹Ğ º¸À¯¿¡ ´ëÇÑ)ÇàÁ¤ºÎ(´ëÅë·É)Æ¯±Ç
executive secretary : x, »ç¹« ±¹Àå(ÃÑÀå)
executive session : x, (¼ö³úºÎµîÀÇ)ºñ¹ĞÈ¸
executor : n, ÁıÇàÀÎ, Áö¾ğ À¯¾ğ ÁıÇàÀÚ
executorial : a, ÁıÇàÀÎÀÇ
executory : a, ÇàÁ¤»óÀÇ, (¹ı)¹ÌÀÌÇàÀÇ, ¹ÌÈ®Á¤ÀÇ
executrix : n, executorÀÇ ¿©¼ºÇü
exegesis : n, (¼º°æ, °æÀüÀÇ)ÁÖ¼®, ÇØ¼®
exegetics : n, ¼º°æ ÇØ¼®ÇĞ
exemplar : n, ¸ğ¹ü, º»º¸±â, °ßº»
exemplary : a, ¸ğ¹ıÀûÀÎ, ÀüÇüÀûÀÎ, Áö¿¹ÀûÀÎ
exemplary damages : x, =PUNITIVE DAMAGES
exemplification : n, ¿¹Áõ, ¿¹½Ã, ÀÎÁõ µîº¹
exemplify : vt, ¿¹½ÃÇÏ´Ù, ¿¹ÁõÇÏ´Ù, ~ÀÇ ½Ç·Ê°¡ µÇ´Ù, ÀÎÁõ µîº»À» ¸¸µé´Ù
exempli gratia : x, ¿¹¸¦µé¸é
exemplum : n, ¿¹, ¸ğ¹ü, µµ´öÀû(±³ÈÆÀû)ÀÌ¾ß±â
exempt : vt, a, n, ¸éÁ¦ÇÏ´Ù, ¸éÁ¦µÈ(»ç¶÷), ¸éÁ¦ÀÚ
exemption : n, (ÀÇ¹«ÀÇ)¸éÁ¦
exequatur : n, (L=he may perform)(ÁÖÀç±¹ Á¤ºÎ¿¡¼­ Å¸±¹ÀÇ ¿µ»ç µî¿¡°Ô ÁÖ´Â)ÀÎ°¡Àå
exequies : n, Àå·Ê(½Ä)
exercisable : a, Çà»ç(¿î¿ë)ÇÒ ¼ö ÀÖ´Â
exercise : n, vt, vi, ¿îµ¿, Ã¼Á¶, ¿¬½À, ½ÇÃµ, ÇĞ°ú, È°µ¿½ÃÅ°´Ù, Çà»çÇÏ´Ù, ´ÙÇÏ´Ù, ¹ø°Å·Ó°Ô ÇÏ´Ù, ¿¬½ÀÇÏ´Ù
exercise book : x, ¿¬½ÀÀå, ¿¬½À ¹®Á¦Áı
exerciser : n, ¿îµ¿ÀÚ(±â±¸)
exercitation : n, ½Ç½À, ¿¬½À, ¹®Àå(¿¬¼³)ÀÇ ¿¬½À
Exercycle : n, ¿¢¼­»çÀÌÅ¬(Æä´Ş¸¸ ¹â°Ô µÈ ½Ç³» ¿îµ¿ ±â±¸, »óÇ¥¸í)
exergue : n, (¿¾³¯ÀÇ È­Æó, ¸Ş´Ş µŞ¸éÀÇ)µµÇüÀÇ ÇÏºÎ¿Í °¡ÀåÀÚ¸® »çÀÌ(¿¬¿ùÀÏ, Á¦Á¶¼ÒµîÀ» »õ±ä °÷)
exert : vt, (Èû, ´É·ÂÀ»)³»´Ù, È°µ¿½ÃÅ°´Ù, (¿µÇâÀ»)¹ÌÄ¡´Ù, ³¢Ä¡´Ù(exert oneself ³ë·ÂÇÏ´Ù)
exertion : n, ³ë·Â, Áø·Â, ¹ßÀ§
exertive : a, ³ë·ÂÇÏ´Â
exes : n, (±¸)ºñ¿ë
Exeter : n, ¿¢¼¼ÅÍ(À×±Û·£µå ³²¼­ºÎ Devonshire ÁÖÀÇ ÁÖµµ, ´ë¼º´çÀÌ ÀÖÀ½)
exeunt : vi, ÅğÀåÇÏ´Ù
exeunt omnes : n, (L)(±Ø)Àü¿ø ÅğÀå
ex factory : x, °øÀåµµ
exfiltrate : vi, vt, (¹Ì±º)ÀûÁø¿¡¼­ Å»ÃâÇÏ´Ù(½ÃÅ°´Ù)
exfoliate : vi, vt, (¾Ï¼®, ³ª¹« ²®Áú µîÀÌ)¹ş°ÜÁö´Ù, ¹ş°ÜÁ® ¶³¾îÁö´Ù, ¹ş±â´Ù
exfoliation : n, ¹ş°ÜÁü, ¹Ú¶ô¹°
exgausted : a, ´Ù ½á¹ö¸°, ½á¼­ ´Ù ³°Àº, °í°¥µÈ, ÁöÃÄ¹ö¸°
exgausting : a, ½É½ÅÀ» ÇÇ·ÎÄÉ ÇÒ
ex gratia : ad, a, (L=out of grace)È£ÀÇ·Î¼­(ÀÇ)
exhalation : n, ¹ß»ê¹°, È£±â, ³¯¼û, Áõ±â
exhale : vt, vi, (°ø±âµûÀ§¸¦)³»»Õ´Ù, (³¿»õ µûÀ§¸¦)¹ß»êÇÏ´Ù, Áõ¹ßÇÏ´Ù, ¼Ò»êÇÏ´Ù
exhaust : ´Ù½á¹ö¸®´Ù, (±×¸© µûÀ§¸¦)ºñ¿ì´Ù, ¾ø¾Ö´Ù, »ô»ôÀÌ ¿¬±¸ÇÏ´Ù, ³²±è¾øÀÌ ³íÇÏ´Ù, (Ã¼·ÂÀ»)¼Ò¸ğÇÏ´Ù, ÁöÃÄ¹ö¸®°ÔÇÏ´Ù, À¯ÃâÇÏ´Ù, ¹èÃâÇÏ´Ù, ¹èÃâ, ¹è±â
exhaust fan : x, È¯Ç³±â
exhaust fumes : x, ¹è±â°¡½º
exhaust gas : x, ¹è±â °¡½º(Æ¯È÷ ¿£ÁøÀÇ)
exhaustible : a, °í°¥½ÃÅ³ ¼ö ÀÖ´Â, ´ÙÇÒ ¼ö ÀÖ´Â
exhaustion : n, ¼Ò¸ğ, °í°¥, ¹èÃâ, (±Ø½ÉÇÑ)ÇÇ·Î, (¹®Á¦ÀÇ)Ã¶ÀúÇÑ ¿¬±¸
exhaustive : a, ³²±è¾ø´Â, ¿ÏÀüÇÑ, Ã¶ÀúÇÑ
exhaustively : ad, Ã¶ÀúÇÏ°Ô, ³²±è¾øÀÌ, ¼Ó¼ÓµéÀÌ
exhaustless : a, ¹«ÁøÀåÀÇ
exhaust manifold : x, (³»¿¬ ±â°üÀÇ)¹è±â ¸Å´ÏÆúµå
exhaust pipe : x, ¹è±â°ü
exhaust valve : x, ¹è±â°ü
exhauxtibility : n, °í°¥½ÃÅ³ ¼ö ÀÖÀ½, ´ÙÇÒ ¼ö ÀÖ´Â °¡´É¼º
exhbn, : x, exhibition
exhibit : vt, n, Áø¿­ÇÏ´Ù, ÃâÇ°ÇÏ´Ù, °ø°³ÇÏ´Ù, º¸ÀÌ´Ù, ³ªÅ¸³»´Ù, (¹®¼­¸¦)Á¦½ÃÇÏ´Ù, Åõ¾àÇÏ´Ù, Àü½Ã, ÃâÇ°¹°, Áõ°Å¹°
exhibition : n, Àü½Ã, °ø°³, °ú½Ã, ÃâÇ°¹°, Àü¶÷È¸, ¹Ú¶÷È¸, Á¦½Ã, ÀåÇĞ±İ, ½Ã¾à
exhibitionism : n, °ú½Ãº®, ³ëÃâÁõ
exhibitive : a, (...À»)³ªÅ¸³»´Â, Ç¥½ÃÇÏ´Â
exhibitor : n, ÃâÇ°ÀÚ, (¹Ì)¿µÈ­°ü °æ¿µÀÚ
exhibitory : a, Àü½Ã(¿ë)ÀÇ
exhilarant : a, n, ±âºĞÀÌ µé¶ß´Â(°Í °°Àº), ±âºĞÀ» »óÄèÇÏ°Ô ÇÏ´Â °Í, ÈïºĞÁ¦
exhilarate : vt, ±â¿îÀ»ºÏµ¸¿ì´Ù, ¸í¶ûÇÏ°Ô ¸¸µé´Ù
exhilarated : a, ±âºĞÀÌ µé¶á, ¸í¶ûÇÑ
exhilarating : a, À¯ÄèÇÏ°Ô ¸¸µå´Â, À¯ÄèÇÑ
exhilaration : n, À¯ÄèÇÏ°Ô ¸¸µê
exhilarative : a, ±â¿î³ª°Ô ÇÏ´Â, »óÄèÇÏ°Ô ÇÏ´Â
exhort : vt, vi, ¿­½ÉÈ÷±ÇÇÏ´Ù, ±Ç°íÇÏ´Ù, ÈÆ°èÇÏ´Ù
exhortation : n, ±Ç°í, ±Ç°íÀÇ ¸», ÈÆ°è
exhortative : a, ±Ç°í(ÈÆ°è)ÀûÀÎ
exhortatory : a, =EXHORTATIVE
exhumation : n, 
exhume : vt, ¹ß±¼ÇÏ´Ù
exigency : n, ±Ş¹Ú, À§±Ş, ±ä¹Ú(ÇÑ ¶§), ±Ş¹Ú(Àı¹Ú)ÇÑ »çÁ¤, ±Ş¹«
exigent : a, ±ä±ŞÀÇ, ~À» ¿äÇÏ´Â, »ì¾Æ°¡±â Èûµå´Â
exigible : a, °­¿ä(¿ä±¸)ÇÒ ¼ö ÀÖ´Â
exiguity : n, ¹Ì¼Ò, ±Ù¼Ò
exiguous : a, ¹Ì¼ÒÇÑ, ÀÛÀº, ºÎÁ·ÇÑ
exile : n, vt, ¸Á¸í, À¯Çü, ±¹¿ÜÃß¹æ, ¸Á¸íÀÚ, À¯¶ûÀÚ, À¯ÇüÀÚ, Ãß¹æÀÎ, Ãß¹æÇÏ´Ù, À¯Çü¿¡ Ã³ÇÏ´Ù
exilic : a, Ãß¹æÀÇ, (Æ¯È÷)¹Ùºô·Ğ À¯¼öÀÇ
exility : n, ¹Ì¼¼, ¹Ì¹¦
ExIm : x, ExportImport Bank of the United States
Eximbank : n, ¼öÃâÀÔÀºÇà
exist : vt, Á¸ÀçÇÏ´Ù, ½ÇÀçÇÏ´Ù, ½ÇÁ¸ÇÏ´Ù, »ıÁ¸ÇÏ´Ù
existence : n, Á¸Àç, ½ÇÀç, »ıÁ¸, »ıÈ°, ½ÇÀç¹°(bring into existence »ı±â°Ô ÇÏ´Ù, , ´Ù, ¼º¸³½ÃÅ°´Ù)
existent : a, n, ÇöÁ¸ÇÏ´Â, ÇöÇàÀÇ, ¸ñÇÏÀÇ, Á¸ÀçÇÏ´Â °Í(»ç¶÷)
existential : a, Á¸Àç¿¡ °üÇÑ, existentialist ½ÇÁ¸ÁÖÀÇÀÚ(ÀÇ), n
existentialism : n, ½ÇÁ¸ÁÖÀÇ
existing : a, ÇöÁ¸ÇÏ´Â
exit : n, vt, Ãâ±¸, ÅğÃâ±¸, ³ª°¨, Åğ°Å, ÅğÀå, ÅğÀåÇÏ´Ù
exit permit : x, Ãâ±¹ Çã°¡(Áõ)
exit poll : x, ÅõÇ¥¼Ò Ãâ±¸¿¡¼­ÀÇ ¿©·ĞÁ¶»ç(ÅõÇ¥°á°úÀÇ ¿¹»ó µîÀ» À§ÇÑ)
exit tax : x, (¼Ò·Ã)(Ãâ±¹ ÀÌÁÖÀÚÀÇ)Ãâ±¹¼¼
exit visa : x, Ãâ±¹ »çÁõ
ex lib, : x, ex libris
ex libris : n, Àå¼­Ç¥
exlibrist : n, Àå¼­Ç¥ ¼öÁıÀÚ
ex nihilo : x, ¹«¿¡¼­
exo- : x, (¿¬°áÇü)(¹Ù±ù, ¿ÜºÎ)ÀÇ ¶æ
exoatmosphere : n, ¿Ü±â±Ç
exobiology : n, ¿ìÁÖ»ı¹°ÇĞ
exocarp : n, =EPICARP
exocentric : a, ¿Ü½ÉÀûÀÎ
Exocet : n, (F)¿¢Á¶¼¼ ¹Ì»çÀÏ(ÇÁ¶û½ºÁ¦ °ø´ëÇÔ ¹Ì»çÀÏ)
exocrine : a, ¿ÜºĞºñÀÇ(exocrine gland ¿ÜºĞºñ¼±)
exocrinology : n, ¿ÜºĞºñÇĞ
Exod, : x, Exodus
exodontia : n, (Ä¡°ú)¹ßÄ¡¼ú
exodus : n, Ãâ¹ß, Ãâ±¹
exoelectron : n, (¹°)¿¢¼Ò ÀüÀÚ(ÀÀ·ÂÇÏ¿¡¼­ ±İ¼Ó Ç¥¸éÀ¸·ÎºÎÅÍ ¹æÃâµÇ´Â ÀüÀÚ)
ex officio : x, Á÷±Ç¿¡ÀÇÇÑ
ex officio : x, Á÷±Ç¿¡ÀÇÇÑ
exogamous : a, (»çÈ¸)ÀÌÁ· °áÈ¥ÀÇ, (»ı)ÀÌ°è ±³¹èÀÇ
exogamy : n, ÀÌÁ·°áÈ¥
exogen : n, (½Ä)¿Ü»ı ½Ä¹°
exogenous : a, (»ı)¿ÜÀÎ¼ºÀÇ, (½Ä)¿Ü»ıÀÇ, (ÁöÁú)¿Ü¼ºÀÇ
exon : n, (»ıÈ­)¿¢¼Õ(ÁøÇÙ »ı¹°ÀÇ mRNAÀÇ Á¤º¸ ¹è¿­)
exonerate : vt, (ºñ³­µûÀ§·ÎºÎÅÍ)±¸ÇÏ´Ù, (ÇøÀÇ¸¦)¹ş´Ù, Ç®´Ù
exoneration : n, (¿øÁË¿¡¼­)±¸ÇÏ±â, ¸éÁË, (ÀÇ¹«ÀÇ)¸éÁ¦, Ã¥ÀÓÀÇ ÇØÁ¦
exonerative : a, ¸éÁËÀÇ, ÀÇ¹« ¸éÁ¦ÀÇ
exonumia : n, (¸Ş´Ş, ¶óº§ µî)È­Æó ÀÌ¿ÜÀÇ ¼öÁıÇ°
exophthalmos : n, (º´¸®)¾È±¸ µ¹Ãâ(Áõ)
exoplasm : n, =ECTOPLASM
exor, : x, executor
exorbitance : n, ¾öÃ»³², °ú´ë, °úµµ
exorbitant : a, ÅÍ¹«´Ï¾ø´Â, ¾öÃ»³­
exorcise : vt, (¾Ç¸¶¸¦)³»ÂÑ´Ù, ¾×¸·ÀÌÇÏ´Ù
exorcism : n, ¾×¸·ÀÌ(±âµµ, ±Â)
exorcize : vt, =EXORCISE
exordium : n, (³í¹®, °­¿¬ÀÇ)¸Ó¸®¸», ¼­·Ğ
exordiumdial : a, 
exoskeleton : n, ¿Ü°ñ°İ
exosphere : n, ¿Ü±â±Ç
exoteric : a, °ø±³ÀûÀÎ, °ø°³ÀûÀÎ, Åë¼ÓÀûÀÎ, ÀÌÇØÇÒ ¼ö ÀÖ´Â
exothermic : a, ¹ß¿­¼ºÀÇ
exotic : a, ¿Ü±¹ÀÇ, ¿Ü·¡ÀÇ, ÀÌ±¹Ç³ÀÇ, »ö´Ù¸¥, ÈñÇÑÇÑ
exotica : n, ÀÌ±¹Ç³ÀÇ °Í, ÀÌ±¹ Ãë¹ÌÀÇ ÀÛÇ°, º°³­ ½À¼Ó
exotic dancer : x, ½ºÆ®¸®ÆÛ
exoticism : n, ÀÌ±¹ Ãë¹Ì, ÀÌ±¹ Á¤¼­, ¿Ü±¹½Ä ¾î¹ı
exotoxin : n, (»ıÈ­)(±ÕÃ¼)¿Ü µ¶¼Ò
exp, : x, expense(s), expired, exportation, export(ed), exporter, express
expand : vt, vi, ³ĞÈ÷´Ù, ³Ğ¾îÁö´Ù, Æì´Ù, ÆÛÁö´Ù, ÆØÃ¢½ÃÅ°´Ù, È®Àå½ÃÅ°´Ù, ¹ßÀü½ÃÅ°´Ù, Àü°³ÇÏ´Ù
expandable : a, =EXPANSIBLE
expanded : a, È®´ëÇÑ, ÆØÃ¢ÇÑ, (¿µ¹® È°ÀÚ°¡)ÆòÃ¼ÀÎ
expanded cinema : x, =INTERMEDIA
expanded metal : x, ¿¢½ºÆÒµå ¸ŞÅ»(¿¯Àº ±×¹° ¸ğ¾çÀÇ ±İ¼ÓÆÇ, ¸ğ¸£Å¸¸£º® ¿Ü¿ë)
expanded plastic : x, ¹ßÆ÷ ÇÃ¶ó½ºÆ½
expanded tense : x, (¹®¹ı)È®Ãæ ½ÃÁ¦, ÁøÇàÇü
expander : n, È®´ë½ÃÅ°´Â »ç¶÷(ÀåÄ¡), (ÀüÀÚ)½ÅÀå±â
expanding folder : x, ÁÖ¸§Åë ¸ğ¾çÀ¸·Î ÆìÁö´Â ¼­·ùÃ¶
expanding universe : x, (Ãµ)ÆØÃ¢ÇÏ´Â ¿ìÁÖ
expanse : n, ³ĞÀ½, ³ĞÀºÀå¼Ò, È®Àå, ÆØÃ¢
expansible : a, ÆØÃ¢ ÇÒ¼ö ÀÖ´Â
expansile : a, ½ÅÀå(È®´ë)ÀÇ, È®Àå(È®´ë)ÇÒ ¼ö ÀÖ´Â, ÆØÃ¢¼ºÀÇ
expansion : n, È®Àå, È®´ë, ¹ßÀü, ÆØÃ¢
expansionary : a, È®Àå(¹ßÀü, ÆØÃ¢)¼ºÀÇ
expansionism : n, ÆØÃ¢·Ğ, ¿µÅä È®Àå·Ğ
expansive : n, ÆØÃ¢·Â ÀÖ´Â, ±¤ÇÒÇÑ, ¸¶À½ÀÌ ³ĞÀº, °ú´ë¸Á»óÀûÀÎ
expansivility : n, ½ÅÀå·Â(¼º), ÆØÃ¢·Â, ¹ßÀü¼º
ex parte : ad, a, (L)(¹ı)´ç»çÀÚ ÇÑÂÊ¿¡ Ä¡¿ìÃÄ(Ä£), ÀÏ¹æÀûÀ¸·Î(ÀÎ)
expatiate : vi, »ó¼¼È÷¼³¸íÇÏ´Ù, ºÎ¿¬ÇÏ´Ù
expatiation : n, »ó¼¼ÇÑ ¼³¸í, ºÎ¿¬
expatiatory : a, ÀÚ¼¼È÷(ÀåÈ²ÇÏ°Ô)¼³¸íÇÏ´Â
expatriate : n, (±¹¿Ü·Î)Ãß¹æÇÏ´Ù, Ãß¹æÀÚ, ÀÌÁÖÀÚ
expatriation : n, ±¹¿Ü Ãß¹æ, º»±¹ Åğ°Å, (¹ı)±¹Àû ÀÌÅ»
expect : vt, ±â´ëÇÏ´Ù, ¿¹»óÇÏ´Ù, ¿¹±âÇÏ´Ù, ´ç¿¬ÇÑ ÀÏ·Î ¿©±â´Ù, ¹Ù¶ó´Ù, ~¶ó°í »ı°¢ÇÏ´Ù
expectance : n, ¿¹±â, ±â´ë, °¡¸Á
expectant : a, n, ¿¹±âÇÏ´Â, ±â´Ù¸®°í ÀÖ´Â, ÀÓ½ÅÁßÀÎ, ±â´ëÇÏ´Â »ç¶÷, Áö¸ÁÀÚ
expectation : n, ±â´ë, ¿¹±â, ¿¹»ó, °¡¸Á¼º, À¯»ê »ó¼ÓÀÇ °¡¸Á¼º
expectative : a, n, ¹Ù¶ó´Â, ±â´ëÇÏ´Â(´ë»óÀÇ), ±â´ëµÇ´Â °Í
expected value : x, (Åë°è)±â´ë°ª
expectorant : a, n, °¡·¡Á¦°Å¸¦µ½´Â, °Å´ãÁ¦
expectorate : vt, vi, ±âÄ§ÇÏ¿©¹ñ´Ù, °¡·¡¸¦¹ñ´Ù, Ä§À» ¹ñ´Ù
expectoration : n, °¡·¡(Ä§)¹ñÀ½, ¹ñÀº °Í
expedience : n, ÆíÀÇ, ÇüÆí, ¹æÆí, »ç¸®, ÆíÀÇÇÑ°Í
expedient : a, n, ÇüÆíÁÁÀº, ÆíÀÇÇÑ, »óÃ¥ÀÇ, ½ÃÀÇ¸¦ ¾òÀº, ÆíÀÇÁÖÀÇÀÇ, À¯¸®ÇÑ, Á¤·«ÀûÀÎ, °ø¸®ÀûÀÎ, ¼ö´Ü, ¹æÆí, Æí¹ı, ÀÓ±âÀÀº¯ÀÇÁ¶Ã³
expediential : a, ÆòÀÇÁÖÀÇÀûÀÎ, ÆíÀÇ»óÀÇ
expedite : vt, ÃËÁøÇÏ´Ù, ÀçÃËÇÏ´Ù, Àç»¡¸® ÇØÄ¡¿ì´Ù
expedition : n, ¿øÁ¤, Å½Çè´ë, ½Å¼Ó, ±Ş¼Ó
expeditionary : a, ¿øÁ¤ÀÇ
expeditious : a, ½Å¼ÓÇÑ, ³¯½Ú
expel : vt, ÂÑ¾Æ³»´Ù, Ãß¹æÇÏ´Ù, Á¦¸íÇÏ´Ù, ¹æÃâÇÏ´Ù
expellant : a, n, ³»ÂÑ´ÂÈûÀÖ´Â, ±¸Á¦·ÂÀÖ´Â, ±¸Á¦¾à
expellee : n, ±¹¿ÜÃß¹æÀÚ
expend : vt, ¼ÒºñÇÏ´Ù, (½Ã°£, ³ë·ÂÀ»)µéÀÌ´Ù
expendability : n, 
expendable : a, n, ¼ÒºñµÇ´Â, (±º)(º´·Â, ÀÚÀç µîÀÌ)Èñ»ıµÉ ¼ö ÀÖ´Â, ¼Ò¸ğ¼ºÀÇ, ¼Ò¸ğÇ°(ÀÚÀç, º´·Â)
expenditure : n, ÁöÃâ, Ãâºñ, °æºñ
expense : n, ºñ¿ë, ÁöÃâ, ÁöÃâ±İ, ¼Õ½Ç, Èñ»ı
expense account : x, ±³Á¦ºñ, Á¢´ëºñ
expenseaccount : a, ºñ¿ë °èÁ¤ÀÇ, ±³Á¦ºñÀÇ
expensive : a, ºñ½Ñ, »çÄ¡½º·±
experience : n, vt, °æÇè, Ã¼Çè, °æ·Â, °æÇè´ã, °æÇèÇÏ´Ù, °æÇèÀ¸·Î ¾Ë´Ù
experienced : a, °æÇèÀ» °¡Áø, ³ë·ÃÇÑ
experience meeting : x, (±³È¸ÀÇ)½Å¾Ó ÁÂ´ãÈ¸
experience table : x, (»ıº¸)°æÇè »ç¸ÁÇ¥
experiential : a, °æÇè(»ó)ÀÇ, °æÇè¿¡ ÀÇÇÑ, °æÇèÀûÀÎ, experientialism(Ã¶)(ÀÎ½Ä·ĞÀÇ)°æÇèÁÖÀÇ, n
experiment : n, vi, ½ÇÇè, ½ÃÇè, ½ÇÇèÇÏ´Ù
experimental : a, ½ÇÇè¿¡ ÀÇÇÑ, ½ÇÇèÀûÀÎ, ½ÇÇè¿ëÀÇ, °æÇè¿¡ ÀÇÇÑ
experimentalism : n, ½ÇÇèÁÖÀÇ, °æÇèÁÖÀÇ
experimentalist : n, 
experimentalize : vi, ½ÇÇèÀ» ÇÏ´Ù
experimentally : ad, ½ÇÇèÀûÀ¸·Î, ½ÇÇè»ó
experimentation : n, ½ÇÇè, ½ÇÇè¹ı
experiment station : x, (³ó»ç µîÀÇ)½ÃÇèÀå
expert : n, a, ¼÷·ÃÀÚ, ³ë·Ã°¡, Àü¹®°¡, ±â»ç, °¨Á¤ÀÎ, ¼÷´ŞµÈ, ³ë·ÃÇÑ
expertise : n, Àü¹®ÀûÀÇ°ß
expertism : n, Àü¹® ±â¼ú(Áö½Ä)¼÷´Ş
expertize : vi, vt, Àü¹®Àû ÀÇ°ßÀ» ¸»ÇÏ´Ù, Àü¹®Àû ÆÇ´ÜÀ» ³»¸®´Ù
expiable : a, º¸»óÇÒ ¼ö ÀÖ´Â
expiate : vt, (ÁË¸¦)¼ÓÁËÇÏ´Ù
expiation : n, ¼ÓÁË, (ÁË¸¦)¼±Çà µîÀ¸·Î °±À½, º¸»ó
expiator : n, ¼ÓÁËÀÚ
expiatory : a, ¼ÓÁËÀÇ, º¸»óÀÇ
ex pier : x, (»ó)ºÎµÎ ÀÎµµ
expiration : n, Á¾°á, ¸¸·á, ¸¸±â, ³¯¼û, Á×À½
expiratory : a, ³¯¼ûÀÇ
expire : vi, vt, ³¡³ª´Ù, ¸¸±â°¡ µÇ´Ù, ¼ûÀ» ³»½¬´Ù, Á×´Ù, ³»½¬´Ù, »Õ¾î ³»´Ù
expiry : n, Á¾·á, ¸¸±â
explain : vt, vi, n, ¼³¸íÇÏ´Ù, ÇØ¼®ÇÏ´Ù, º¯¸íÇÏ´Ù, ±º´õ´õ±â, µ¡ºÙÀÌ±â, ¿å¼³, Çã»ç
explainable : a, ¼³¸í(ÇØ¼®, ÇØ¸í)ÇÒ ¼ö ÀÖ´Â
explanation : n, ¼³¸í, ÇØ¼®, ÇØ¸í, º¯¸í, ¼³¸íÀÌ µÇ´Â ¸»(»ç½Ç, »çÁ¤), (¼³¸íÀ¸·Î ¹àÇôÁø)¶æ
explanative : a, =EXPLANATORY, explanatively, ad
explanatory : a, ¼³¸íÀûÀÎ, ÇØ¼®»óÀÇ
explant : vt, n, (»ı)(»ıÃ¼ ÀÏºÎ¸¦)¿Ü½ÄÇÏ´Ù, ¿Ü½ÄÆí
expletive : a, n, ´Ü¼øÈ÷ ºÎ°¡ÀûÀÎ, µ¡ºÙÀÌ±âÀÇ, Á¶»ç, Çã»ç, ¹«ÀÇ¹ÌÇÑ °¨Åº»ç
expletive deleted : x, ºñ¼Ó(¿Ü¼³)¾î »èÁ¦
expletory : a, =EXPLETIVE
explicable : a, ¼³¸íÇÒ¼öÀÖ´Â, ³³µæÇÒ ¼ö ÀÖ´Â
explicate : vt, Â÷·Ê·ÎÇ®ÀÌÇÏ´Ù, ¼³¸íÇÏ´Ù
explication : n, ¼³¸í, ÇØ¼³, Àü°³
explicative : a, ¼³¸íÀÌ µÇ´Â, ÇØ¼³ÀûÀÎ
explicatory : a, =EXPLICATIVE
explicit : a, ¸í¹éÇÑ, ¸í¹éÈ÷ ¸»ÇÑ, ³ë°ñÀûÀÎ, ¼û±è¾ø´Â
explicit faith (belief) : x, (±³¸® µîÀ» ÀÌÇØÇÑ ´ÙÀ½ÀÇ)¸í½ÃÀû ½Å¾Ó
explode : vt, vi, Æø¹ß½ÃÅ°´Ù, Å¸ÆÄÇÏ´Ù, ³íÆÄÇÏ´Ù, Æø¹ßÇÏ´Ù, (°¨Á¤ÀÌ)°İ¹ßÇÏ´Ù
exploded : a, Æø¹ß(ÆÄ¿­)ÇÑ, ³íÆÄ(Å¸ÆÄ)µÈ, (¸ğÇü, ±×¸²ÀÌ)±â°è¸¦ ºĞÇØÇÏ¿© ºÎÇ°ÀÇ »óÈ£ °ü°è¸¦ ³ªÅ¸³»´Â
exploder : n, Æø¹ß ÀåÄ¡, ³ú°ü
exploit : vt, °³Ã´ÇÏ´Ù, °³¹ßÇÏ´Ù, Ã¤±¼ÇÏ´Ù, ÀÌ¿ëÇÏ´Ù, ¹Ì³¢»ï´Ù, ÂøÃëÇÏ´Ù
exploitage : n, (ÀÚ¿ø µîÀÇ)ÀÌ¿ë, °³¹ß, ÀÌ±âÀûÀÎ ÀÌ¿ë, ÂøÃë
exploitation : n, (»ê¾ß, »ï¸², ±¤»ê µîÀÇ)°³Ã´, °³¹ß, ÀÌ¿ë, ÀÌ±âÀû ÀÌ¿ë, (³ëµ¿·ÂÀÇ)ÂøÃë
exploitative : a, ÀÚ¿ø °³¹ßÀÇ, ÂøÃëÀûÀÎ, exploitatively, ad
exploitive : a, =EXPLOITATIVE
exploration : n, Å½Çè, Å½±¸
explorative : a, =EXPLORATORY, Ä³±â ÁÁ¾ÆÇÏ´Â
exploratory : a, (½ÇÁö)´ä»çÀÇ, Å½Çè(»ó)ÀÇ, Å½±¸¸¦ À§ÇÑ
explore : vt, vi, Å½ÇèÇÏ´Ù, Å½±¸ÇÏ´Ù
explorer : n, Å½Çè°¡, Å½±¸ÀÚ, (¹Ì±¹ÀÇ)ÀÎ°øÀ§¼ºÀÌ¸§
explosion : n, Æø¹ß, ÆÄ¿­, ±ŞÁõ
explosive : a, n, Æø¹ß¼ºÀÇ, °İÁ¤ÀûÀÎ, ÆÄ¿­À½ÀÇ, Æø¾à, ÆÄ¿­À½
explosive bolt : x, Æø¹ßº¼Æ®(¿ìÁÖ¼±ÀÇºĞ¸®ºÎºĞµî¿¡¾²ÀÓ)
expo : n, ¹Ú¶÷È¸
exponent : n, ´ëÇ¥ÀûÀÎ¹°, ´ëÇ¥¹°, Çü, ¼³¸íÀÚ, ¸èÁö¼ö
exponential : a, Áö¼öÀÇ
export : vt, n, ¼öÃâÇÏ´Ù, ¼öÃâÇ°, ¼öÃâ
exportation : n, ¼öÃâ, ¼öÃâÇ°
exportinport bank : x, ¼öÃâÀÔ ÀºÇà
export reject : x, ¼öÃâ ±âÁØ ºÒÇÕ°İÇ°
expose : vt, (ÀÏ±¤, ºñ, ¹Ù¶÷µûÀ§¿¡)½ı´Ù, ³ëÃâÇÏ´Ù, Æø·ÎÇÏ´Ù, Àû¹ßÇÏ´Ù, Áø¿­ÇÏ´Ù, (¾ÆÀÌ¸¦)Áı¹Û¿¡ ³»¹ö¸®´Ù
expose : n, (F=exposure)(Ãß¹® µîÀÇ)Æø·Î, Àû¹ß
exposed : a, (À§Çè µî¿¡)µå·¯³­, ³ëÃâµÈ, ºñ¹Ù¶÷À» ¸Â´Â, ³ëÃâÇÑ(ÇÊ¸§)
exposition : n, ¼³¸í, ÇØ¼³, Àü¶÷È¸, (¾ÆÀÌÀÇ)À¯±â
expositive : a, =EXPOSITORY
expositor : n, ¼³¸íÀÚ, ÇØ¼³ÀÚ
expository : a, ¼³¸í(ÇØ¼³)ÀûÀÎ
ex post facto : x, ¼Ò±ŞÇÏ´Â
ex post facto : x, »çÈÄÀÇ, ¼Ò±ŞÇÏ´Â
expostulate : vt, °£ÇÏ´Ù
expostulation : n, °£, Ãæ°í
expostulatory : a, Ãæ°íÀÇ
exposure : n, ¹ö·ÁµÒ, (Áı, ¹æÀÇ)Çâ, ³ëÃâ, Æø·Î, Àû¹ß, (¾î¸°¾ÖÀÇ)À¯±â
exposure index : x, ³ë±¤Áö¼ö
exposure meter : x, ³ëÃâ°è
expound : vt, ¼³¸íÇÏ´Ù, »ó¼úÇÏ´Ù
expremier : n, Àü¼ö»ó, ÀüÃÑ¸®
expresident : n, Àü´ëÅë·É
express : Ç¥ÇöÇÏ´Ù, Ç¥½ÃÇÏ´Ù, Áö±ŞÆíÀ¸·Î º¸³»´Ù, ¸í½ÃµÈ, ¸í¹éÇÑ, Á¤È®ÇÑ, Æ¯º°ÇÑ, ±ŞÇàÀÇ, Áö±ŞÆíÀÇ, ¿î¼ÛÆíÀÇ, Æ¯º°È÷, ±ŞÇàÀ¸·Î, ¼Ó´Ş·Î, Áö±ŞÆí, Æ¯º°Æí, ±ŞÇà¿­Â÷, ¿î¼ÛÈ¸»ç
expressage : n, ¼Ó´Ş¿î¼Û¾÷, ±× ¿îÀÓ
express car : x, ±ŞÇà È­¹° Â÷·®
express delivery : x, ¼Ó´ŞÆí
express elevator : x, (¹Ì)±ŞÇà ½Â°­±â
expressible : a, Ç¥ÇöÇÒ ¼ö ÀÖ´Â, Â¥³¾ ¼ö ÀÖ´Â
expression : n, Ç¥Çö, ¸»Åõ, Ç¥Á¤
expressional : a, Ç¥Çö»óÀÇ, Ç¥Á¤ÀÇ
expressionism : n, Ç¥ÇöÁÖÀÇ, Ç¥Çö°ú
expressionistic : a, Ç¥ÇöÁÖÀÇÀûÀÎ
expressionless : a, ¹«Ç¥Á¤ÇÑ
expression mark : x, (¾Ç)³ªÅ¸³¿ ¸», ¹ß»ó±âÈ£
expressive : a, Ç¥ÇöÇÏ´Â, ÀÇ¹Ì ½ÉÀåÇÑ, Ç¥Á¤ÀÌ Ç³ºÎÇÑ, Ç¥ÇöÀÇ
expressivity : n, (»ı)(À¯ÀüÀÚÀÇ)Ç¥Çöµµ, Ç¥Çö ´É·Â, Ç¥ÇöÀÇ Ç³ºÎÇÔ
express letter : x, (¿µ)¼Ó´Ş ÆíÁö
expressly : ad, ¸í¹éÈ÷, Æ¯º°È÷, ÀÏºÎ·¯
expressman : n, ¿î¼Û¾÷ÀÚ, ±ŞÇà Æ®·° ¿îÀü»ç
express rifle : x, ¼Ó»ç ¿±ÃÑ
express train : x, ±ŞÇà ¿­Â÷
expressway : n, °í¼Óµµ·Î
exprobration : n, ºñ³­, Ã¥¸Á
expropriate : vt, (ÅäÁö, Àç»êµûÀ§¸¦)¸ô¼öÇÏ´Ù, »©¾Ñ´Ù
expropriation : n, (ÅäÁö µîÀÇ)¼ö¿ë, Â¡¹ß, ¸ô¼ö
expt, : x, experiment
exptl, : x, experimental
expulsion : n, Ãß¹æ, Á¦¸í
expulsion order : x, ±¹¿Ü Åğ°Å ¸í·É
expulsive : a, ±¸Ãà·ÂÀÌ ÀÖ´Â, ¹èÁ¦¼ºÀÇ
expunction : n, ¸»¼Ò
expunge : vt, Áö¿ì´Ù, ¸»»ìÇÏ´Ù
expungement : n, (¹Ì)(Àü°ú µîÀÇ)±â·Ï »èÁ¦
expuragator : n, (Ã¥ µîÀÇ)»èÁ¦ÀÚ
expurgate : vt, (Ã¥ÀÇºÒ¿ÂÇÑ´ë¸ñÀ»)»èÁ¦ÇÏ´Ù
expurgation : n, (¿Â´çÇÏÁö ¸øÇÑ ºÎºĞÀÇ)»èÁ¦
expurgatorial : a, »èÁ¦(ÀÚ)¿¡ °üÇÑ, »èÁ¦ÇÏ´Â
expurgatory : a, »èÁ¦ÀÇ
expy, : x, expressway
exquisite : a, n, Àı¹¦ÇÑ, ¿ì¹ÌÇÑ, ´õÇÒ³ªÀ§ ¾ø´Â, (Áñ°Å¿òÀÌ)±íÀº, ¿¹¹ÎÇÑ, Á¤±³ÇÑ, (Ãë¹Ì, ÅÂµµÀÇ)¿ì¾ÆÇÑ, ¸ÚÀïÀÌ ³²ÀÚ, Ãë¹Ì°¡±î´Ù·Î¿î»ç¶÷
exr, : x, executor
exrx, : x, executrix
exs, : x, examples, expenses
exsanguinate : vt, ...¿¡°Ô¼­ ÇÇ¸¦ »Ì´Ù, ¹æÇ÷ÇÏ´Ù
exsanguine : a, ÇÍ±â¾ø´Â, ºóÇ÷ÀÇ
exscind : vt, Àß¶ó³»´Ù, ÀıÁ¦ÇÏ´Ù
exsect : vt, ÀıÁ¦ÇÏ´Ù
exsection : n, ÀıÁ¦(¼ú)
exsert : vt, ³»¹Ğ´Ù, µ¹ÃâÄÉÇÏ´Ù
exsertion : n, µ¹Ãâ
exservice : a, (¿µ)(±ºÀÎÀÌ)Åğ¿ªÇÑ, Á¦´ëÇÑ, (¹°ÀÚ°¡)±º¿¡¼­ ºÒÇÏµÈ
exserviceman : n, Åğ¿ª±ºÀÎ
ex ship : x, ¼±ÃøÀÎµµÀÇ
exsiccate : vt, vi, °ÇÁ¶½ÃÅ°´Ù, °ÇÁ¶ÇÏ´Ù
exstipulate : a, (½Ä)Å¹¿±ÀÌ ¾ø´Â
ex store : x, Á¡µÎ ÀÎµµÀÇ
ext, : x, extension, external(ly), extinct, extra, exteract
extant : a, (±â·ÏµûÀ§)ÇöÁ¸ÇÏ´Â
extemporaneity : n, ÀÓ½Ãº¯Åë, Áï¼®
extemporaneous : a, Áï¼®ÀÇ, ÀÓ½Ã(º¯Åë)ÀÇ
extemporarily : ad, Áï¼®¿¡¼­, ÀÓ½Ã º¯ÅëÀ¸·Î
extemporary : a, Áï¼®ÀÇ, ÀÓ½ÃÀÇ
extempore : a, ad, Áï¼®ÀÇ, Áï¼®¿¡¼­, ÁïÈïÀû(À¸·Î)
extemporization : n, Áï¼®¿¡¼­ ¸¸µê, ÁïÈï, ÁïÈïÀû ÀÛÇ°, Áï¼®¿¡¼­ ³ë·¡ ºÎ¸§, Áï¼® ¿¬ÁÖ(µî)
extemporize : vt, vi, Áï¼®¿¡¼­¸¸µé´Ù, Áï¼®¿¡¼­ ¿¬¼³ÇÏ´Ù, ³ë·¡ÇÏ´Ù, ¿¬ÁÖÇÏ´Ù
extencisor : n, ¼Õ°¡¶ô, ¼Õ¸ñ °­È­ ±â±¸, ¾Ç·Â °­È­±â
extend : »¸´Ù, ´ÃÀÌ´Ù, ³ĞÈ÷´Ù, È®ÀåÇÏ´Ù, ¿¬ÀåÇÏ´Ù, º£Ç®´Ù, »¸Ä¡´Ù, (¹åÁÙÀ»)°Ç³ÊÄ¡´Ù, (¼Ó±â¸¦)º¸Åë ±ÛÀÚ·Î ¿Å°Ü ¾²´Ù, Æò°¡ÇÏ´Ù, (ÅäÁö¸¦)¾Ğ·ùÇÏ´Ù
extended : a, »¸Ä£, Àå±â°£¿¡ °ÉÄ£, ±¤¹üÀ§ÇÑ, È®ÀåµÈ, Áõ´ëÇÑ, ÆòÃ¼ÀÎ
extended family : x, (»çÈ¸)È®´ë °¡Á·(±ÙÄ£À» Æ÷ÇÔÇÑ °Í)
extended play : x, EpÆÇ(1ºĞ°£ 45È¸Àü ·¹ÄÚµå)
extender : n, ´ÃÀÌ´Â »ç¶÷(°Í), Áõ·®Á¦, Èñ¼®Á¦, Ã¼Áú ¾È·á, (¿µ)(´ëÇĞ °ø°³ °­ÁÂÀÇ)±³»ç
extendible : a, =EXTENSIBLE
extensibility : n, ½ÅÀå¼º, ¿¬Àå¼º, È®Àå °¡´É¼º
extensible : a, »¬À» ¼ö ÀÖ´Â, ½ÅÀå¼ºÀÇ
extensile : a, ³Ğ¾îÁö´Â, ¿¬ÀåµÇ´Â(µÉ ¼ö ÀÖ´Â)
extensimeter : n, =EXTENSOMETER
extension : n, ½ÅÀå, ¿¬Àå, È®Àå, ÁõÃà, ¿Ü¿¬
extension cord : x, (Àü±â ±â±¸¿ë)¿¬Àå Àü±âÁÙ
extension courses : x, ´ëÇĞ °ø°³ °­ÁÂ
extension ladder : x, ½ÅÃà»ç´Ú´Ù¸®
extension lecture : x, ´ëÇĞ °ø°³ °­ÀÇ
extension table : x, ½ÅÃàÅ×ÀÌºí
extensity : n, ½ÅÀå¼º, ³ĞÀÌ, ¹üÀ§, (½É)°ø°£(¿¬Àå)¼º
extensive : a, ³ĞÀº, ±¤¹üÀ§¿¡ °ÉÄ£, ´ë±Ô¸ğÀÇ, Á¶¹æÀÇ
extensively : ad, ³Î¸®, ±¤¹üÇÏ°Ô
extensometer : n, (±â)½ÅÀå°è(½ÅÃà, ¿Ö°îÀ» ÃøÁ¤ÇÏ´Â)
extensor : n, ½ÅÃà±Ù
extent : n, ³ĞÀÌ, Å©±â, ¹üÀ§, Á¤µµ, ³ĞÀº Àå¼Ò
extenuate : vt, (ÁËµûÀ§¸¦)°æ°¨ÇÏ´Ù
extenuating : a, ÂüÀÛÇÒ ¸¸ÇÑ
extenuation : n, Á¤»ó ÂüÀÛ, (ÁËÀÇ)°æ°¨, ÂüÀÛÇÒ Á¡(»çÁ¤)
extenuatory : a, ÂüÀÛ »çÀ¯°¡ µÇ´Â (»çÁ¤ µî)
exterior : a, n, ¿ÜºÎÀÇ, ¿Ü¸éÀÇ, ¿ÜºÎ, ¿Ü¸é, ¿Ü°ü
exterior angle : x, ¿Ü°¢
exteriority : n, =EXTERNALITY
exteriorize : vt, ¿Ü¸éÈ­ÇÏ´Ù, (ÀÇ)(¼ö¼úÀ» À§ÇØ)(Á¶Á÷À»)¸ö¹ÛÀ¸·Î ³»´Ù
exterminable : a, ±ÙÀıÇÒ ¼ö ÀÖ´Â
exterminate : vt, ±ÙÀıÇÏ´Ù
extermination : n, 
exterminator : n, ±ÙÀıÀÚ, (ÇØÃæ µîÀÇ)±¸Á¦¾à
exterminatory : a, ±ÙÀıÀûÀÎ
extern : n, Åë±ÙÀÚ, ÅëÇĞ»ı, ¿Ü·¡ È¯ÀÚ, Åë±Ù ÀÇ»ç
external : a, n, ¿ÜºÎÀÇ, ¿Ü¸éÀÇ, ¿Ü°èÀÇ, ¿Ü¸éÀûÀÎ, ÇÇ»óÀûÀÎ, ´ë¿ÜÀûÀÎ, ¿ÜºÎ, ¿Ü¸é, ¿Ü°ü
external angle : x, =EXTERIOR ANGLE
externalcombustion : a, (±â)¿Ü¿¬ÀÇ
external fertilization : x, Ã¼¿Ü¼öÁ¤
external galaxy : x, (Ãµ)ÀºÇÏ°èÀÇ ¼º¿î
externality : n, ¿ÜºÎ(¿Ü¸é)Àû ¼ºÁú, ¿Ü°è, ¿ÜÇü, ¿Ü°ü, Çü½ÄÁÖÀÇ
externalization : n, ¿ÜÀû Ç¥Çö, °´°üÈ­, ±¸Ã¼È­
externalize : vt, (³»ÀûÀÎ °ÍÀ»)¿Ü¸éÈ­ÇÏ´Ù, (»ç»ó µîÀ»)±¸Ã¼È­ÇÏ´Ù
external loan : x, ¿ÜÃ¤
externally : ad, ¿ÜºÎÀûÀ¸·Î, ¿ÜºÎ¿¡¼­
external screw : x, (±â)¼ö³ª»ç
exteroceptor : n, (»ı¸®)¿ÜºÎ ¼ö¿ë±â(´«, ±Í, ÄÚ, ÇÇºÎ µî)
exterritorial : a, Ä¡¿Ü¹ı±ÇÀÇ
exterritoriality : n, Ä¡¿Ü ¹ı±Ç
extg, : x, extracting
extinct : a, ²¨Áø, ²÷¾îÁø, »ç¸êÇÑ, ÆóÁöµÈ
extinction : n, ¼ÒÈ­, ÁøÈ­, Èí±¤, Á¾½Ä, »ç¸ê, Àı¸í, (°¡°èÀÇ)´ÜÀı, (¹ı)(±Ç¸® µîÀÇ)¼Ò¸ê
extinctive : a, ¼Ò¸êÀûÀÎ, ¼Ò¸ê¼ºÀÇ
extinguish : vt, ²ô´Ù, (Èñ¸ÁÀ»)ÀÒ°Ô ÇÏ´Ù, ²ª´Ù, Àü¸ê½ÃÅ°´Ù, ¹«»öÇÏ°ÔÇÏ´Ù, (ºÎÃ¤¸¦)»ó°¢ÇÏ´Ù
extinguishable : a, ²ø ¼ö ÀÖ´Â, Àı¸ê½ÃÅ³ ¼ö ÀÖ´Â
extinguishant : n, ¼ÒÈ­¹°(¹°, ¼ÒÈ­Á¦ µî)
extinguisher : n, ¼ÒÈ­±â
extirpate : vt, ±ÙÀıÇÏ´Ù, ¹Ú¸êÇÏ´Ù
extirpation : n, ±ÙÀı, Àı¸ê, (¿Ü°ú)ÀûÃâ¼ú
extirpative : a, ±ÙÀıÇÏ´Â
extoll : vt, °İÂùÇÏ´Ù, ÀıÂùÇÏ´Ù
extort : vt, (¾à¼Ó, µ·À»)°­¿äÇÏ´Ù, °¥ÃëÇÏ´Ù, (¶æÀ»)¾ïÁö·Î °®´ÙºÙÀÌ´Ù
extortion : n, °­Å», (°ü¸®ÀÇ)Àç¹°°­¿äÁË, ºÎ´çÇÑ ¿ä±İ
extortionary : a, °­¿äÀÇ, °­Å»ÀÇ, ÂøÃëÀûÀÎ
extortionate : a, °­¿ä(°­Å»)ÇÏ´Â, ¾öÃ»³­, Æø¸®ÀÇ, extortionately, ad
extortive : a, °­¿äÇÏ´Â, °­Å»ÀûÀÎ
extra : a, ad, n, Æ¯º°ÇÑ, °¡¿ÜÀÇ, °¡¿Ü·Î, Æ¯º°È÷, ÀÓ½ÃÀÇ(·Î), °¡¿Ü¹°°Ç, Æ¯º°ÇÑ ¹°°Ç, °æÇ°
extra- : pref, (...¿ÜÀÇ, ...ÀÇ ¹üÀ§ ¿ÜÀÇ)ÀÇ ¶æ
extraatmospheric : a, ´ë±â±Ç ¹ÛÀÇ
extrabase hit : x, ÀåÅ¸
extrachromosomal : a, (»ı)¿°»öÃ¼¿ÜÀÇ
extracorporeal : a, Ã¼¿ÜÀÇ
extracosmical : a, ¿ìÁÖ ¹ÛÀÇ
extract : vt, n, ²ø¾î³»´Ù, »©¾î³»´Ù, Â¥³»´Ù, ¾Ë¾Æ³»´Ù, (Äè¶ôÀ»)¾ò´Ù, ¹ßÃéÇÏ´Ù, ÃßÃâ¹°, ÀÎ¿ë±¸
extractant : n, (È­)ÃßÃâ¿ë ¿ëÁ¦(¿ë¸Å)
extraction : n, »Ì¾Æ³¿, »©¾î³¿, ÀûÃâ(¹ı), (È­)ÃßÃâ, (¾àµîÀÇ)´Ş¿©³¿, »Ì¾Æ³½ °Í, ¿¢½º, Ç÷Åë, (¼ö)(±Ù)Ç®ÀÌ
extractive : a, n, ¹ßÃéÀûÀÎ, ÃßÃâÇÒ ¼ö ÀÖ´Â, ÃßÃâ¹°, ¿¢½º
extractor : n, ÃßÃâÀÚ, ¹ßÃéÀÚ, ÃßÃâ ÀåÄ¡, »Ì¾Æ³»´Â ±â±¸
extracurricular : a, °ú¿ÜÀÇ
extracurricular activity : x, °ú¿Ü È°µ¿, (¼Ó)ºÎÁ¤(ºÎµµ´ö)ÇàÀ§, ¿Üµµ
extraditable : a, (µµÁÖ¹üÀÌ)ÀÎµµµÇ¾î¾ß ÇÒ, (ÁË°¡)ÀÎµµÃ³ºĞ¿¡ ÇØ´çÇÑ
extradite : vt, (´ç±¹, »ó´ë±¹¿¡µµ¸Á¹üÀÎÀ»)ÀÎµµÇÏ´Ù, ~ÀÇ ÀÎµµ¸¦ ¹Ş´Ù
extradition : n, (¹ı)(¾î¶² ³ª¶ó·Î)¿Ü±¹ ¹üÀÎÀÇ ÀÎµµ, º»±¹ ¼ÛÈ­, (½É)°¨°¢ÀÇ »çÃâ
extra dividend : x, (Áõ±Ç)Æ¯º° ¹è´ç
extrados : n, (°Ç)(¾ÆÄ¡ÀÇ)°ÑµÑ·¹, ¿ÜÈ£¸é
extra dry : x, (Æ÷µµÁÖ µî)°ÅÀÇ ´Ü¸ÀÀÌ ¾ø´Â
extraessential : a, º»Áú ¿ÜÀÇ, ÁÖ¿äÇÏÁö ¾ÊÀº
extragalactic : a, (Ãµ)ÀºÇÏ°è ¹ÛÀÇ
extrajudicial : a, »ç¹ı°üÇÒ ¹ÛÀÇ, »ç¹ı ¼ö¼Ó¿¡ ÀÇÇÏÁö ¾Ê´Â, ÀçÆÇ(»çÇ×)¹ÛÀÇ
extralegal : a, ¹ı·üÀÇÁö¹è¸¦¹ŞÁö¾Ê´Â
extrality : n, (±¸)=EXTERRITORIALITY
extralunar : a, ´Ş ¹ÛÀÇ, ´Ş ¹Û¿¡ ÀÖ´Â
extramarital : a, È¥È¸¼º±³ÀÇ, °£ÅëÀÇ, ºÒ·ûÀÇ
extramundane : a, Áö±¸ÀÌ¿ÜÀÇ, ¹°Áú ¼¼°è ¹ÛÀÇ
extramural : a, ¼º¹ÛÀÇ, ±³¿ÜÀÇ, ´ëÇĞ ¹ÛÀÇ
extraneous : a, ¿ÜºÎ·ÎºÎÅÍÀÇ, ¿Ü·¡ÀÇ, ÁúÀÌ ´Ù¸¥, °ü°è¾ø´Â
extranuclear : a, (¼¼Æ÷, ¿øÀÚÀÇ)ÇÙ ¹ÛÀÇ
extraofficial : a, Á÷±Ç ¿ÜÀÇ, Á÷¹« ¿ÜÀÇ
extraordinaire : a, (F)±ØÈ÷ ÀÌ·ÊÀûÀÎ, ºñ¹üÇÑ, ÃâÁßÇÑ
extraordinarily : ad, ºñ»óÇÏ°Ô, ¾öÃ»³ª°Ô, À¯º°³ª°Ô, ÀÌ·ÊÀûÀ¸·Î
extraordinary : a, º¸ÅëÀÌ¾Æ´Ñ, ºñ¹üÇÑ, ¾öÃ»³­, Æ¯¸íÀÇ
extraordinary ray : x, ÀÌ»ó±¤¼±
extraparochial : a, ±³±¸ ¹ÛÀÇ, ±³±¸ °üÇÒ¿ÜÀÇ
extrapolability : n, (ÀÚ·á¿¡ ÀÇ°ÅÇÑ)ÃßÁ¤ °¡´É¼º
extrapolate : vt, vi, ÃßÁ¤ÇÏ´Ù, ¿Ü»ğÇÏ´Ù, ~À» ÃßÁ¤ÀÇ ±âÃÊ·Î »ï´Ù
extrapolation : n, (Åë°è)¿Ü»ğ¹ı, º¸¿Ü¹ı
extra sec : x, (¼¤ÆäÀÎÀÌ)½Ô»ìÇÑ, ´Ü¸ÀÀÌ °ÅÀÇ ¾ø´Â
extrasensory : a, ÃÊ°¨°¢ÀûÀÎ, ¿µ°¨ÀûÀÎ, ¿µ°¨ÀÇ(extrasensory perception)
extrasolar : a, ÅÂ¾ç°è ¹ÛÀÇ
extra special : x, (±¸)±Ø»óÀÇ
extraterrestrial : a, Áö±¸¹ÛÀÇ, ´ë±â±Ç¿ÜÀÇ
extraterritorial : a, Ä¡¿Ü¹ı±ÇÀÇ
extraterritoriality : n, Ä¡¿Ü¹ı±Ç
extra time : x, (½ºÆ÷Ã÷)(·Î½º Å¸ÀÓÀ» º¸ÃæÇÏ±â À§ÇÑ)¿¬Àå ½Ã°£
extrauterine : a, ÀÚ±Ã¿ÜÀÇ
extravagance : n, ³¶ºñ, ¹æÁ¾, ÅÍ¹«´Ï ¾øÀ½
extravagant : a, ³¶ºñÇÏ´Â, ÅÍ¹«´Ï ¾ø´Â, ¾öÃ»³­
extravaganza : n, (¹®ÇĞ, ¾Ç±ØµîÀÇ)±¤»óÀûÀÛÇ°, ±¤ÅÂ
extravasate : vt, vi, (Ç÷¾×µûÀ§°¡)¸Æ°ü¿¡¼­³ÑÃÄ³ª(°ÔÇÏ)´Ù, ³»ÃâÇ÷ÇÏ´Ù
extravasation : n, (Ç÷¾×, ÀÓÆÄ¾× µîÀÇ)³ÑÃÄ Èå¸§
extravehicular : a, ¿ìÁÖ¼±¹ÛÀÇ(eatravegicular activity ¿ìÁÖ¼±¿Ü ÇÒµ¿)
extravehicular activity : x, (¿ìÁÖÀÎÀÇ)¼±¿Ü È°µ¿
extraversion : n, (½É)=EXTROVERSION
extravert : n, a, =EXTROVERT
extreme : a, n, ±ØµµÀÇ, ±Ø´ÜÀÇ, °ú°İÇÑ, ¸Ç³¡ÀÇ, ÃÖÈÄÀÇ, ±Ø´Ü, ±Øµµ, ¾ç±Ø´Ü, ±Ø´ÜÀûÀÎ ¼ö´Ü
extremely : ad, ±Øµµ·Ï
extremely high frequency : x, (Åë½Å)ÃÊ°íÁÖÆÄ
extreme unction : x, º´ÀÚ¼º»ç
extremism : n, =EXTREMENESS, ±Ø´Ü·Ğ(ÁÖÀÇ), °ú°İÁÖÀÇ
extremist : n, ±Ø´Ü·ĞÀÚ, °ú°İÆÄ
extremity : n, ³¡, ¸»´Ü, ¼±´Ü, ±Ø´Ü, ±ØÇÑ, °ï°æ, ºñ»ó¼ö´Ü, ¼öÁ·
extremum : n, (¼ö)±Ø°ª
extricable : a, ±¸ÃâÇÒ ¼ö ÀÖ´Â
extricate : vt, ±¸ÇØ³»´Ù
extrication : n, ±¸Ãâ, Å»Ãâ, (È­)À¯¸®
extrinsic : a, ¿ÜºÎÀÇ, ¿Ü·¡ÀûÀÎ, ºñº»ÁúÀûÀÎ
extrinsic semiconductor : x, (ÀüÀÚ)¿ÜÀÎ¼º(ºÒ¼ø¹°)¹İµµÃ¼
extro- : pref, (¹Ù±ùÀ¸·Î)ÀÇ ¶æ
extrorse : a, (½Ä)(²É¹äÀÌ)¿ÜÇâÇÏ´Â, extrorsely, ad
extroversion : n, (´«²¨Ç®, ¹æ±¤µîÀÇ)¿ÜÀü, ¿ÜÇâ¼º
extrovert : n, a, ¿ÜÇâ¼ºÀÇ(»ç¶÷)
extroverted : a, =EXTROVERT
extrude : vt, vi, ³»¹Ğ´Ù, ¹Ğ¾î³»´Ù, µ¹ÃâÇÏ´Ù
extrusion : n, ¹Ğ¾î³¿, ³»¹Ò, ±¸Ãà, ¾ĞÃâ ¼ºÇü(ÇÑ Á¦Ç°)
extrusive : a, n, ¹Ğ¾î³»´Â, ³»¹Ì´Â, (ÁöÁú)(È­»ê¿¡¼­)ºĞÃâÇÑ, (ÁöÁú)ºĞÃâ¾Ï
exuberance : n, Ç³ºÎ, ÃæÀÏ, ¹«¼ºÇÔ
exuberant : a, ¹«¼ºÇÑ, Ç³ºÎÇÑ, ¿ø±â¿Õ¼ºÇÑ, (¹®Ã¼ µûÀ§)È­·ÁÇÑ
exuberate : vi, Ç³ºÎÇÏ´Ù, Å½´ĞÇÏ´Ù
exudate : n, »ïÃâ¹°(¾×)
exudation : n, ½º¸ç ³ª¿È, »ïÃâ(ÀÛ¿ë), ¹èÃâ, »ïÃâ¹°(¾×)
exude : vi, vt, ¹è¾î³ª¿À´Ù, ¹è¾î³ª¿À°Ô ÇÏ´Ù, ¹ß»êÇÏ´Ù, ¹ß»ê½ÃÅ°´Ù
exult : vi, ¹«Ã´±â»µÇÏ´Ù
exultant : a, Å©°Ô ±â»µÇÏ´Â, ÀÇ±â ¾ç¾çÇÑ, È¯ÈñÀÇ, ÀÌ°Ü »Ë³»´Â, exultantly, ad
exultation : n, È¯Èñ, ±¤Èñ, ¿­±¤
exulting : a, ¹ÌÄ¥µíÀÌ ±â»µÇÏ´Â, exultingly Å©°Ô ±â»µÇÏ¿©, ad
exurb : n, ÁØ±³¿Ü
exurbanite : n, ÁØ±³¿ÜÁö¿ª°ÅÁÖÀÚ
exurbia : n, (ÁıÇÕÀû)ÁØ±³¿Ü ÁÖÅÃ Áö¿ª
exuviae : n, Çã¹°(¸Å¹Ì, ¹ì µîÀÇ), ÀÜÇØ
exuviate : vi, vt, (Áü½ÂÀÌÇã¹°À»)¹ş´Ù
exuviation : n, Å»ÇÇ
ex voto : x, ºÀ³³¹°
ex voto : x, ºÀ³³¹°, ºÀÇå¹°
exworks : ad, a, (¿µ)°øÀåµµ·Î(ÀÇ)
exx, : x, examples, executrix
Exxon : n, ¿¢¼Õ
eyas : n, »õ »õ³¢, ¸Å »õ³¢
eye : n, vt, ´«, ´«¸Å, ½Ã·Â, ÁÖ¸ñ, ¾È½Ä, º¸´Â´«, °ßÇØ, ´« ¸ğ¾çÀÇ °Í, Å½Á¤, ·¹ÀÌ´õ ¼ö»ó±â, Àß º¸´Ù, ÀÚ¼¼È÷ º¸´Ù
eye appeal : x, »ç¶÷´«À»²ù, ¸Å·Â
eyeappealing : a, (¹Ì±¸)³²ÀÇ ´«À» ²ô´Â, ¸Å·ÂÀûÀÎ
eyeball : n, ´«¾Ë, ¾È±¸
eyeballtoeyeball : a, (±¸, ÀÍ»ì)=FACETOFACE
eye bank : x, ¾È±¸ÀºÇà
eyebar : n, (±â, °Ç)¾ç³¡¿¡ ±¸¸ÛÀÌ ¶Õ¸° °­Ã¶ºÀ
eye bath : x, (¿µ)=EYECUP
eyebeam : n, ´«ºûÀÇ ¹øµæÀÓ, ÀÏº°
eyeblack : n, ¸¶½ºÄ«¶ó
eyebolt : n, (±â)¾ÆÀÌº¼Æ®, °í¸® º¼Æ®
eyebright : n, (½Ä)Á¼½ÒÇ® ¹«¸®
eyebrow : n, ´«½ç
eyebrow pencil : x, ´«½ç ¿¬ÇÊ(È­ÀåÇ°)
eyecatcher : n, ¹ÌÀÎ, »ç¶÷ ´«À» ²ô´Â °Í
eyecatching : a, ´«±æÀ» ²ô´Â
eye chart : x, ½Ã·Â°Ë»çÇ¥
eye contact : x, ½Ã¼±ÀÌ ¸¶ÁÖÄ§
eyecup : n, ¼¼¾ÈÄÅ
eyed : a, (...ÀÇ)´«À» ÇÑ, ´«±¸¸ÛÀÌ ´Ş¸°, ´« ¸ğ¾çÀÇ ¾ó·èÀÌ ÀÖ´Â
eye dialect : x, ½Ã°¢¿Í¾î(¹ßÀ½´ë·Î³¹¸»À»¾´°Í)
eye doctor : x, (±¸)¾È°ú ÀÇ»ç, °Ë¾È»ç
eyedrop : n, ´«¹°
eyedropper : n, Á¡¾È±â
eye drops : x, ¾È¾à
eyefilling : a, (¹Ì±¸)(º¸±â¿¡)±²ÀåÇÑ, ¾Æ¸§´Ù¿î
eyeful : n, ÇÑ²¯º¸°í½ÍÀº°Í, ¹ÌÀÎ
eyeglass : n, ¾È°æ¾Ë, ¾È°æ
eyegrabber : n, (¼Ó)¾ÆÁÖ °­ÇÏ°Ô(Å©°Ô)´«±æÀ» ²ô´Â °Í
eyehole : n, ¾È¿Í, ÀÛÀº±¸¸Û
eyeinthesky : n, °øÁß ÀüÀÚ °¨½Ã ÀåÄ¡(Ç×°ø±â, ÀÎ°ø À§¼º¿¡ ÀåÄ¡ÇÑ °Í)
eyelash : n, ¼Ó´«½ç
eye lens : x, ´ë¾È(Á¢¾È)·»Áî
eyeless : a, ´«¾ø´Â, ±¸¸Û¾ø´Â, ¸Í¸ñÀûÀÎ
eyeless sight : x, ¹«¾È ½Ã°¢, ÃË½Ã°¢(¼Õ°¡¶ô¿¡ ÀÇÇÑ ºû±ò, ¹®ÀÚÀÇ ½Äº° ´É·Â)
eyelet : n, ÀÛÀº±¸¸Û, ²ö ²ç´Â ±¸¸Û, (±¸µÎ, ¼­·ù µûÀ§ÀÇ ²ö ²ç´Â ±¸¸Û¿¡ ´Ş¸°)ÀÛÀº ¼è°í¸®
eyeleteer : n, (²öÀ» ²ê ±¸¸Û ¶Õ´Â)¼Û°÷
eyelevel : n, ´« ³ôÀÌ
eyelid : n, ´«²¨Ç®, ´«µÎµ¢
eye liner : x, ¾ÆÀÌ¶óÀÌ³Ê(¼Ó´«½çÀ»±×¸®´ÂÈ­ÀåÇ°)
eye lotion : x, ¾È¾à, Á¡¾È¾×
eye measure : x, ´«¾î¸², ´«´ëÁß
eyeminded : a, »ç°¢ÇüÀÇ
eyeopener : n, ±ôÂ¦³î¶ö¸¸ÇÑ»ç°Ç, ¾ÆÄ§¼ú
eyepatch : n, ¾È´ë
eyepiece : n, Á¢¾È·»Áî
eyepit : n, =EYE SOCKET
eyepopper : n, (¹Ì±¸)±ôÂ¦³î¶ó°Ô ÇÏ´Â °Í, ±²ÀåÇÑ °Í
eyepopping : a, (´«ÀÌÆ¢¾î³ª¿ÃÁ¤µµ·Î)´ë´ÜÇÑ, ±²ÀåÇÑ, ³î¶ó¿î
eyepopping : a, (´«ÀÌ Æ¢¾î ³ª¿Àµµ·Ï)±ôÂ¦ ³î¶ó°ÔÇÏ´Â, ±²ÀåÇÑ
eyereach : n, ¾È°è
eye rhyme : x, ½Ã°¢¿î
eyeservant : n, ÁÖÀÎ ´« ¾Õ¿¡¼­¸¸ ¾Ë¶û°Å¸®´Â °í¿ëÀÎ
eyeservice : n, ÁÖÀÎ ´« ¾Õ¿¡¼­¸¸ ÀÏÇÔ, ´«ºñÀ½, ´«Ä¡²¯ÀÇ ±Ù¹«
eyeshade : n, º¸¾È¿ëÃ¬
eye shadow : x, ¾ÆÀÌ¼¨µµ
eyeshot : n, ¾È°è
eyesight : n, ½Ã°¢, ½Ã·Â
eye socket : x, ¾È¿Í, ´«±¸¸Û
eyesome : a, (°í)º¸±â¿¡ ¸Å·ÂÀÖ´Â
eyesonly : a, (¹Ì)(±â¹Ğ¹®¼­ µî)¹¬µ¶¸¸ ÇÏ´Â(³¶µ¶, º¹»ç µîÀÌ ¾ö±İµÈ)
eyesore : n, ´«¿¡°Å½½¸®´Â°Í
eye splice : x, (ÇØ)»è¾È(¹åÁÙÀÇ ³¡À» Ç®¾î ÀÕ´ë¾î °í¸® ¸ğ¾çÀ¸·Î ÇÔ)
eyespot : n, °¨±¤±â°ü, ¾ÈÁ¡, ´«¸ğ¾çÀÇ¹İÁ¡
eyestalk : n, (µ¿)´«ÀÚ·ç(»õ¿ì µîÀÇ)
eyestrain : n, ´«ÀÇÇÇ·Î
eyestrings : n, (°í)¾È±Ù
Eyetie : n, ÀÌÅ»¸®¾Æ»ç¶÷
eyetooth : n, °ßÄ¡, ¼Û°÷´Ï
eyewall : n, ÅÂÇ³ ´« ÁÖÀ§ÀÇ ±¸¸§º®
eyewash : n, ¾È¾à, ¼ÓÀÓ, »ç±â
eyewater : n, ¾È¾à, (´«ÀÇ)¼ö¾ç¾×, ´«¹°
eyewear : n, ¾È°æ·ù
eyewink : n, ´«±ôÂ¦ÀÓ, ÀÏ¼ø°£
eyewinker : n, =EYELASH
eyewitness : n, ¸ñ°İÀÚ
eyot : n, (¿µ)=AIT
EYP : x, Electronic Yellow Pages ÀüÀÚ½Ä Á÷¾÷ ÀüÈ­ ¹øÈ£ºÎ
eyre : n, (»ç)¼øÈ¸, ¼øÈ¸ ÀçÆÇ(Á¤)
eyrie : n, =AERIE, AERY
Ez : x, (¼º)Ezra
ezceptionable : a, ºñ³­ÇÒ ¸¸ÇÑ
Ezekiel : n, ¿¡½º°Ö(À¯´ëÀÇ ¿¹¾ğÀÚ)
Ezra : n, ¿¡½º¶ó, À¯´ëÀÇ¿¹¾ğÀÚ
