B : n, 두번째문자, 나음, 나조
B, & W, : x, black and white
B, A, A, : x, British Airports Authority
B, A, Sc : x, Bachelor of Agricultural Science, Bachelor of Applied Science
B, Ag, : x, Bachelor of Agriculture
B, Arch : x, Bachelor of Architecture
B, B : x, BlueBook
B, E, C, : x, Bureau of Employees' Compensation
B, E, M, : n, British Empire Medal(1941년 제정)Bug-Eyed Monster(왕방울 눈의 괴물, 과학 소설에 나오는 공상적인, 생물)
B, I, E, : x, Bachelor of Industrial Engineering
B, I, F, : x, British Industries Fair
B, I, M, : n, British Institute of Management 영국 경영 연구소
B, I, O, T, : x, British Indian Ocean Territory
B, I, P, O, : x, British Institute of Public Opinion
B, I, S, : x, Bank for International Settlement 국제 결제 은행, British Information Services 영국 정보부
B.E.C.S. : x, British Red Cross Society
B.O.A.C. : n, British Overseas Airways Corporation 영국 해외 항공 회사
baa : n, 매애(양의울음소리)
baal : n, (고대Phoenicia 사람의)발신, 주신, 태양신, 우상, 사신
baalamb : n, 매매(새끼양을 이름)
Baalism : n, 숭배(우상), 발신
Baalist : n, 발신숭배자, 우상숭배자
baas : n, 주인, 나으리
Baath : n, 바트당, 아랍의 민족주의 정당
Bab : n, 바바라(Barbara)의 애칭
baba : n, 럼주로 맛낸 건포도 과자
babbitt : n, 독선적인 속물 취미의 실업가
Babbitt : n, 배비트 합금, 주석, 납의 합금
Babbittry : n, 속물적인 실업가 기질, 속물취미
babble : n, vi, ti, 떠듬거리는 말, 허튼소리, 수다, 지껄여 누설하다
babbler : n, 서투르게 지껄이는 어린애, 수다쟁이, 높은 소리로 지저귀는 작은 새
babbling : a, n, 재잘거리는, 졸졸 흐르는, 수다, 졸졸 흐르는 소리
babe : n, =baby천진 난만한 사람, 숫보기
Babel : n, 바벨 탑(옛날 Babylon 에서 하늘까지 닿도록 쌓으려던 탑, 천벌로 인부들이 서로 말이 통하지 않게 되어 완성에 실패
Babelize : vt, (언어, 습관, 민족 등을)혼란에 빠뜨리다
babiesbreath : n, 대나물, 광대나물
babirusa : n, 멧돼지의 일종(동인도 산)
baboo : n, 영어를 쓸 줄 아는 서기, 영국물이 든 인도인
baboon : n, 비비, 보기싫은놈
baboonery : n, 비비 같은 짓(태도)
babouche : n, 슬리퍼, 실내화(터키 등에서 씀)
babul : n, 아카시아속의 고무나무, 그 재목(수지)
babushka : n, 세모꼴의 여자들 머리쓰개
baby : n, 갓난애, 작은동물(물건), 젊은 여자, 소녀, 애인(gold the~ 성가신 것을 떠맏다), pass the~ 책임 회피하다)
babybattering : n, 유아징계(학대)
baby blue : x, 옅은 푸른색
baby carriage : x, 유모차
baby farm : x, 육아원, 탁아소
baby grand : x, 소형 그랜드 피아노
babyhood : n, 유아기, 젖먹이
babyish : a, 어린애 같은, 유치한, 어리석은
babylike : a, 어린애 같은
Babylon : n, 바빌론, 화려한 도회, 타락의 도시
Babylonia : n, 아시아 남서부 고대제국
Babylonian : a, n, 바빌로니아의, 죄많은, 바빌로니아 사람, 바빌로니아 말
babyminder : n, =BABY SITTER
babysit : vi, 어린아이를 보아주다
babysiter : n, 어린아이 봐주는 사람
babysitting : n, babysitter의 일, do ~ 집 지키며 애보기를 하다
baby talk : x, 유아 말
baccalaureate : n, 학사의 학위(대학 졸업생에 대한)송별 설교
baccanal : a, n, 주신, 바카스의, 바카스 예찬의, 바카스 예찬자, 주정꾼
baccarat : n, 바카라, (도박용 카드놀이의 일종)
baccatate : a, 장과(berry)를 맺는, 장과 모양의
Bacchae : n, 주신 바커스의 시녀(무녀)들, 바커스제 여성 참가자들
bacchanal : n, BACCHUS의, 술 마시며 떠들어대는, 주신 바커스의 신도, 취하여 떠드는 사람, 떠들썩한 술잔치
Bacchanalia : n, (고대 로마의)주신제, 통음난무
Bacchanalian : a, pl, 바카스의
bacchant : n, 주신 바카스의 사제, 술마시고 떠드는 사람
bacchante : n, 바커스 신의 여사제(여신도), 여주객
bacchantic : a, 바커스를 숭배하는, 술마시며 떠들어대는, 술을 좋아하는
Bacchic : a, 주신 바카스의, 만취한
Bacchus : n, 바카스, 술의 신
bacciferous : a, 장과를 맺는
bacciform : a, 장과 모양의
bacco : n, 담배
baccy : n, (tobacco의 단축형)담배
Bach : n, 독일의 작곡가
bach : n, vi, 독신자, 독신 생활을 하다
bachelor : n, 독신자, 학사
bacheloratarms : n, 다른 기사를 섬기는 젊은 기사
bachelordom : n, 독신, 독신 기질, 독신자
bachelorette : n, (자립 생활 하는)독신 여성
bachelor girl : x, 젊은 독신 여성
bachelor girl : (자활하고 있는)젊은 독신여성, 
bachelorhood : n, 독신 생활, 독신 시절
bachelorsbutton : n, 수레국화, 수레국화 따위
bachelorship : n, 독신, 학사의 자격
bacilius : n, 간상균, 세균
bacillary : a, 간상의, 간균의
bacilliform : a, 작은 막대기 모양의
bacitracin : n, 바시트라신(항생물질)
back : n, a, ad, 등, 잔등, 뒤, 후부, 안, (손발의)등, (의자의)등널, 등뼈, 산등성이, 후위, 뒤의, 배후의, 안의, 속의, 벽지의, 거꿀의, 밀린, 이전, 뒤로, 뒤쪽으로, 뒤에
back : n, vt 등, 뒤, 후퇴하다
backache : n 등의 통증
backalley : a, 은밀한, 음성적인, 뒤가구린
backband : n, 등띠(말의 끌채를 붙들어 매는)
backbench(er) : n, 하원 뒷자리, (하원 뒷자리에 앉은 평의원)
backbite : vt, vi, 험담하다
backbiter : x, 험담하는 사람
backblock : n, 오지, 벽지의 목장
backboard : n, 뒤판, 백보드(농구의), 척추교정판
backbone : n, 등뼈, 기골
backboned : a, 등뼈가 있는, 기골이 있는(firm, resolute)
backbreaker : n, 몹시 힘드는 일, 맹렬히 일하는 사람
backbreaking : a, 몹시 힘드는
backcast : vt, vi, (연구, 자료에 의거)(과거의 일을)재구성하다, 기술하다, 묘사하다, 뒤로 선지기, (낚시)백캐스트(낚싯줄을 던지는 예비 동작)
backchat : n, 말대꾸, 대답, 수작, 모욕
backcloth : n, =BACKDROP 1
backcomb : vt, (머리를)거꾸로 빗어 세우다(tase)
back country : x, 벽촌
backcountry : n, 시골, 벽지, 미개척지
back country : x, 벽촌
backcourt : a, (테니스의), 백코드
backcross : vt, vi, n, 역교배를 시키다, 역교배
backdate : vt, ...의 날짜를 거슬러 올라가게 하다..., 까지 소급시키다
backdoor : n, a, 뒷문, 은밀한, 교활한
backdown : n, 퇴각, 후퇴, 항복
backdrop : n, 배경, 막
backed : a, 등을 댄, 배서가 있는
backer : n, 후원자
backfall : n, (레슬링)백폴(상대방을 넘어뜨려 매트에 등이 닿게 함)
backfence : a, 담 너머로의(대화 등), 이웃끼리의, 잡답(험담)식의
backfield : n, 후위(quarterback, halfback, fullback), 외야
backfill : vt, (판 구멍을)도로 메우다
backfire : n, 맞불, (산불을 끄기위함), 역불
backflip : n, vi, 뒤공중제비(를)하다
backflow : n, 역류, 환류
back formation : x, 역성, 역성어
backformation : n, 역성(법), 역성어
back formation : x, 역성, 역성어
backgammon : n, 서양 쌍륙
background : n, 배경, 바탕색, 소양, 음악효과
backgrounder : n, (정부측의)배경 설명(기자 회견), 배경 해설 기사
backhand : a, n, 역타, (테니스 따위의), 왼쪽으로 기운 필적
backhanded : a, 손등으로의, (필적이)왼쪽으로 기운, 서투른, 간접적인
backhaul : n, (트럭, 화물선 등의)귀로, 역송, 귀로 화물
backhouse : n, 옥외 변소
backing : n, 등붙이기, 지원, 배서, 속널
backingout : n, 철회, 취소
backlands : n, 오지, 벽지
backlane : n, 뒷골목
backlash : n, (기계 톱니바퀴등의 느슨해지거나 마모된 곳의)덜거덕 거림, 격한 반동, 반발
backless : a, 등이 없는(의자 등)
backlighting : n, 역광 조명
backlining : n, (내리닫이 문틀의 홈을 막은)세로 판자, 등받침 붙이기
backlist : n, 재고서적 목록
backlog : n, (난로 속 깊숙이 넣는) , 축적, 예비
backmost : a, 맨 끝의
back number : x, 뒤의
back number : a, 뒤의
back out : x, 철회, 탈퇴, 변절
backout : n, 초읽기의 철회
backpack : n, vi, 배낭, (배낭을 지고 여행하다)
backpage : a, 뒷면의, 보도 가치가 적은(opp, front-page)
back passage : x, 직장
back passage : x, 직장
backpedal : vi, 페달을 뒤로 밟다, 후퇴하다(특히 권투에서)
backplate : n, (갑옷의)등갑, (부재의)뒤판
backproject : vt, n, 배경 영사하다, 배경 영사상
backrest : n, (의자 등의)등받침
back room : x, 뒤방
back room : n, 뒷방
backroom boy : x, 비밀 연구원, 공작원
backsaw : n, 등대기톱
backscattering : n, (방사선등의)후방, 산란
backscratcher : n, 등긁이, 타산적인 사람, 아첨꾼
backseat : n, 뒷자리, 말석, 하찮은 지위
backseat driver : x, 운전수에게 지시하는 승객, 간섭 좋아하는 사람
backset : n, 역행, 역류
backsheesh : n, =BAKSHEESH
backside : vi, 뒤쪽, 등, 궁둥이
backsight : n, 후시, (총의)가늠자
back slang : x, 철자나 발음을 꺼꾸로 하는 속어
back slang : x, 철자나 발음을 거꾸로하는 속어
backslap : a, n, 등을 탁 치다, 과장해서 친밀감을 보이다, 등을 탁 치기
backslide : vi, 다시 과오에 빠지다, 타락하다
backspace : vi, n, (타자기에서)한 자 역행시키다, 백스페이스, 역행 키
backspin : n, 백스핀, (테니스 따위에서 공의 역회전)
back srairs : x, 뒷계단, 음모
backstage : n, a, 무대뒤
backstair : a, =BACKSTAIRS
backstairs : n, 뒷계단, 음모
backstay : n, 뒤쪽 버팀줄, 버팀
backstitch : n, vt, vi, 박음질(하다)
backstop : n, 백네트
backstreet : n, 뒷골목
backstretch : n, 백스트레치(장방형 코스의 homestretch와 반대쪽 부분)
backstroke : n, 되치기, 역타, 배영
backswept : a, 뒤쪽으로 경사한, (날개가)후퇴각이 있는
backswing : n, 백스윙
backsword : n, 한쪽 날의 검, (펜싱용의) 목검
back talk : x, 말대꾸
backtalk : x, 말대꾸
backtoback : a, 잇따른, 등을 맞대고선(주로 연립주택에서)
backtrack : vi, 물러나다, 되돌아가다
backup : n, 뒷받침, 후원, 저장, (차량 따위의)정체
backward : a, 뒤로의, 거꾸로의(reversed), 싫어하는, 개약의
backwardation : n, 수도, 유예
backwardlooking : a, 회고적인, 퇴영적인
backwardly  : ad, 마지못해, 늦어져
backwards : ad, =BACKWARD
backwash : n, 역류, 노로 저은 물, 여파
backwater : n, 되 밀리는 물, 역수, 침체
backwind : n, 역풍
backwoods : n, pl, 변경의 삼림지, 오지
backwoodsman : n, 변경 개척자
backyard : n, 뒤뜰, 늘 가는 곳
bacon : n, 이익, 벌이, 베이컨
Bacon : n, 영국의(경험학파의) 철학자, 수필가, 정치가
Baconian : a, n, 베이컨(학파)의, 베이컨의 철학을 신봉하는 사람, 베이컨설의 주장자
bacony : a, 지방질의, 뚱뚱한
bact : x, bacteriology
bacteremia : n, 균혈증(혈액에 세균이 있는 상태)
bacteri : n, 세균, 박테리아
bacteria : n, pl, 박테리아
bacterial : a, 박테리아(세균)의
bactericidal : a, 살균제의
bactericide : n, 살균제
bacterid : n, 세균성 피진(매독진 등)
bacterin : n, 세균 백신(bacterial vaccine)
bacteriogenic : a, 세균성의, 세균이 원인인
bacteriological : a, 세균학(상)의
bacteriological : a, 
bacteriologist : n, 세균학
bacteriology : n, 세균학
bacteriolysis : n, 세균 분해 (처리), 용균 (살균)현상
bacteriolytic : a, 용균성의
bacteriophage : n, (장, 오줌, 피속의)살균소
bacteriophobia : n, 세균 오염 공포증
bacterioscopy : n, 세균 검사(현미경에 의한)
bacteriostasis : n, 세균 발육 저지
bacteriostat : n, 세균 발육 저지제
bacteriotherapy : n, 세균 요법
bacterium : n, 박테리아의 단수형
bacterization : n, 세균 작용
bacterize : vt, ...에 세균을 작용시키다
bacteroid : n, a, 박테로이드(콩과 식물의 근류 속의), 가세균, 세균 모양의, 세균 비슷한
bacteroidal : a, =BACTEROID
bacukkary : a, 간상의, 간균의, 간균에 의한
baculine : a, 회초리의, 태형의
bad : a, n, 나쁜, 불량한, 부정한, 불길한, 나쁘게 된, 썩은, 서투른, 시원치 않은, 형평이 좋지 않은, 아픈, 악성의, 심한, 무효의, 나쁜 것, 악운
bad : v, bid의 과거
bad blood : x, 나쁜 감정, 증오
bad debt : x, 대손
baddish : a, 약간(좀)나쁜
bade : v, bid의 과거
bad egg : x, 악인, 신용이 없는 인물
badely : ad, 천하게, 비열하게, 서출로서
BadenBaden : n, 바덴바덴(서독 남서부의 도시, 온천 휴양지)
BadenPowell : n, 베이든포엘, (Boy Scouts와 Girl Gukdes를 창설한 영국의 군인)
badge : x, 반자동 방공 경계 관제 조직
badge : n, 기장, 표
BADGE : n, Basic Air Defense Ground Environment, 기지 방공 지상 경계 조직
badger : n, vt, 오소리, 그모피, 지분대다, 괴롭히다
badger : n, vt, 오소리, 그 가죽, (장난 삼아)집적대다, 괴롭히다, 조르다
Badger State : x, 미국의 주
bad hat : x, 깡패
badhumored : a, 심기가 나쁜, 성 잘 내는
badinage : n, vt, 농담, 놀림, 놀리며, 집적거리다
badlands : n, pl, 불모의 땅, 황무지, 암흑가
badly : ad, 나쁘게, 서투르게, 심하게
badman : n, (서부 개척 시대의)악당, (영화, 연극 등의)악역
badminton : n, 배드민턴, 소다수로 만든 청량음료
badmouth : vt, 혹평하다, 헐뜯다
badness : n, 나쁜 상태(모양), 나쁨, 악, 불량, 부정, 골치 아른 녀석
badtempered : a, 기분이 언짢은, 꾀까다로운, 심술궂은
bad time : x, 곤경
Baedeker : n, 여행 안내서
baff : vt, n, 골프채로 땅을 쳐 공을 높이 올리다, 그러한 타구
baffle : vt, n, 좌절시키다, 깨뜨리다, 꺾다, 방해하다
bafflegab : n, (관리가 쓰는)어려운 말투
bafflement : n, 방해, 훼방, 곤혹, 당혹
baffling : a, 저해하는, 당황하게 하는, 이해할 수 없는
baffy : n, 배피(클럽의 일종, wooddml 4번)
bag : n, vt, vi, 가방, 자루, 주머닌 모양의 것, 손지갑, 자루에 넣다, 잡다, 죽이다, 훔치다(steal), 자루처럼 부풀다(swell)
bag(h)dad : n, 이락의 수도
Bag(h)dad : n, 이락의 수도
bagasse : n, (사탕수수의)당분을 짜고 남은 깍지(연료용)
bagatelle : n, 사소한 일, (피아노용의)소곡, 배거텔놀이(당구의 일종)
Bagdad : n, 하찮은 것, 사소한 일, 바가텔(일종의 당구 놀이), (피아노를 위한)소곡
bagel : n, 도넛형의 굳은 빵
bagful : n, 자루 하나 가득
baggage : n, 수화물, 군용 행낭, 말괄량이, 닮고 닮은 여자
baggage car : x, 수화물차
baggage check : x, 수화물표
baggageman : n, 수하물 계원
baggagemaster : n, 수하물 계장, 수송 대장
baggage room : x, baggagetag, 수화물 일시 보관소
baggagesmasher : n, =BAGGAGEMAN
baggage tag : x, 꼬리표
bagged : a, (몹시)술취한
bagger : n, 루타, ( 삼루타 )
bagging : n, 자루 만드는 재료
baggy : a, ad, n, 자루 같은, 헐렁한, 불룩한-gily-giness
bagman : n, 외판원, 세일즈맨
bagnio : n, 목욕탕, (노예를 가두는)감옥, 매춘굴
bagpipe : n, 백파이프(스코틀랜드 고지인의, 날라리 소리 비슷한 피리)
bagpiper : n, 백파이프 취주자
bagplay : n, 비위맞추기, 아첨
baguet(te) : n, 길쭉한 네목꼴
bagwig : n, 가발의 일종(18세기에 유행, 뒷머리를 싸는 주머니가 달림)
bagwoman : n, =BAG LADY
bagworm : n, 도롱이, 벌레
bah : xint, 바보같은, 흥
bahadur : n, 각하(공문서 등에서), (인도)나리
Bahaism : n, 바하이교, (세계 평화를 창도하는 페르샤에서 일어난 종교
Bahamas : n, 바하마, (미국 플로리다 반도 동남쪽에 있는 독립국)
Bahamian : a, n, 바하마(제도)의, 바하마 사람의, 바하마 사람
Bahrain : n, 바레인(페르시아만 내에 있는 독립국, 수도 Manama)
bahrein : n, 바레인, (페르샤만 서부의 독립국)
baht : n, 태국의 화폐단위
baignoire : n, 특별석
baignoirement : n, 보석, 위탁
baignoiror : n, 위탁인
Baikal : n, 바이칼호(시베리아의 호수)
bail : n, vt, 보석, 보석금, 들손-보석받게하다
bail : n, 삼주문위의 가로나무
bail : vt, vi, n, 뱃바닥에 괸물을 퍼내다
bail : n, 들손, 통의 반달꼴손잡이
bailable : a, 보석시킬 수 있는(죄, 사람 등)
bailee : n, 수탁인
bailer : n, 뱃바닥에 괸 물을 퍼낸는 사람
bailey : n, 성벽, 성안의 뜰
bailie : n, 시참사 회원
bailiff : n, 법정내의 간수, (지주의)집사, (시의)집행관
bailiwick : n, 관할 구역, 분야, 영역
bailment : n, 위탁, 보석
bailor : n, 위탁자
bailout : n, a, 탈출, 긴급 구조-탈출의
bailsman : n, 보석 보증인
bainmarie : n, 이중 냄비=STEAM TABLE
bairn : n, 어린이
bait : n, vt, vi, 미끼, 미끼를 달다, 먹이를 먹다
bait and switch : a, 유인 상술의
baize : n, 일종의 나사, (책상보, 커튼용)
bake : n, vi, n, 굽다, 구워지다, 굽기, 회식
Bakelite : n, 베이클라이트(그릇, 절연체용 합성수지)
bakeoff : n, 빵 굽기 콘테스트
baker : n, 빵집, 빵 굽는 사람, 빵 제조업자, 휴대용 빵 굽는 기계
bakerkneed : a, 무릎이 안쪽으로 굽은, 앙가발이의
bakers dozen : x, 13개
baking : n, a, ad, 빵굽기, 한 번 굽기, 태워버릴 것 같은
baking powder : x, 베이킹 파우더
baking soda : x, 중조
baksheesh, -shish : n, 행하, 팁(터키, 이집트, 인도 등지에서)
Balaam : n, 발람, (메소포타미아의 예언자), 여백 매우는 기사
balalaika : n, 발랄라이카, (기타 비슷한 삼각형의 러시아의 악기)
balance : n, vi, vt, 저울, 천칭, 균형, 균형을 잡다
balanceable : a, 균형 잡을 수 있는
balanced : a, 균형 잡힌, 안정된, ~ diet (ration)균형(조정)식, 완전 영양식
balancer : n, 균형을 유지하는 사람(것), 평형기, 청산인, 곡예사(acrobat)
balance sheet : x, 대차대조표
balanitis : n, 귀두염
balas : n, 귀첨정색의 일종
balata : n, 열대나무의 일종, 발라타고무
balboa : n, 발보아(파나마의 화폐 단위 기호 B/, =100 centesimos)
Balboa : n, 발보아 Vasco Nunez de ~(1475-1517) (태평양을 발견한 스페인 탐험가)
balbriggan : n, 무명 메리야스의 일종, 그 것으로 만든 속옷, 파자마등
balconied : a, 발코니가 있는
balcony : n, 노대, (이층의)특별석, 발코니
bald : a, 벗어진, 털없는, 대머리의, 노출된
baldachin : n, 닫집, 금란, 비단
bald coot : x, 대머리, 큰 물닭
bald eagle : x, 흰머리독수리, (미국의 국장)
balderdash : n, 헛소리
baldfaced : a, 얼굴에 흰점이 있는
baldhead : n, 대머리
baldheaded : a, 대머리의
baldie : n, =BALDY
balding : a, 벗겨지기 시작한 (머리)
baldish : a, 조금 벗어진
baldly : ad, 노골적으로(plainly)
baldly ad : x, 노골적으로
baldpate : n, 대머리인 사람, 아메리카 홍머리 오리
baldric : n, (어깨에서 비스듬히 걸치는)장식띠, (칼, 나팔 따위를 다는 )
Baldwin : n, 볼드윈 Stanley ~ (1867-1947) (영국의 정치가, 수상)
baldy : n, 대머리, 접지면이 마모된 타이어
bale : n, vt, (상품을 꾸민)짐짝, 가마니, 포장하다, 재앙, 악
baleen : n, 고래 수염, 고래 뼈
balefire : n, 봉화, 모닥불, 화장용의 장작더미
baleful : a, 해로운
balk : n, vt, vi, 장애, 방해, 실책, 보크, (귀를 둥글린)각재, 들보감-방해하다, 좌절시키다, 실망시키다(기회를)놓치다-(말이 뒷걸을질 쳐)급히 멈추다
Balkan : a, 발칸 반도(제국, 산맥)의
Balkanize : vt, (서로 적대시하는)소국으로 분열시키다
balker : n, 
balkline : n, (트랙 경기의)스타트라인, (도약에서)발구름 선, 스리쿠션에 있어 당구대 위에 그은 정자 꼴의 줄, 영국식 당구대 위의 각부 제2성간을 맺는 선
balky : a, 움직이지 않는, (말이)
ball : n, 공, 구, (구기용)공, 볼, 공같이 둥근 것, 공놀이, 야구, (던지거나 친)공, 탄환, 포환, 큰 환약, 볼알, 어리석은 일, 용기, 만용, 천체, 지구, 남자, 놈, 책임있는 지위
ball : n, 공, 구, 구기, 야구, 대도회
ballad : n, 민요, 전설 가요
ballade : n, 발라드(8행의 구 3절과 4행의 envoy로 된 프랑스 시형, 각 절과 envoy는 모두 같은 후렴으로 끝남, 서사가(곡), 담시곡
balladeer : n, 민요 시인(작가)
balladmonger : n, 발라드를 짓는(파는) 사람, 서투른 시인
balladry : n, (집합적)민요
ballast : n, vt, 밸러스트, 바닥짐, 모래주머니-바닥짐을 싣다, (철도, 도로에)자갈을 깔다, 안정시키다
ballasting : n, 바닥짐 재료, 자갈
ball bearing : x, 볼 베어링
ballbearing : a, 볼베어링의, 쇠알이 든
ball cartridge : x, 실탄
ball cock : x, 부두, 콕
ballerina : n, 발레리나, (여자 발레 무용가)
ballet : n, 발레, 무용극, 발레곡, 발레단
ballet : n, 발레, 발레단(음악)
balletic : a, 발레의, 발레 같은
balletically : ad, 발레적으로
balletomane : n, 발레광
balletomania : n, 발레광
ballflower : n, 꽃송이 장식, 꽃방망이
Balliol : n, Oxford 대학의 cllege의 하나
ballista : n, 투석포
ballistic : a, 탄도(학)의, 비행 물체의
ballistician : n, 탄도학자
ballistic missile : x, 탄도병기, 탄도탄
ballistics : n, 탄도학
ballistocardiogram : n, 심전도
ballistocardiograph : n, 심전도계
ballkan : a, 발칸 반도의
ballocks : n, pl, 불알
ballon dessai : x, 관측기구, 시험기구, 탐색(여론의 반응을 알기 위한 성명, 행동 따위)
ballonet : n, 보조 기낭(부력 조절용)
balloon : n, vi, 기구, 풍선(처럼 부풀다), 기구(를 타고 올라가다) ~, er, ~, ist n
balloon barrage : x, 조색, (방공), 기구망
balloonfish : n, 복어
balloon flower : x, 도라지
balloonflower : n, 길경, 도라지
balloonhead : n, 멍텅구리
ballooning : n, 기구 비행 경기
balloon tire : x, 저압 타이어
ballot : n, 투표용지, 투표용의 작은공, 투표, 제비, 추첨
ballotage : n, 결선 투표
ballot box : x, 투표함
ballot paper : x, 투표용지
ballottement : n, 부구감(태아 등 체내 부유체의 촉진법)
ball park : x, 야구장
ballpark : a, 대체로 정확한, 만족할 만한
ball park : x, 야구장
ball pen : x, 볼펜
ball player : x, 야구선수, 구기를 하는 사람
ballplayer : n, 야구(공놀이)를 하는 사람, 직업 야구 선수
ball player : n, 야구선수
ballpoint(pen) : n, 볼펜
ball point pen : x, 볼펜
ball pointpen : x, 볼펜
ball proof : x, 방탄의
ballproof : a, 방탄의
ball proof : a, 방탄의
ball room : x, 무도장
ballroom : n, 무도실(장)
ball room : n, 무도장
balls : vt, 혼란케 하다, 엉망으로 만들다
ballsup : n, =BALLUP
ballsy : a, 간이 큰, 강심장의, 용감한
ballup : n, 혼란, 당황
ballute : n, 기구 낙하산(우주선 귀환용)
bally : a, ad, 지독한, 지독하게, 정말로
ballyhack : n, 파멸, 지옥(hell)
ballyhoo : n, 대선전, 야단법석, 떠벌려, 퍼뜨림
ballyrag : vt, =BULLYRAG
balm : n, 향유, 바향수지, 진통제, 서양박하
balmily : ad, 향기롭게, 상쾌하게
balmy : a, 향기로운, 진통의(soothing), 기분좋은, 상쾌한(freshing)
balneal : a, 욕탕의, 목욕의, 탕지의
balneary : a, 욕탕의, 목욕의, 탕지의
balneology : n, 온천학, 광천학
balneotherapy : n, 광천(온천)요법
baloney : n, 헛소리, 실없는 소리, 어리석은 짓=BOLOGNA
balsa : n, 발사, (열대 아프리카산의 나무), 뗏목, 발사 재목(가볍고 단단한 나무), 발사 재목으로 만든 뗏목(부표)
balsam : n, 발삼, 방향수지, 진통제, 봉선화
balsam fir : x, (북미산의 상록수, 테레빈이 채취됨)발삼전나무
Baltic : a, 발트해의, 발트해 연안 제국의, 발트어파의, 발트파=BALTIC SEA
Baltimore chop : n, 안타, (높은 바운드의 내야 안타)
Baltimore oriole : 북미산의 oriole의 일종(빛깔은 오렌지색과 흑색), 
baluster : n, 난간 동자, (난간의 작은 기둥)
balustrade : n, 난간
balustraded : a, 난간이 달린
Balzac : n, 프랑스의 소설가
bambino : n, 어린 아이, 아기 예수의 상
bamboo : n, 대, 대나무
bamboo curtain : x, (중공의)죽의 장막
bamboo shoot : x, 죽순
bamboo telegraph : x, 대양주원주민들의 정보전달 방법(hgrapevine telegraph)
bamboozle : vt, vi, 속이다, 어리둥절케 하다, 당황케 하다
bamboozlement : n, 어리 둥절, 당황
ban : vt, n, 금지하다, 파문하다-금지령, 파문, 금지령, 금제, 금제, 공고, 파문, 추방, 포고, 결혼 예고, (봉건 시대의)가신의 소집, 소집된 가신들
banal : a, 평범한(commonplace), 진부한
banality : n, 평범, 진부한 말
banalize : vt, 진부(평범)하게 만들다..., 의 신선미를 빼앗다
banana : n, 바나나
banana republic : x, 바나나 소국, (국가 경제를 바나나 수출에 의존함)
bananas : a, 머리가 돈, 열광한, 흥분한
banausic : a, 실용적인, 실리적인, 단조로운, 기계적인, 독창성 없는
banc : n, 판사석
banco : n, 판사석
band : n, vi, vt, 끈, 밴드, 띠, 일대, 악대-단결하다(together)
bandage : n, vi, 붕대, 안대, 붕대를 감다
BandAid : n, 임시방편, 미봉책, 반창고의 일종, 임시방편의
bandana : n, 비단 손수건, (무늬가 있는 큰 비단 손수건)
bandanna : n, 홀치기 염색의 대형 손수건, 네커치프
bandar : n, 인도원숭이
bandbox : n, 종이 상자
bandeau : n, 여자용 머리 띠, 가는 기롭
banded : a, 줄무늬 모양의, 대상 장식이 있는
banderilla : n, (투우에서 수의 목을 찌를는)창
banderllero : n, (banderilla를 쓰는)투우사
banderol : n, 작은 기
banderole : n, (창, 돛대의)작은 기, 기드림, 조기(bannerol)
band hell : 야외음악당, 
bandicoot : n, 큰쥐(인도산), 캥러루쥐(오스트레일이아산)
bandit : n, 산적, 노상강도, 도둑, 악당
banditry : n, 산적 행위, (집합적)산적단, 강도떼
bandline : n, 밴덜린(포마드의 일종)
bandloier : n, 탄약대, 탄띠
bandmaster : n, 악장
bandmoll : n, 록밴드를 따라다니는 여자(보통 10대)
bandog : n, (사슬에 매인), 사나운 개, 탐정견
bandoleer : n, 멜빵, 탄띠(어깨에 걸쳐 띠는)
bandonion : n, 반도니온(아코디언 비슷한 악기)
bandore : n, =PANDORA
band saw : x, 띠톱
band saw : x, 띠톱
band shell : x, 음악당
bandsman : n, 악대원
bandstand : n, 연주대
Bandung : n, 반둥(인도네시아 Java섬의 도시)
bandwagon : n, (행렬 선두의)악대차, 우세한 쪽, 사람의 눈을 끄는것, 유행
bandwidth : n, 대역폭
bandy : vt, n, a, 주고 받다, 서로 던지고 받고 하다, 퍼뜨리다-하키-밖으로 굽은
bandyball : n, (옛)하키, 하키공
bandylegged : a, 다리가 O형으로 굽은, 안짱다리의
bandylegged : a, 안짱 ekfldml(bowlegged)
bane : n, 독, 해, 파멸
baneberry : n, (북미산)노루삼속의 식물, 그 유독 열매
baneful : a, 해로운, 유독한
Banff : n, 뱀프(캐나다 Allberta주 남서부 Rocky산맥 중의 국립 공원)
bang : n, vt, ad, vt, 강타하는 소리, 돌연한 음악, 강타, 원기-쿵쿵치다, 쾅 닫다, 탕 발사하다, 주입시키다, 성교하다-광하고, 탁하고, 갑자기, 모두
bangalore  torpedo : n, 폭약철관(철조망 파괴용)
banger : n, 소음이 나는 고물차, 소시지
bangkok : n, 타이의 수도
Bangladesh : n, 방글라데시(1971년 파키스탄에서 분리, 독립한 공화군)
bangle : n, 팔찌, 손목고리
bangled : a, 장식 고리(팔찌)를 낀
bangon : a, 굉장한, 먼진, 딱 들어맞는
bangtail : n, 꼬리 자른 말(의 꼬리), 짧은 꼬리의 야생마, 경주마(race horse)
Bangui : n, 방기(중앙 아프리카 공화국의 수도)
bangup : a, 최고의
banian : n, 상인, 거간, (인도의)헐렁한 샤쓰
banish : vt, 추방하다, 떨어버리다
banishment : n, 추방, 방축, 배척, 유형
banister : n, 난간
banjax : vt, 때리다, 패다, 이겨내다(overcome)
banjo : n, 밴조, (손가락 깍지로 타는 현악기)
banjulele : n, 밴줄렐레(banjo와 ukulele의 중간 악기)
bank : n, vt, vi, 둑, 제방, 은행, 퇴적, 쌓다-둑을 쌓다, 쌓아 올리다, 에워싸다, 재에 묻다, 뱅크시키다-둑이 되다
bank : n, vt, vi, 은행, 저장소, 은행에 맡기다, 은행을 경여하다, 은행과 거래하다
bank : n, (캐리배의)노젓는 자리, 한줄로 늘어선 노, (건반의)한 줄, (신문의)부제목
bankable : a, 은행에 담보 할 수 있는
bank account : x, 은행 계정, 당좌 예금
bank bill : x, 은행 어음, 지폐
bankbook : n, 예금 통장
bank discount : x, 어음 할인
banker : n, 은행가, 물주
bank holiday : x, (일요일 이외의)은행 공휴일
banking : n, 은행업
banking : n, a, 제방 쌓기, 제방 공사, 횡경사, 근해 어업(뉴질랜드의), 은행업, 은행 업무, 은행업의
bank night : x, (영화관에서 베푸는)현상금붙은 야간흥행
bank note : x, 은행권 지폐
bank rate : x, 어음할인율, 은행일변
bankroll : n, vt, 자금, 자본, 돈다발, 재원, 가지고 있는 돈, 자금을 공급하다
bankrupt : n, a, 파산자, 파산한, 지불 능력이 없는, 파산하다
bankruptcy : n, 파산, 파탄
banksia : n, 뱅크셔(오스트레일리아산 상록 관목의 일종)
Bankside : n, 뱅크사이드(Thames강 남안의 극장가)
banksman : n, (탄광의)갱외 감독
banlieue : n, 교외 주택 지구
bannal : a, 평범한
banner : n, a, 기, 군기, 기치, 주장, 전단표제-일류의, 제 1위의, 주요한
banneret : n, 작은기
bannerette : n, 작은 기
bannerline : n, vt, 신문의 톱전단에 걸친 제목(을 붙이다)
bannerol : n, =BANDEROLE
bannister : n, =BANISTER
bannock : n, 빵
banns : n, 결혼 거행의 예고
banquet : n, vt, vi, 연회, 향연-향응하다, 향을을 받다
banquette : n, 사격용 발판
Banquo : n, 뱅쿼(Macbeth 중의 인물, 유령이 되어 맥베스를 괴롭힘)
bans : n, pl, =BANNS
banshee : n, 요정, (가족의 죽음을 예고하는)
banshee wail : x, 공습경보
bantam : n, a, 벤텀당닭:암팡지고 싸움 좋아하는 사람-몸집이 작은, 가벼운, 공격적인
bantamweight : n, 벤텀급선수(권투, 레슬링 따위)
banter : n, vt, vi, 놀림, 놀리다, 조롱하다
bantering : a, 농담조의, 희롱하는
banthebomb : a, 핵무기 폐지를 주장하는
Banthine : n, 밴신(위궤양 치료제, 상표명)
banting : n, (지방, 당분의 감량에 의한)체중 감량법, 밴팅식 감지 요법(기름기, 녹말, 당분 등을 피하여 살빼기)
bantling : n, 꼬마, 애송이
Bantu : n, 반투족의 토인(아프리카 남, 중부의)
Bantustan : n, 반투스탄(남아공화국의 반자치 흑인 구역)
banyan : n, 벵골 보리수
baobab : n, 바오바브나무(아프리카산의 거대한 나무)
baptism : n, 세례, 침례, 명명(식)(~of bloo 괴의 세례, 순교, ~of fire 포화의 세례, 첫 출전, 화형에 의한 순교, 괴로운 시련
baptismal : a, 세례의
baptist : n 침례교도, 세례자 요한
Baptist church : x, 침례교회, 세례자(요한)
baptistery : n, 세례장
Baptistic : a, 세례의, 침례교회(파)의
baptize : vt, (...에게)세례를 베풀다, 정하게 하다..., 에게 세례명을 지어주다, 명명하다, 별명을 붙이다
baptize : vt, vi, 세례를 베풀다, 침례를 행하다, 명명하다
baptizer : vi, 세례를 베풀다
bar : n, vt, prep, 막대기, 가로장, 장애, 장벽, 관문, (통행 금지의)차단봉, (난간의)돌난대-빗장을 지르다(가로대로)잠그다, (길을)막다, 금하다- ...을 제하고
bar : n, 바(입력의 단위)
bar : n, 모기장
BAR : x, Browning automatic rifle bar, barometer, barometric, barrel, barrister Bar, Barrister B, Ar(ch), Bachelor of Architecture
Barabbas : n, 바라바(그리스도 대신 석방된 도둑의 이름)
barandgrill : n, 술도 파는 식당
Bararian : a, n, 바이에른(산)의, 바이에른 사람(사투리)의, 바이에른 사람, 바이에른 사투리
barathea : n, 배라시아(양모 또는 견(면)을 섞어짠 고급 옷감
barb : n, vt, a, 미늘, (낚시)-...에 가시를 달다-미늘이 있는
barb : n, 바르바리 말(Barbsary 산의 좋은 말)
Barbadian : a, n, 바르바도스(사람)의, 바르바도스 사람
Barbados : n, 바르바 도스, (서인도 제도에 속하는 섬)
Barbara : n, 여자 이름(애칭 Baba, Bab)
barbarian : n, a, 야만인, 외국인, 교양없는 사람-야만적인, 미개한
barbaric : a, 야만인의(같은), 야만적인, (문체, 표현 등)세련되지 않은, 잔인한
barbarism : n, 야만, 미개, 조야, 조야한 행동
barbarism : n, 야만, 미개(상태), 포학, 막된 거동(말씨), 파격적인 말(구문), 상말
barbarity : n, 만행, 잔인, 조야, 잔인한 행동
barbarization : n, 야만화, (문체의)불순화
barbarize : vi, vt, 야만화하다
barbarous : a, 야만의, 잔인한, 조야한, 무식한
Barbary : x, 바바리(이집트를 제외한 북아프리카 회교 지역의 옛 이름)
barbary ape : x, 꼬리없는 원숭이
barbary statew : x, 바바리 제국, (옛 Morocco, Algeria, Tumis, Tripoli 등의 회교국)
barbecue : vt, n, 통째로 굽다, 바베큐, (통돼지 구이가 나오는 연회)
barbecue man(o)euver : x, (우주선의)바비큐 비행, (태양열, 맹기를 고푸 받도록 1시간에 2번씩 자전하며 비행)
barbed : a, 마늘(가시)이 있는, 신랄한
barbel : n, 수염이 있는 물고기
barbell : n, 바벨, (역도용)
barbellate : a, 짧은 센 털이 있는, 수염 있는
barber : n, 이발사, 이발하다, 수염을 깍다
barberry : n, 매발톱나무, 매발톱나무 열매
barbershop : n, a, 이발소-(경음악의 남성 4중창의 구성이)(주로)반음 차인, 밀집 위치의, 부드러운
barbers pole : x, 이발소의 간판 기
barbersurgeon : n, (옛날의)이발사 겸 외과의사
barbet : n, 오색조(열대산)
barbette : n, (성벽 안의)포좌, (군함의)고정 포탑
barbican : n, (도시, 요새의)외보, (성문 따위의)망루, 성문탑
barbital : n, 바르비탈(진정, 수면제)
barbital : n, 바르비탈, (진정, 수면제)
barbitone : n, =BARBITAL
barbiturate : n, 바르비투르 산염, (수면제)
barbituric acid : n, 바르비투르산
barBO : n, BARBECUE의 상업용 변형 절차
barbola : n, (가소물로 만드는 꽃, 과일 등의)압화 세공(=~ work)
barbule : n, 작은 가시(수염), 작은 깃가지
barbwire : n, =BARBED WIRE
barcarolle : n, 뱃노래, 뱃노래 풍의 곡
Barcelona : n, 바르셀로나(스페인 북동부의 항구)
barchan : n, 바르한(초승달 꼴 사구)
barcode : vt, vi, (상품등에)바코드를 붙이다
bard : n, 음유시인, 시인
bardolatry : n, 셰익스피어(Bard of Avon)숭배
Bardolino : n, 바르돌리노주(양질의 순한 이탈리아산 적포도주)
bare : a, vt, 벌거벋은, 알몸의, 노출된, 드러낸, 노골적인, 장식없는, ...이 없는, 닳아빠진, 써서 낡은, 부족한, 결핍된, 가까스로의몸의, 발가벗기다, 벗기다
bare : x, bear의 과거
barebacked : a, 안장 없는(없이)
bareboat : a, 선체 용선의
barebones : n, a, 바싹 마른 사람, 피골이 상접한 사람, 말라빠진, 골자(요점)만의, 내용이 빈약한
barefaced : a, 안장 없는 말의, 맨말에
barefacedly : ad, 뻔뻔스럽게
barefisted : a, ad, 맨주먹의(으로)
barefoot : a, 맨발의, 맨발로
barefooted : a, 맨발의(로)
barege : n, 명주실과 무명실 등으로 짠 얇은 직물(베일, 옷감용)
barehanded : a, ad, 맨손의, 맨손으로
barehead : a, ad, 맨머리 바람으로
bareknuckled : a, ad, (권투에서)글러브를 끼지 않은(않고), 마구잡이의(로), 맹렬한(히), 가차없는(이)
barelegged : a, ad, 양말을 신지 않은, 양말을 신지 않고
barely : ad, 간신히, 겨우, 드러내놓고, 꾸밈없이
barenecked : a, 목을 드러낸
barf : vi, vt, 토하다
barfly : n, 술집의 단골, 술꾼
bargain : n, vi, vt, 매매, 거래, 약속을 하다, 흥정하다, 교섭하다
bargainbasement : a, 값싼, 헐값의
bargaincounter : a, 값싼, 헐값의
bargaining : n, 거래, 계약, 교섭
bargainor : n, 매도인
barge : n, vt, 거룻배, 짐배(바닥이 편편한 화물선), 유람선, 낡은 배, 거룻배로 나르다, 뒤뚱뒤뚱 걷다, 주제넘게 나서다
bargeboard : n, 박공
bargee : n, barge의 사공
bargeman : n, 거룻배(유람선)의 사공
barghest : n, 귀신(큰 개가 되어 흉사를 예고한다는)
barhop : vi, 술집을 돌아다니며 마시다
bariatrician : n, 비만 치료 전문가, 비만학자
bariatrics : n, 비만병학, 체중조절 의학
baric : a, 바륨의, 바룸을 함유한
barilla : n, 수송나물(명아주과), 소다회
barite : n, 중정석
baritone : n, a, 바리톤가수, 바리톤의
barium : n, 바륨, (금속원소)
bark : 나무껍질, 기나피(quinine), 피부-(나무에서)껍질을 벗기다, 나무 껍질로 덮다n, vt, 
bark : vi, vt, n, 짖다, 소리지르다, 기침을 하다, 소리치며 손님을 끌다-소리 지르며 말하다-짖는 소리, 기침 소리, 포성, 총성
barkbarque : n, 바크배(세대박이), 배
barkeep(er) : n, 술집 주인, 바텐더
barkentine : n, 세대박이 돛배의 일종=BARQUENTINE
barker : n, 짖는 동물, 소리 지르는 사람, 나무 껍질 벋기는 사람(기구)
barker : n, 껍질 벗기는 사람
barkery : n, 무두질 공자, 가죽 다루는 곳(tanward)
barking : n, (잘)짖는, 권총, 짖는 소리, 심한 기침, 호통(치는 소리)
barky : n, 보리, 대맥
barley : n, 보리
barleybrake, -break : n, 남녀 3인씩 술래잡기
barleycorn : n, 보리알, (길이의 단위)
barlow : n, 큰 포켓 나이프
barm : n, 누룩, 효모(yeast)
barmaid : n, 술집의 여급
barman : n, 술집주인, 바텐더
Barmecidal : a, 허울뿐인, 가공의
Barmecide : n, a, (진미라 하여 빈 그릇만 내놓았다는 Arabian Nights의 부자 이름에서)허울좋은 향연(친절)을 베푸는 사람=BARMECIDAL
bar mitzvah : x, 성년식, (13세에 행하는 유태교의 남자 성년식)
barmitzvah : n, 13세에행하는 유태교의 남자성년식, 13세가된 유태교의 남자
barmy : a, 누룩든, 발효하는, 머리가 돈, 어리석은
barn : n, 헛간, 광, 가축 우리 겸용의 헛간, 전차 차고
barnacle : n, 조개삿갓, 따개비, 무능한관리, 코집게(편자를 박을 때 말이 날뛰지 못하게 하는 기구), 안경
Barnard : n, 남자 이름
barnburner : n, 과격파, 굉장한 것, 백열적인 시합
barn dance : x, 농가의 댄스 파티
barn door : x, 헛간의 큰 문
barndoor fowl : n, 닭
barney : n, 짜고 하는 권투 시합, 사기, 실수, 격론, 언쟁, 소형 기관차
Barney : n, 남자 이름(Barnabas, Bernard의 애칭)
Barnsley : n, 반즐리(잉글랜드 South Yorkshire주의 수도)
barnstorm : vi, 지방 순회 공연하다, 지방 유세하다
barnstormer : n, 지방 순회 배우, 엉터리 배우, 지방유세자
barnyard : n, a, 헛간의 앞마당, 농가의 안뜰, 뒤뜰의, 시골의
baro : n, 중량, 기압
barococo : a, 바로크와 로코코 절충 양식의, 더없이 정교한(장식적인)
barocyclonometer : n, 열대 저기압계, 구풍계
barodynamics : n, (단수취급)중량 역학
barogram : n, 자기 기압 기록
barograph : n, 자기 기압계
barology : n, 중력학, 중량학
barometer : n, 기압계, 청우계, 표준, 지표
barometric : a, 기압계의, 기압상의
barometry : n, 기압 측정법
baron : n, 남작, 산업계의 거물, 귀족, 남편, 재판관, 허리에 붙은 고기
baronage : n, 남작들, 남작계급, 남작의 지위, 남작 명부
baroness : n, 남작부인, 여남작
baronet : n, vt, 준남작(baron의 아래, knight의 위)
baronetage : n, (집합적)준남작, 준남작의 지위, 준남작 명부
baronetcy : n, 준 남작의 지위
barong : n, (필리핀 Moro족이 쓰는)폭이 넓은 칼
baronial : a, 남작의, 남작다운, 당당한
barony : n, 남작의 작위, 남작령
baroque : n, a, 바로크식, 바로크식의, 기괴한
baroreceptor : n, 압수용기(혈관벽 등에 있으며 압력 변화를 감지하는 지각 신경 종말)
baroscope : n, 기압계의 일종
barotolerance : n, 압력 내성
barouche : n, 마차, (4인승 대형 4륜 마차)
bar pin : x, 가늘고 긴 브로치
barque : n, 나무껍질
barquentine : n, 세대박이 돛배
barrack : n, vt, vi, 막사, 병영, 건초막, (선수, 연설자를)야유하다, 성원하다, 야유하다, 성원하다
barrack : vi, vt, (상대편 경기자를)야유하다
barracks bag : x, 잡낭
barracoon : n, 노예(죄수)수용소
barracouta : n, 창꼬지
barracuda : n, 창꼬지
barrage : n, 탄막, 연속
barrage balloon : x, 조색기구
barranca : n, 협곡
barrater : n, 소송 교사자, 수회 판사, 부정 선장(선원)
barrator : n, 소송 교사자, 수회 판사, 부정 선장(선원)
barratrous : a, 소송 교사의, 부정한, 태만한
barratrously : ad, 부정하게, 태만하게
barratry : n, 교사죄, 소송 교사죄, 성직 매매
barred : a, 빗장이 있는, 줄(무늬) 있는, 모래톱이 있는
barrel : n, vt, 통, 한 베럴(미국에서는31, 5 갈론, 영국에서는 36 18 또는 9갈론), 통 모양의 것-(...을)통에 담다
barrelage : n, 통의 용량
barrelbulk : n, 5입방 피트의 용적(1/8톤)
barrel chair : x, 안락의자
barrelchested : a, 가슴퉁이 두툼한(튼튼한)
barreled : a, 통에 넣은(채운), 원통형의, (보통 복합어를 이루어)총신이 ...인
barrelful : n, 한통(의 양), 다수, 대량
barrelhead : n, 통뚜껑(바닥)
barrel house : x, 통 술집, 싸구려 술집
barrelhouse : n, 하급 술집, 초기의 소란한 재즈
barrelled : a, 통에 넣은(채운), 원통형의
barrel organ : x, 풍금, (손으로 연주하는 풍금)
barrel roll : x, 통돌이, 연속회전
barren : a, n, 불모의, 농작물이 나지않는(토지), 새끼를 못 낳는, 임신 못하는, 열매를 맺지 않는, 재미없는, 내용이 보잘것 없는, 메마른 땅, 불모지, (특히 북미의)황야
barret : n, (베레모 비슷한)납작한 모자
barrette : n, 머리핀
barretter : n, 버레터(고주파 전류 검파기의 일종)
barriada : n, (도시의)지구, (특히 지방 출신자가 살고 있는)슬럼가
barricade : n, vt, 방책, 통행 차단물, 장애물-방책을 만들다, 막다, 방해하다
Barrie : n, 배리 Sir James M, ~(1860-1937)(영국의 소설가, 극작가, 대표작 Peter Pan)
barrier : n, 울타리, 방벽, 관문, 장벽, 방해
barrier reef : x, 보초(해안과 나란히 뻗은 산호초)
barring : xprep, =except..., 이 없으면 ...을 제외하고는
barringout : n, 교사 배척(학생들이 교실문을 걸고 배척하기)
barrio : n, 미국의 스페인어 통용지역
barrister : n, 법정 변호사, 변호사, 법률가
barroom : n, 바, (호텔 따위의 바)
barrow : n, 손수레, 들것식의 하물 운반대, 무덤, 언덕
barrow : n, 무덤(봉분, 또는 석총), 언덕
barrow boy : x, 손수레 행상인
barrowful : n, 손수레 한 대(의 짐)
barrowman : n, =COSTERMONGER
barstool : n, (술집의)높고 둥근 의자
BART : n, Bay Area Rapid Transit(미국 San Francisco 시의 고속 통근 철도)
bartender : n, 바텐더
barter : vi, vt, n, 물물교환 하다, 교역하다(이익에 현혹되어 영예, 지위 따위를)팔다-물물교환
barter system : x, 바터제
Bartholdi : n, 바르톨디 Frederic Auguste ~ (1834-1904)(프랑스의 조각가, 쥬욕의 자유의 여신상 제작자)
bartholomew : n, 바돌로매, (예수의 제자)
bartizan : n, 퇴망루
Bartlett : n, 바틀렛종의 배
barton : n, 농가의 뜰
Barts : x, 런던의 St, Bartholomews Hospital의 생략
Baruch : n, 바루크(예언자 예레미야의 제자), 바루크서(구약 외경의 한 책)
bary : n, 무거운, 중(heavy)
barycenter : n, 중심
baryon : n, 바리온(neutrom, proton, hyperon을 함유하는 소립자의 일종)
barysphere : n, 중권
baryta : n, 가종의 바륨 화합물
baryte : n, 중정석
barytes : n, 중정석
barytes : n, =barite
barytone : n, =baritone
basal : a, 기초의, 근본의(~metabolism 기초 대사)
basalt : n, 현무암
basaltic : a, 현무암의
basaltiform : a, 현무암 모야의
basanite : n, (주로 사장석, 감람석, 휘석으로 돈)현무암
bas bleu : x, =BLUESTOCKING
bascule : n, 튀개장치
bascule bridge : x, 도개교
base : n, vt, 기초, 기슭, 기지, 출발점, 천한, 비열한-기초를 두다(on)
base : a, n, 천한, 비열한, 비속한, 열등한, 조악한, 저음의, 천한, 저음
baseball : n, 야구, 야구공
baseboard : a, 굽돌이 널, (벽 아랫도리의)
baseborn : n, 태생이 비천한
basebred : a, 천하게 자란
baseburner : n, (위에서 연료가 자동적으로 보급되는)자동식 난로
basecoat : n, (페인트 등의)밑칠
basecoutr : n, 성의 바깥 마당, 농가의 뒤뜰, 하급 재판소
based : a, 근거가 있는..., 에 기지(기반)를 둔
basedows disease : x, 바제도 병
base exchange : x, 매점
basehearted : a, 마음이 비열한, 품성이 비천한
base hit : x, 안타
Basel : n, 바젤(스의스 북부의 Rhine강에 면한 도시)
baseless : a, 기초없는, 근거없는
baselevel : n, 기준면
base line : x, 기준선, 누선
baseman : n, 내야수, 누수
basement : n, 지하실, 지계
base metal : x, 비금속
baseness : n, 천함, 비열, (품질의)조악, 서출
basenji : n, (콩고산의)작은 사냥개
baseplate : n, 바닥판, 기초판, 의치상
base runner : x, 주자
base running : x, 주루
baserunning : n, 주루
bases : n, basis의 복수
bases : n, bese의 복수
basesloaded : a, 만루의
base stealing : x, 도루
base umpire : x, 누심
bash : vt, n, 후려갈기다, 후려갈김, 일격, 일격을 가하다
bashaw : n, 고관, 거만한 사람, 관리
bashful : a, 수줍어하는, 수줍은
bashibazouk : n, (오스만 제국 시대의)터키 비정규병(약탈, 잔인으로 유명)
bashing : n, 강타, 심한 패배(비난)
basi : n, a, 기부, 기저, basicranial 두개 기부의
basic : n, 기초의, 근본적인, 염기(알칼리)성의, 기초 훈련, 기초훈련을 받은 병사
Basic : n, Baginners Allpurpose Symbolic Instruction Code, 베이식(간단한 언어를 사용한 컴퓨터 용어)
basic : a, 기초의, 근본의, 염기성의
basically : ad, 근본적으로, 기본적으로, 원래
basic dress : x, 기본형 드레스(액세서리 따위의 변화로 다양하게 입을 수 있는 옷)
Basic English : x, 베이식 영어(Ogden이 고안한 간이 영어, 어휘 850어)
basicity : n, 염기도
basidiomycete : n, 담자균
basidiospore : n, 담자포자
basification : n, 염기화 (작용)
basify : vt, 염기화하다
basil : n, 박하 비슷한 향기높은 식물
Basil : n, 남자 이름
basilar : a, 기초의, 기부의
basilic : a, 왕의, 왕다운(royal), 중요한, 척측 피정맥의
basilica : n, 공회당, 그리스도 교회당
basilical : a, 왕의, 왕다운(royal), 중요한, 척측 피정맥의
basilicon : n, 연고의 일종
basilisk : n, 괴사, (그 눈빛 독기는 사람을 죽임), (열대 아메리카산의)등지느러미 도마뱀, 뱀무늬 대포
basin : n, 대야, 세면기, 웅덩이 유역
basinet : n, 철모
basinful : n, 대야 가득(한 분량)
basis : n, 기초, 근거, 근거지, 근본원리, 주성분
bask : vi, vt, (햇볕, 불을)쬐다, 몸을 녹이다, (애정 따위에)빠지다-(열 따위에)쬐다
basket : n, 바구니, 광주리, 한 바구니, 네트(농구)
basketball : n, 농구, 농구공
basket case : x, 사지가 절단된 환자
basketeer : n, 농구 선수
basketful : n, 한 바구니 가득, 한 바구니 (분량)
basketry : n, 바구니 세공, 바구니 세공품
basketwork : n, 바구니 세공, 바구니 세공품
basophil : n, 호염기성 백혈구
basophile : n, 호염기성 세포(특히 백혈구)
basophilic : a, 호염기성 세포(특히 백혈구)의
Basque : n, a, 바스크 사람(Pyrenees 산맥 지방에 사는), 바스크 (말의)
basrelief : n, 얕은 돋을 새김
bass : n, a, 베이스, 베이스 가수, 저음악기-저음의
bass : n, 농어의 일종
bass : n, =BASSWOOD=BAST
bass drum : x, 큰북
basset : n, 바셋, (다리가 짧은 사냥개)
bassinet : n, 요람, 포장 달린 요람, 그 모양의 유모차
basskap : n, 백인에 의한 유색 인종 지배
basso : n, 저음부, 저음 가수
bassoon : n, 바순, (저음 목관악기)
bassorelievo : n, =BASRELIEF
bass tarthing : x, 하잖은 거서, 조금
bass wood : x, 참피나무, 그 재목
basswood : n, 참피나무(의 재목)
bast : n, 인피부, (참피나무의)속껍질(돗자리, 바구니의 재료)
bastard : n, a, 서자, 사생아, 가짜-서출의, 가짜의, 열등한, 모습이 이상한, 비정상인
bastardization : n, 서자임의 인정, 조악화
bastardize : vt, vi 서자로 인정하다, 조악하게 하다, 나빠지다
bastardly : a, 서출의, 사생의, 가짜의
bastardy : n, 서출
baste : vt, 가봉하다, 기름을 치다, 치다, 때리다
baste : vt, (고기를 구울 때)기름을 치다, 버터를 바르다
baste : vt, 치다, 때리다(thrash)
Bastille : n, (파리의)바스티유 감옥(프랑스 혁명 때 파괴됨)
bastille : n, 바스티유 감옥, 감옥, 형무소
bastinado : vt, n, 발바닥을 때리다, 곤장 치다, 형벌, 막대기
basting : n, 가봉, 시침질, 시침질 솔기(실), (고기를 구우면서)양념장, 버터등을 축축하게 침, 그 양념장이나 버터
bastion : n, 요새, 능보
bastioned : a, 능보를 갖춘
bat : n, vi, vt, 배트, 타봉, (크리켓의)타자, 일격, 덩어리, (벽돌, 진흙 따위의)조각, 배트로 치다
bat : n, 박쥐
bat : vt, (눈을)깜박이다(wink)
bat : n, 속력, 속도, 보속
Batavia : n, 바타비아, Jakarta의 옛 이름, 라인강 하구에 있던 옛지역, 네덜란드의 옛 이름
batblind : a, (박쥐처럼)까막눈이의, 어리석은
batboy : n, 팀의 잡일을 하는 소년
batch : n, (빵, 오지 따위의)한 번 굽기, 한 번 구운 분량, 한 떼, 한 묶음
batch processing : x, 자료의 일괄처리
batchy : a, 미치광이 같은, 정신이 돈(crazy)
bate : vt, vi, 덜다, 줄이다(lessen), 약하게 하다(weaken), 줄다, 약해지다(with~d breath)숨을 죽이고
bate : n, 분개, 노여움
bate : n, vt, (무두질용의)알칼리액에 담그다
bateau : n, 평저선, (뒤가뾰족한)
batesark : ad, =BERSERKER, 갑옷 없이 무장하지 않고
batfish : n, 날개 모양의 돌기가 있는 물고기
batfowl : n, (횃불 등을 켜들고)보금 도마뱀, 사포(옛날 대포)
Bath : n, 이글랜드 Somerset주의 도시, 온천장, 바드 훈의(훈장)
bath : n, vt, vi, 목욕, 목욕실, 목욕통-목욕하다
bath brick : x, 바드 숫돌, (금속 닦을때 사용)
bath chair : x, (환자 외출용의)바퀴 달린 의자
bathe : vt, vi, n, 잠그다, 적시다, 끼얹다, 씻다-해수욕, 미역
bather : n, 해수욕자, 미역감는 사람, 온천 요양객
bathhouse : n, 목욕탕, 탈의실
Bathinette : n, 유아용 접이식 휴대욕조
bathing : n, 목욕, 수영, 멱감기(a bathing beauty 미인 대회에 나오는)수영복 차림의 미인
bathing cap : x, 수영모
bathing dress : x, =bathing sult
bathing machine : x, 이동 탈의차
bathing suit : x, 수영복, (여성용)
bathingtrunks : n, (남자용)수영 팬츠
bath mat : x, 발 닦는 매트
batholith : n, 저반(화성암이 불규칙하게 형성된 큰 덩어리)
bathometer : n, 수심 측량계, =BATHYMETER
bathorse : a, 깊은 바다 속에 살기에 적합한
bathorse : n, 짐말(군용)
bathos : n, =anticlimax
bathrobe : n, 화장복, (목용용)
bathroom : n, 욕실
Bathsheba : n, 여자 이름, 밧세바(전 남편이 죽은 뒤 다윗 왕에게 재가하여 솔로몬을 낳음)
Bath stome : x, 바드석(재)
bath stone : x, 바드석
bathtub : n, 욕조
bathwater : n, 목욕물
bathymeter : n, 수심 측량기
bathymetry : n, 수심 측량술, 측심학
bathypelagic : a, 점심해의
bathyscaphe : n, 베디스케이프, (해저탐험용 잠수정)
bathysphere : n, 구형 잠수기, (심해 생물 조사용)
bathythermograph : n, 심해 자기 온도계
batik : n, 납결 염색법, 염색한 천
bating : xprep, ...을 제외하고, 이외에
batiste : n, 얇은 무명
Batman : n, 베트맨(망토로 하늘을 나는 만화의 초인), 장교의 단번병
baton : n, 지휘봉, 지팡이, 경찰봉, 바통
baton twirler : x, 지휘봉 흔드는 사람
batpay : n, =BAT MONEY
Batrachia : n, 양서류(Amphibia)
Batrachian : n, a, 양서류(의)
batrachian : a, n, 꼬리업는 양서루의 동물
bats : a, 머리가 돈
batsman : n, 타자
battalion : n, 포병대대, 대부대, 육군, 대군
batteau : n, =BATEAU
battels : n, 식비, 학비
batten : vi, vt, 살찌게하다, 많이 먹다, 작은 절빤지, 마루청을 깔다
batter : n, vi, vt, 타자-연타하다, 처부수다, 포격하다-(우유, 달걀, 버터, 밀가루 등의)반죽
battered : a, 박살난, 오래 써서 낡은, (생활에)지쳐서 초라해진
battering ram : x, 파성용의 큰 망치
Battersea : n, 배터시(런던의 자치구의 하나)
battery : n, 구타, 포열, 한 벌의 기구, 전지
battik : n, =BATIK
batting : n, 타격, 배팅, 탄솜, 이불솜
battle : n, 전투, 싸움, 교전(특정 지역에서의 조직적이며 장기간에 걸친), (일반적으로)전쟁, 투쟁
battle array : x, 전투대형, 진용
battleaxe : x, 전투용 도끼, (중세의)
battle cruiser : x, 순양전함
battle cry : x, 함성, 표어, 슬로건
battled : a, 흉벽이 있는, 총안이 있는(cf, BATTLEMENT)
battled : a, 흉벽이 있는, 총안이 있는
battledore : n, 깃털 제기채, 빨래방망이(~and shuttlecock 깃털 제기치기)
battle dress : x, 전투복
battle fatigue : x, 전선에서 생기는 일종의 신경쇠약
battlefield : n, 싸움터, 전장
battlefront : n, 전선
battleground : n, 전쟁터
battle line : x, 전선
battlement : n, (총안이 있는)흉벽
battle piece : x, 전쟁화
battleplane : n, 전투기
battler : n, (오스)악전고투하는 사람, 낮은 생활 수준의 근로자, 매춘부
battleready : a, 전투준비가 된
battle royal : x, 난전, 대논전
battlescarred : a, 전상을 입은, (전함 등이)역전의 흔적을 보이는, 낡고 헌
battleship : n, 전함
battlewagon : n, 전함
battue : n, 몰이꾼, 몰살, 몰이 해낸 사냥감
batty : a, 박쥐같은, 머리가 돈
batwoman : n, BATMAN의 여성형
bauble : n, 지팡이, 값싸고 번지르르한 물건
baud : n, 컴퓨터 자료 처리의 속도 단위
Baudelaire : n, 보들레르 P, C, ~(1812-67)(프랑스의 시인, 비평가)
Bauhaus : n, Walter Gropius가 1919년 독일 Weimar에 창립한 건축, 조형학교
baulk : n, BALK
baulk : v, n, =balk
Baume : a, 보메 비중계의
bauxite : n, 보크사이드(알루미늄의 원광)
Bavaria : n, 바이에른, 바바리아(서독 남부의 주)
bavin : n, 섶나뭇단
bawbee : n, 반 페니
bawcock : n, 좋은 녀석
bawd : n, 창녀집의 포주
bawdily : ad, 음탕하게, 외설스럽게
bawdry : n, 외설(행위)
bawdy : a, 음탕한
bawdyhouse : n, 매음굴
bawl : vi, vt, n, 고함지르다, 호통치다
bay : n, 월계수, 월계관, 영예
bay : n, 만(gulf보다 작음), (바다, 호수의)내포, 후미, 산모통이, (참호 안의) 좀 넓은 곳, (기체 내의)격실
bay : n, vi, vt, 궁지, (사냥개의 길고도 굵은)짖는 소리, 쫓겨서 몰린 상태-짖다, 짖어대며 덤비다, 소리지르다
bay : n, 기둥과 기둥 사이의 우묵 들어간 벽면
bay : a, n, 밤색의(말)
bayadere : n, 가로줄 무늬 직물, (힌두교의)무희
Bayard : n, (중세 기사 이야기에 나오는)마력을 가진 말, (보통의)말, 구렁말, 남자 이름, 무용이 뛰어난 믿음직한 신사, 바야르(중세 기사의 귀감으로 일컬어진 프랑스인
bayberry : n, (북미산의)소귀나무의무리, (서인도산의)베이베리 나무(그 잎으로 bay  rum을 만듦)
Bayern : n, Bavaria의 독일명
Bayesian : a, (영국의 수학자 Thomas Bayes의 이름에서)베이스(의 정리)의
bay line : x, 대피선, 측선
bay line : x, 대피선, 측선
bayline : n, 특설선, 인입선, 측선
bayonet : n, (프랑스의 제작지명에서)총검, 무력, 총검무장병
bayonet : n, vt, 총검, 무력
bayou : n, 모양의 후미(미국 남부의 강, 호수, 만의)
bayou : n, 늪 같은 후미, 내포
bay rum : x, 베이럼, (머리기름)
bay rum : x, 베이럼(머릿 기름)
baysreath : n, 월계관
bay window : x, 퇴창, 내민 창
bay window : x, 퇴창, 내민 창
baywood : n, (멕시코산의)마호가니의 일종(가구용)
baywreath : n, 월계관
bazaar : n, 상점가, (동양의), 시장, 백화점, 특매장, 바자, 자선시
bazaari : n, 이란인 상인(상점주)
bazar : n, 상점가, 시장, 특매장
bazoo : n, (지껄이기 위한)입, 코, 허풍, 야유
bazooka : n, 바주카포(휴대용 대전차 로켓포)
bazookaman : n, 바주카 포병
B battery : x, B전지
bdellium : n, 베델리엄(수지, 보석 또는 진주일 것이라고 함, 창세기 2:12), 방향 수지(를 내는 나무)
be : v, 있다, 존재한다, 전면에, 아주
beach : n, vi, vt, 바닷가, 물가, 해변, 냇가, 호반, (해변의)모래, 조약돌(on the~ 영락하여-바닷가에 얹히다(얹히게 하다), 바닷가에 끌어올리다
beachcomber : n, 큰 파도, (부둣가의)부랑
beachhead : n, 상륙거점, 교두보
beachie : n, 바닷가 낚시꾼, 젊은 해변 부랑자
beachlamar : n, 사투리 영어, (남서태평양 제도에서 사용)
beachmaster : n, 상륙 지휘관
beachscape : n, 해변 풍경
beach umbrella : x, 비치 파라솔
beach waggon : x, =station waggon
beachwear : n, 해변복
beacon : n, vt, vi, 횃불, 봉화, 등대, 수로(항로)표지-봉화를 올리다, 봉화로 신호하다, (비추어(인도하다, 경고하다
beacon fire : x, 신호의 횃불
beaconry : n, 무선 표지의 제작, 이용에 관한 내용
bead : n, vt, vi, 구슬, 염주알, 염주, 로자리오(rosary), (이슬, 땀의)방울, 거품의
beaded : a, 구슬이 된, 구슬 같은(거품, 땀 등)구슬로 장식한
beadhouse : n, 구비원, 양로원
beading : n, 비즈, 비즈 세공(장식), 구슬선(장식)
beadle : n, 하급관리, (행렬 때) 대학 총장의 권표(nace)를 받드는 속관
beadroll : n, 명복(을 받는 자의)명부, (일반적으로)명부, 목록, 염주(rosary)
beadsman : n, 양육원(beadhouse)수용자
beadswoman : n, beadsman의 여성형
beadwork : n, 구슬세공, 염주알 장식, 구슬선
beady : a, 비즈 같은, 비즈로 장식한, 거품이 이는 (술 등)
beagle : n, (다리가 짧고 귀가 쳐진 토끼 사냥용의)작은 사냥개
beagling : n, 비글을 쓰는 토끼
beak : n, (맹조 따위의)부리, (거북, 낙지 따위의)주둥이, (주전자 따위의)귀때, (옛 전함의)격돌 함수, (매부리)코, 누조, 치안판사, 교사
beaked : a, 부리가 있는, 부리 비슷한
beaker : n, 비커, 굽달린 큰 잔
beaky : a, 부리 모양의
beall : n, 전체, 요체, 가장 중요한 것
beall and endall : x, 요점, 정수, 중요부
beam : n, vi, vt, 대들보, 도리, 가로들보, 선폭, (천칭의)대, (쟁기의)성에, 광선, 방향지시전파-발하다, 빛나다, 번쩍이다, 미소짓다
BEAM : n, (Brain Electrical Activity Mapping)빔(뇌파의 파형을 실제의 뇌의 활동을 나타내는 컬러 지도로 바꾸는 장치)
beamcast : vt, 지향 전송하다
beamed : a, 들보가 있는, 빛나는, (라디오)방송되는(된)
beamends : n, pl, 가로 들보의 끝, (사람이)진퇴양난이 되어
beaming : a, 빛나는, 기쁨에 넘친, 희색이 만면한, 밝은
beamish : a, =BEAMING
beamless : a, 들보가 없는, 빛을 내지 않는, 빛나지 않는
beam rider : x, 전자유도 미사일
beamwidth : n, 신호(레이더)전파의 방사 각도
beam wind : x, 바람
beamy : a, (배가)폭이 넓은, 광선을 방사하는, 빛나는, 환한, 즐거운, (수사슴이)가지뿔이 있는
bean : n, vt, (pea와 그별하여)(납작)콩, 하찮은 것, 사소한 일-(공으로) ...의 머리를 때리다
beanbag : n, 콩 따위를 헝겊으로 싼 공기
beanball : n, 빈볼, (고의로 타자의 머리를 겨눈 공)
bean cake : x, 콩깻묵
bean curd : x, 두부
beanery : n, 싼 음식점
beanfeast : n, 고용인에게 베푸는 잔치, 즐거운 잔치
beanfed : a, 콩으로 키워진, 원기 왕성한
beanhead : n, 바보, 멍텅구리
beanie : n, 빵모자
beano : n, =bingo=beanfeast
beanpod : n, 콩꼬투리
bean pole : x, 콩 줄기를 바치는 막대기
bean pole : x, 콩줄기를 받치는 막대기, 키다리
bean soup : x, 잠수 튜브
bean soup : x, 남두 수프
bean sprouts : x, 콩나물
beanstalk : n, 콩줄기
Beantowner : n, 보스턴 시민, 보스턴 사람
beany : a, 원기 왕성한
bear : n, vt, vi, 곰, 난폭자, 거동이 거친 사람-팔아치우다
bear : vt, vi, 나르다, 지니다, (이름 특징 따위를)가지다, 견디다, 받치다, ...하기에 족하다, 적합하다-지탱하다, 배겨내다, 덮치다, 쳤향을 주다
bearable : a, 견딜 수 있는, (추의, 더위 등이)견딜 만한
bearbaiting : n, (개를 덤비게 하는) 곰 놀리기
bearberry : n, 까막월귤, 덩굴덩귤
beard : n, vt, 수염, 미늘-수염을 잡다, 공공연히 반항하다
bearded : a, 수염(까락, 마늘)이 있는
beardie : n, (턱)수염을 기른 사람, 털보(등)
beardless : a, 까락이 없는, 수염이 없는(나지 않는), 풋내기의
bearer : n, 나르는 사람, 짐꾼, 지참인
bear garden : x, 곰사육장, 시끄러운 곳
bearhug : n, (힘찬)포옹
bearice : n, 베아트리체
bearing : n, 태도(manner), 거동(begavior), 관계, 관련
bearish : a, 곰 같은, 우락부락한, 약세의
bear leader : x, 가정교사
bearskin : n, 곰 가죽, (영국 근위병의)검은 털모자
Bear State : x, arkansas주의 딴 이름
beast : n, 짐승, 가축, 식용 소, 짐승 같은 놈
beastings : n, (암소의 산후의)초유
beastliness : n, 짐승 같은 짓, 불결, 부정, 추악, 더러움, 음탕, 구역질 나는 것(음식물 등)
beastly : a, ad, 짐승 같은, 잔인한, 더러운(dirty), 지겨운, 대단히
beat : vt, vi, n, (계속해서)치다, (달걀을)휘젓다, 박자를 맞추다, 지게 하다, 속이다, 면하다-연거푸 치다, (심장, 맥박이)뛰다-계속해서 치기, 순찰, 특종기사
beata : n, 복자(여성의)(cf, BEATUS)
beaten : v, a, beat의 과거 분사-두들겨 맞은, 두들겨 편, 밟아 다져진
beater : n, 때리는 사람, 몰이꾼(사냥의), 두들기는(휘젓는)기구
beat generation : x, 비트족
beatific : a, 축복을 주는, 행복에 넘친, 행복을 줄 수 있는
beatifically : ad, 기쁜듯이
beatification : n, 축복, 시복
beatify : vt, 축복하다, 시복하다
beating : n, 때림, 매질, 타파, 고동, 날개치기
beatitude : n, 지복, 팔복
Beatles : n, 비틀즈(영국의 록 그룹, 1962-70)
beatnik : n, 비트족의 사람
beatout : n, 내야 안타
Beatrice : n, 베아트리체(단테가 애인을 모델로 한 이상의 여성)
beatup : a, 낡은
beatus : n, 복자(BEATA)
beau : n, a, 멋장이, 구혼자, 애인, 아름다운, 좋은
beaucoup : ad, 매우, 크게
beaufort scale : x, 보퍼트 풍력계급
beau geste : x, 아름다운 행위
beau ideal : x, 미의 그치, 최고이 이상
Beau jolais : n, 프랑스산의 빨간(백)포도주
Beaujolais : n, 보졸레(와인)(프랑스 Beaujolais 지방산 적포도주)
beau monde : x, 사교계, 상류사회
Beaune : n, (Burgundy 산)적포도주
beaut : n, 몹시 아름다운 것, 굉장히 훌륭한 것, 미인
beaut : n, 고운, 멋진사람, 멋진것
beauteous : a, 아름다운(beautiful)
beautician : n, 미용사
beautifler : n, 미화하는 것, 화장품
beautiful : a, 아름다운, 훌륭한, 우수한
beautifully : ad, 아름답게, 훌륭히, 솜씨있게
beautify : vt, vi, 아름답게 하다, 아름다워지다
beautility : n, 미와 실용성(의 겸비), 기능미
beautirication : n, 미화, 장식
beautous : a, 아름다운
beauty : n, 아름다움, 미, 좋은 점, 미관, 아름다운 것, 미인, 아름다운 동물, 터무니 없는 것
beauty contest : x, 미인선발대회
beauty parlo(u)r : x, 미장원
beauty queen : x, 미인대회이 여왕
beauty sleep : x, 초저녁 잠
beauty spot : x, 명승지, 아름다운 경치, 애교점
beaux : n, beau의 복수
beaux arts : x, 미술
beaux yeux : x, 명모, 미모
beauyoir : n, 보부아르 Simone de ~(1908-86)(프랑스의 소설가, 평론가)
beaver : n, 비버, 해리, 비버 모피, 턱가리개
beaver board : x, 섬유로 만든 가벼운 널
beaverboard : n, 섬유로 만든 가벼운 널(건축 재료)
beaverteen : n, 비버 모피 비슷한 면빌로드
bebop : n, 재즈의 일종
becalm : vt, 잠잠하게 하다, 정지시키다
became : v, become의 과거
because : xconj, ad, 왜냐하면, 이므로, 하므로, 라는 이유로는 , 라고해서- ...때문에
beccafico : n, 휘파람새 비슷한 철새(이탈리아에서 식용함)
bechamel : n, 흰 소스의 일종
bechance : vi, vt, 우연히 일어나다
becharm : vt, 매혹하다(charm)
bechedemer : n, 해삼
beck : n, 손짓, 고갯짓(nod), (be at a person's~and call 아무가 시키는 대로 하다, have a person at ome's~ 아무를 마음대로 부리다)
becket : n, 다림줄, 밧줄
Becket : n, 베케트 Thomas a ~(1118-70) (영국 Canterbury의 대주교)
Beckett : n, 베케트 Samuel ~(1906- )(프랑스에 사는 아일랜드의 소설가, 극작가, Nobel 문학상(1969)
beckon : vi, vt, 손짓으로 부르다, 신호하다, 유인하다, 유혹하다
Becky : n, 여자 이름(Rebecca의 애칭)
beclasp : vt, (주위에서)꼭 죄다
becloud : vt, 흐리게하다, 애매하게하다
become : vi, vt, 되다-어울리다, 적합하다
becoming : a, 어울리는, 알맞은
becquerel : n, 침대, 동물의잠자리, 숙박
Becquerel rays : x, 베크렐선(방사선)
bed : n, vi, vt, 침대, 잠자리, 취침, 숙박, 강바닥-재우다, 자다, 화단에 심다, 고정시키다, 판판하게 놓다, 쌓아 올리다
bedabble : vt, (물을)튀기다, 튀겨 더럽히다
bedad : xint, =begad
bedash : vt, ...에 온통 뿌리다(치다), (비가)세차게 때리다, 산산이 부수다
bedaub : vt, 더덕더덕 칠하다, 지나치게 꾸미다
bedaze : vt, 현혹시키다, 어찌할 바를 모르게 하다
bedazzle : vt, 현혹하다, 매혹하다
bedazzlement : vt, 현혹하다, 매혹하다
bedbug : n, 빈대
bedchamber : n, 침실
bedchamber : n, =BEDROOM
bedclothes : n, pl, 침구, (덮는 것만)
bedding : n, 침구, 깃, 토대, 기반, 성층
bedeck : vt, 장식하다
bedell : n, 대학의 의전선도계
bedevil : vt, 귀신들리게 하다, 매혹하다, 괴롭히다
bedevilment : n, 귀신 들림, 광란, 고민
bedew : vt, 적시다, 눈물 흘리다
bedfast : a, =dedridden
bedfellow : n, 잠자리를 같이 하는 사람, 친구, 아내
Bedford cord : n, 코르덴비슷한 두꺼운 천
bedfordshire : n, 영국 중부의 주
Bedfore : n, 남자 이름, 잉글랜드 Bedfordshire주의 주도
bedgown : n, 잠옷(여성용)
bedhemoth : x, 큰짐승, 하마
bedhouse : n, 사창굴
bedight : vt, a, 꾸미다, 차려 입다, 꾸민, 장식된
bedim : vt, 흘리게 하다, 어슴프레하게 하다
bedimmed : a, 흐리게 한
bedin : n, 취침 항의(침대에 누워서 하는 항의), 취침 항의자
bedizen : vt, 꾸미다
bedkey : n, 침대용 렌치
bedlam : n, 정신병원, 큰소동, 혼란
bedlamite : n, 미친사람
bedlamp : n, 베드램프
bed linen : x, 시트와베갯잇
bedmaker : n, 침실 담당 하인(Oxford, Cambridge 대학의)
bedmate : n, 동침하는 사람, 아내, 남편
Bedouin : n, 베두인 사람(유목의 아랍 사람), 유랑민, 집시
bedpan : n, 변기, 환자용 변기
bedplate : n, 받침판, 받침대, 대
bedpost : n, 대, 받침판
bedraggle : vt, 질질 끌어적시다, 더럽히다
bedrail : n, 침대의 가로 널
bedrench : vt, 흠뻑 젖게 하다
bedrid : a, 자리 보전하고 있는
bedridden : a, 누워만 있는, 일어나지 못하는
bedrock : n, 기반, 암상, 기초, 바닥, 기본원리
bedroll : n, 휴대용 침구
bedroom : n, 침실
bedside : n, a, 배겟머리, 침대곁, 머리맡, 배겟머리의, 침대곁의
bedsit : vi, n, BED-SITTER에 살다, =BED-SITTINGROOM
bedsittingroom : n, 침실 겸 거실
bedsock : n, 침대용 두툼한 양말
bedsonia : n, 베드소니아(앵무병, 트라코마등의 병원이 되는 바이러스)
bedsore : n, (오래 병사에 누워 생기는)욕창
bedspace : n, (병원, 호텔의)침대 수
bedspread : n, 침대보
bedspring : n, 침대 스프링, 미사일의 레이다 안테나
bedstead : n, 침대, 침대의 뼈대
bedstraw : n, 갈퀴덩굴의 무리, 깔짚, 욧속의 짚
bedtick : n, 잇(베갯잇, 요잇)
bedtime : n, 잘 시간
bedward(s) : ad, 침대 쪽으로, 잠잘 무렵에
bedwetting : n, 잠결에 싸는 오줌
bedwetting : n, 자면서 오줌싸기
bedworthy : a, 성적 매력이 있는
bee : n, 꿀벌, 일꾼, (유회, 공동작업 따위를 위한)모임
beebread : n, 새끼꿀벌의 먹이(벌집에 모은 껑가루 반죽)
beech : n, 너도밤나무
beechen : a, 너도 밤나무(재목)의
beechnut : n, 너도밤나무의 열매
bee culture : x, 양봉
beeeater : n, =BEE BIRD
beef : n, vi, a, 쇠고기, 근육, 체력, 완력-불평을 하다, 건장한, 뚱뚱한
beefalo : n, 비팔로(들소와 축우의 잡종, 육우)
beefburger : n, 쇠고기 햄버거
beefcake : n, 남성의 근육미 사진
beefcakery : n, BEEFCAKE 사진술
beef cattle : x, 식육용 소
beef eater : x, 런던탑의 수위, 호위병
beefeater : n, 쇠고기를 먹는 사람, 영양이 좋은 사람, 영국왕의 호위병, 런던탑의 수위, 영국인
beefiness : n, 
beefish : a, n, (사람이)억센, 늠름한, (영국인이)쇠고기를 먹는, 저민 쇠고기와 다진 어육을 섞은 것(햄버거 용등)
beefless : a, 쇠고기가 없는, 쇠고기를 먹지 않는 (날)
beefsquad : n, (고용된)폭력단
beefsteak : n, 두껍게 저민 쇠고기점, 비프스테이크
beef tea : x, 진한 쇠고기 수프, 고깃국
beefwitted : a, 굼뜬, 둔한
beefy : a, 살찐, 근육이 발달한(muscular), 견고한, 둔한, 굼뜬
beehive : n, 꿀벌통, 사람이 붐비는 장소
Beehive State : x, Utah 주의 딴 이름
beehouse : n, 양봉장(apiary)
beekeeper : n, 양봉가
bee keeping : x, 양봉
beekeeping : n, 양봉(apiculture)
beeline : n, vi, 직선, 최단거리, 직행하다
beeliner : n, 자동 추진식 디젤 철도 차량, 좀 낮은 직구
Beelzebub : n, =devil
beemaster : n, 양봉가
been : v, be의 과거분사, 지금까지 줄곧 ...이다, 그때까지 ...이었다
beento : n, a, (서 아프리카에서)영국에서 생활한 (교육 받은)적이 있는 사람(의)
beep : n, vi, vt, 경적, 삑하는 소리, 발신음-울리다, 발신하다
beeper : n, 신호 발신 장치, 무인 비행기를 원격 조종하는 사람
beer : n, 맥주, 맥주같은, 얼근히 취한
beerage : n, (귀족이 된)양조업자, 맥주업계, 영국 귀족(계급)
beer bust : x, 맥주 파티, 최상급의 것
beer bust : x, 맥주파티
beer garden : x, 비어가든(옥외에서 청량 음료, 맥주 등을 파는 가게)
beer hall : x, 맥주홀
beerhouse : n, 비어홀
beer house : n, 맥주홀
beer knees : x, 월등히 좋은 것, 좋은 일
beermat : n, 비어매트(맥주잔 받침)
beeroholic : a, n, 맥주 중독의 (사람)
beerpull : n, beer pump의 레버
Beersheba : n, 브엘세바(Israel 의 도시)
beershop : n, (가게 안에서는 마시지 못하는)맥주 판매점
beerup : n, 술잔치, 주연
beery : a, 맥주의(같은), 맥주에 취한
beestings : n, (새끼는 낳는 암소의)초유
beeswax : n, vt, 밀, 밀랍, 밀랍을 바르다
beeswing : n, 묵은 포도주, 그 위의 얇은 더껑이
beet : n, 비트, (근대, 사탕무우 따위)
Beethoven : n, 베토벤, (독일의 작곡가)
beetlbrowed : a, 눈썹이 굵은, 뚱한
beetle : n, vt, a, vi, 갑충, 딱정벌레, 근시인 사람, 큰 망치, 메, 공이, 방망이, (메, 공이로)치다, 돌출한, 상을 찌푸린, 뚱한, 돌출하다
beetlebrain : n, =BEETLEHEAD
beetlecrusher : n, 큰 발(구두)
beetlehead : n, 바보
beetleheaded : a, 미련한
beetling : a, 불거진, (벼랑, 눈썹따위)
beetradish : n, =RED BEET
beetroot : n, 사탕무우 뿌리(샐러드 용)
beet sugar : x, 사탕무우설탕
beeves : n, beer의(식용 소) 복수
beezer : n, 코, 사람, 녀석
bef : x, 영국해외파병군
befall : vt, vi, 일어나다, 재난이 닥치다
befallen : v, BEEFALL의 과거분사
befell : v, BEEFALL의 과거
befit : vt, 어울리다, 적합하다, 알맞다, 어울리다
befitting : a, 적당한, 어울리는, 알맞은(proper)
beflag : vt, 많은 기로 장식하다
beflower : vt, 꽃으로 뒤덮다..., 에 꽃을 흩뿌리다
befog : vt, 안개로 덮다, 얼떨떨하게 하다, 모호하게하다
befool : vt, 놀리다, 우롱하다
before : xprep, ad, conj, 쪽에-(쪽)에, 이전에- ...보다 이전에
beforehand : ad, 전부터, 미리, 서다, 대비하다, 예기하다
beforementioned : a, 전술한
beforetax : a, 세금이 포함된
beforetime : ad, 이전에는, 옛날에
befoul : vt, 더럽히다, 부정세금이 포함된
befriend : vt, 친구가 되다, 돕다
befuddle : vt, 정신을 잃게 하다, 어리둥절하게 하다
befurred : a, 모피 장식을 단
beg : vi, vt, 빌다, 구걸하다, 빌어먹다, 발을들고서다
begad : xint, 맹세코
began : v, BEGIN의 과거
begat : v, BEGET의 과거
begats : n, (구약 성서 중의)가계도, 자식, 자손
beget : vt, 돌보다, 낳다, 생기다
begetter : n, 낳는 사람(특히 아버지)
beggar : n, vt, 거지, 가난뱅이, 악한-거지로 만들다, 가난하게 하다, 무력하게 하다
beggar(s)lice : n, 옷에 열매가 달라붙는 식물(쇠무지기, 뱀도랏 따위)
beggardom : n, 거지 생활, 거지 패거리
beggarliness : n, 빈궁, 빈약
beggarly : a, 거지 같은, 가난한, 얼마 안되는, 빈약한, 비천한
beggarmyneighbor : n, a, 상대편의 패를 전부 뺏을 때까지 둘이 하는 놀이, 남의 손실로 이익을 얻는, 지기 중심적인, 보호주의적인(정책)
beggarthyneighbor : n, a, =BEGGARMYNEIGHBOR, 요즘에는 beggaryourneighbor로도 씀
beggarticks : n, pl, 서양도깨비바늘(미국 원산, 국화과, =BEGGARLICE
beggary : n, 극빈, 거지 생활, 패거리
begging : n, a, 구걸, 거지 생활, 구걸하는
begin : vi, vt, 시작하다, 시작되다, 착수하다
beginner : n, 초학자, 초심자, 창시자
beginning : n, 시작, 개시, 처음, 발단
begird : vt, 띠로 감다, 두르다, 둘러싸다
begirt : a, 둘러싸인
begohm : n, 10억옴, (저항의 단위)
begone : xint, 가라
begonia : n, 베고니아, 추해당
begorra : xint, (아일)어럽쇼!, 이런!, 맹세코, 반드시(by God의 변형)
begot : v, beget의과거
begotten : v, beget의과거분사
begrime : vt, 더럽히다
begrudge : vt, 아까워하다, 시기하다
begrudgingly : ad, 마지못해, 아까운 듯이, 인색하게
beguile : vt, 기만하다, 사취하다, 즐겁게하다, 지루함을 잊게 하다
beguilement : n, 기만, 속임, 기분전환 거리, 심심풀이가 되는 것
beguiler : n, 속이는 사람, 심심풀이
beguiling : a, 속이는, 기분을 전환시키는
beguine : n, 비긴, (서인도제도Martinique 섬 토인의 춤), 비긴풍의 댄스(곡)
Beguine : n, 베긴회 여자 신자(12세기 벨기에에서 창설)
begum : n, 여왕, 공주(인도 회교도의 )
begun : v, bigin의 과거분사
behalf : n, 이익, 위하여
behave : vt, vi, 처신하다, 행동하다, 올바르게 행동하다
behaved : a, (보통 복합어를 이루어)...한 태도의, 행동거지가 ...한
behavio(u)r pattern : x, 행동양식
behavior : n, 행실, 행동, 태도, 상태, 행동주의
behavioral : a, 행동의, 행동에 관한
behaviorism : n, 행동주의
behavioristic : a, 행동주의 적인
behcets syndrome : x, 베이쳇병(눈, 입의 점막, 음부에 병이 생김)
behead : vt, 목을 베다
beheld : v, behold의 과거(분사)
behemoth : n, 큰짐승(하마인듯)
behest : n, 명령
behind : ad, prep, 뒤에, 뒤로, 나중에, 나중-...의 나중에, ...에 늦어서
behindhand : ad, a, 늦어, 늦게되어, 밀려(in, with)
behindthescenes : a, 공개안된, 비밀리의, 흑막의(~conference 비밀 회담
behold : vi, vt, 보다
beholden : a, 은혜를 입고 있는
beholder : n, 보는 사람, 구경꾼(spectator)
behoof : n, 이익, 아무를 위하여
behoove : vt, 당연하다, 의무이다
Behring : n, 베링 Emil (Adolf) von ~(1854-1917)(독일의 세균학자, Nobel 의학상 수상(1901))
beige : a, n, 원모로 짠 나사, 밝은 회갈색
Beijing : n, =PEKING
bein : n, 히피족의 모임, 우연히 모이는 일
being : v, n, be의 현재 분사-존재, 실재, 생존, 생물, 사람, 본질
beingforitself : n, (Hegel의)향자존성
Beirut : n, 레바논의 수도
Beja : n, 베지족(Nile강과 홍해 사이에서 사는 유목 민족), 베자족의 사람, 베자 말
bejabbers : ad, 이런!, 어머나!, 제기랄!, 맙소사!(놀람, 두려움, 기쁨, 노여움 등), 반드시, 꼭
bejan : n, 신입생
bejaune : n, 신입생, 대학 신입생
bejeaned : a, 청바지를 입은
bejesus : xint, n, =BEJABBERS
bejewel : vt, 보석으로 장식하다
beke : n, 백인 이민 생활자(보통 상류 계급, 프랑스계)코레올(Creole말))
bel : n, 벨, (전압, 전류나 소리의 강도의 단위)
belabor : vt, 세게치다, 때리다, 욕설하다, 호통치다
belated : a, 늦은, 뒤늦은, 시대에 뒤진, 길이 저문
belaud : vt, 격찬하다
belay : vt, vi, 밧줄을 감아 매다
belaying pin : x, 밧줄걸이
bel canto : x, 벨칸토창법
belch : vt, 트림하다, 내뿜다, 분출하다, 퍼붓다
belcher : n, 얼룩얼룩 물들인 목도리
beldame : n, 할멈, 변덕스러운 노파, 고약한 노파
beleaguer : vt, 포위하다, 둘러싸다, 괴롭히다
belemnite : n, 전석(오징어류의 화석)
Belfast : n, 북아일랜드의 수도
belfry : n, 종루
belga : n, 벨가(벨기에의 화폐 단위, =5벨기에 프랑)
Belgian : a, n, 벨기에 (사람)의, 벨기에 사람
Belgic : a, 벨기에 (사람)의, 고대 벨가에족(Belgae)의
Belgium : n, a, 벨기에
Belgo : n, 벨기에
Belgrade : n, 벨그라드, (유고슬라비아의 수도)
Belgravia : n, 런던부근의 상류주택지역
Belial : n, 사탄, 악마
belie : vt, 속이다, 왜곡하여 전하다, 희망에 어긋나다, 어기다, 배반하다, 일치하지 않는다
belief : n, 믿음, 신념, 생각, 신앙, 신용
believable : a, 믿을 수 있는, 신용할 수 있는
believe : vi, vt, 믿다, 신용하다, 신앙하다, 생각하다
believer : n, 신자
believing : n, a, 빈음, 보는(직접 경험하는)것보다 확실한 것은 없다, 백문이 불여 일견, 믿음이 있는
beligerent : a, n, 교전중의, 교전국의, 호전적인, 교전국, 교전자
belike : ad, 아마
Belinda : n, 여자 이름(애칭 Linda)
belisha beacon : x, (황색의)횡단로 표지
belittle : vt, 얕보다, 헐뜯다, 작게하다, 작아 보이게하다
belittlement : n, 얕봄, 흠잡아 봄
Belize : n, 벨리즈, 중미 카리브해에 면한 나라(옛이름 British Honduras, 수도 Belmopan), 1의 옛 수도, 항구 도시
Belizean : n, 
bell : n, 종, 벨, 방울, 초인종, 종소리, 종 모양의 꽃, (해파리의)갓
Bell : n, 벨 Alexander Graham~ (1847-1922)(전화를 발명한 미국 사람)
bell : n, vi, vt, 종, 방울, 초인종, 종소리, 수사슴 울음소리
Bella : n, 여자 이름(Isabella의 명칭)
belladonna : n, 벨라도나(유독식물)
Bellatrix : n, 벨라트릭스(Orion자리의	    성)
bellbird : n, 방울새(종소리 비슷하게 우는 새의 총칭, 특히 중, 남미산)
bellbottom : a, 바지 가랑이가 넓은, 판탈롱의
bellbottoma : n, 나팔 바지, 판탈롱
bellboy : n, 급사, 보이
bell buoy : x, 타종 부표, (파도에 흔들리어 울림)
bell captain : x, 급사장, (호텔의 급사장)
belle : n, 미인, 예쁜소녀
belleslettres : n, pl, 순문학
belletistic : a 순문학적인
belletrist : n, 순문학자
bellflower : n, 초롱꽃
bell founder : x, 종 만드는 사람
bell garham : x, 미국의 과학자
bellgerence : n, 교전, 전쟁(행위), 호전성, 투쟁성
bell glass : x, 종 모양의 유리 그릇
bellhop : n, =BELLBOY
bellicism : n, 호전성, 투쟁적 성격(태도)
bellicose : a, 호전적인
bellicosity : n, 호전성
bellied : a, 배(복부)가 ...한, 팽창한, 부푼
belligerency : n, 호전성, 교전
belligerent : a, n, 교전중의, 교전국의, 호전적인-교전국, 교전자
belllike : a, 종 모양의, 종소리를 닮은
bellman : n, 종치는 사람(어떤 일을 동네에) 알리고 다니는 사람
bell metal : x, 종청동
bellmouthed : a, (그릇 등이)종 모양의 아가리를 가진
bellona : n, 전쟁의 여신, 키가 큰 미인
bellow : vi, vt, n, 울다, 고함을 지르다-(황소의)우는 소리, 노한 목소리
bellows : n, sing, pl, 풀무, (사진기의)주름상자, 폐
bellpull : n, 종치는 줄, 설렁줄
bellshaped : a, 종(벨)모양의
bell tower : x, 종루
bellwether : n, 방울 달린 양, 선도자
bellwort : n, 초롱꽃속의 식물
belly : n, vi, vt, 배, 복부, 위, 식욕, 태내, 자궁-부풀게하다
bellyache : n, vi, 복통, 불평을 말하다
bellyband : n, 뱃대끈(마구)
bellybutton : n, 배꼽
bellyflop : n, vi, 배로 수면을 치면서 뛰어들기
bellyful : n, 배 가득, 만복, 충분
bellygod : n, 대식가
bellyhold : n, (비행기의)객실 아래의 화물실
bellyland : vi, 동체착륙하다
belly landing : x, 동체 착륙
belly laugh : x, 웃음거리, 홍소
bellyup : a, 뻗다, 죽다, 무너지다
bellywash : n, 음료(맥주, 커피 등)
belong : vi, ...에속하다, ...의 것이다
belonging : n, pl, 재산, 소지품, 성질, 재능
belongingness : n, 소속성(개인의 집단에 의한)
Belorussia : n, =BYELORUSSIA
beloved : a, n, 가장 사랑하는, 소중한-가장 사랑하는 사람, 애인, 남편, 아내
below : ad, prep, 아래에, 아래로, 하위(하류)에, 후단에- ...의 아래에, ...의 하위(아래쪽, 하류)에, ...보다 못하여, ...의 가치가 없어
belowdecks : ad, 선실로, 배안에
belowstairs : ad, a, 아래층에(의)
belowtheline : ad, a, 특별 회계로
Belshazzar : n, 벨사살(고대 바빌로니아 제국 마지막 왕, 다니엘 5)
belt : n, vt, 띠, 혁대, 지방, 해협- ...에 띠를 두르다- ...에 띠를 두르다, (혁대로)때리다
Beltane : n, 벨테인 축제(고대 켈트족의 May Day축제)
belt conveyor : x, 벨트콘베이어
belted : a, 벨트를 단, 띠(예대)를 두른, 장갑한, 줄무늬가 있는
beltedbias tire : x, 바이어스 타이어(안이 가로 무늬 직조로 된)
belter : n, 뛰어난 것(사람)
belt highway : x, 순환도로
belting : n, 벨트 재료, (집합적)벨트류, 벨트(장치), (가죽 끈 등으로)때리기
belt line : x, 순환선
beltline : n, 허릿매, 허리통
belttighten : vi, 긴축 정책을 펴다
belt tightening : x, 긴축정책, 내핍생활
beltway : n, 순환도로
beluga : n, 흰돌고래, 흰철갑상어
belvedere : n, 전망대
belying : v, BELIE의 현재 분사
bema : n, (고대 그리스, 로마의)연단(platform), (동방 교회의)성단소(chancel)(성직자, 성가 대석이 있음)
bemaul : vt, 혼을 내다, 경치게 하다
bemazed : a, 망연한, 어리둥절한(bewildered)
Bemberg : n, 벰베르크(인조견의 일종)
bemean : vt, 저하시키다, 인격, 품성 등을 떨어뜨리다
bemedaled : a, 훈장(메달)을 단(받은)
bemegride : n, 베메그리드(바르비투르산염 중독자용 흥분제)
bemire : vt, 진흙투성이로 만들다
bemoan : vt, vi, 비탄하다
bemock : vt, 비웃다
bemuse : vt, 멍하게 하다
bemused : a, 멍한, 어리벙벙한
Ben : x, benjamin
benab : n, 가이아나 원주민의 오두막
Benadryl : n, 베나드릴, (두드러기, 알레르기성 질환용)
Benares : n, 베나레스(동부 인도에 있는 힌두교의 옛 성도, 현재는 Varanasi)
bench : n, vt, 벤치, 진열대, 판사석, 재판소- ...에 벤치를 놓다, 지위에 앉히다, 퇴장시키다
bencher : n, 벤치에 앉은 사람, 법학원(the inns lf Court)
bench jockey : x, 벤치에서 상대팀을 야유하는 선수
benchmade : a, (목공품, 구두가)손으로 만든, 맞춤의
benchmark : n, vt, 수준 기표(고저 측량의 표고의 기준이 됨), 기준, (측정을 위한)기준점, 벤치마크(여러가지 컴퓨터의 성는을 비교, 평가하기 위해 쓰이는 표준 문제), (컴퓨터 시스템 등을)벤치마크 문제로 테스트 하다
bench show : x, 개 품평회
bench warmer : x, 보결선수
bench warrant : x, 구속영장
benchwork : n, (기계 작업에 대하여)앉아서 하는 작업, 좌업, 마무리 손질
bend : xbent, vi, n, 구부리다, 당기다, 굴복시키다, 기울이다, 주시하다-굽다, 굽히다, 굴복하다, 힘을 쏟다-굽이, 굴곡(부), 경향, 결삭
bendable : a, 구부릴 수 있는
benday : a, vt, 벤데이법의, 벤데이법으로 제판하다
bended : a, 무릎을 꿇고, 애원하며
bender : n, 구부리는 사람(도구), 뻬찌, 커브, 옛 6펜스 은화, 다리(leg), 무릎, 흥청거림
bendleather : n, 벤드 가죽(구두 밑창용 단단한 가죽)
bend sinister : x, 좌경평행선, (서출의 표)
bendwise : a, 우상부(마주보아 좌상부)에서 좌하부(마주보아 우하부)를 향해 비스듬히 표시한
bendy : a, 마음대로 구부릴 수 있는, 유연한, (길 등이)꼬불꼬불한
beneath : ad, prep, 아래쪽에, 못하여, 어울리지 않는, 가치조차 없는
benedicite : n, int, 만물의 송, 그 악곡, 축복의 기도-그대(나, 우리들)에게 천복 있기를
benedick : n, 새신랑, 기혼 남자
benedict : n, 베네딕트회를창시한이탈리아의수도사
Benedictine : a, n, 베네딕트회의-베네딕트회의 수사
benediction : n, 축복, 축도, 감사의 기도, 성체 강복식
benedictive : a, (동사가)소원의, 원망의
benedictory : a, 축복의
Benedictus : n, 라틴어찬송가의 하나
benefactor : n, 은인, 후원자, 보호자, 기증자
benefction : n, 은혜, 자선, 선행
benefic : a, 선행을 하는
benefice : n, 목사록, 성직록
beneficed : a, 성직록을 지급받는
beneficence : n, 선행, 친절, 시여물
beneficent : a, 인정많은, 자선을 베푸는
beneficial : a, 유익, 유리한
beneficiary : n, 은혜를 받는 사람, 수익자, 수취인
beneficiate : vt, 정련하다, (원료, 광석등을 정련함)
beneficiation : n, 선광(처리)
benefit : n, vi, vt, 이익, 은혜, 은전, 기부금, 희사, 자선 흥행-이익을 주다, 도움을 받다(profit)
benefit society : x, 공제조합
Benelux : n, 베네룩스 3국(경제 협정(1948)을 맺고 있는 Belgium, the Netherlands, Luxembourg의 총칭)
benevolence : n, 자비심, 인정, 덕행, 자선
benevolent : a, 자비스러운, 친절한
Bengal : n, 벵골(본래 인도 중부의 주), 벵골비단(견모 교직)
Bengalee : n, a, 벵골의, 벵골사람, 말
bengalese : n, a, 벵골사람
Bengali : a, n, 벵골말의, Bengal의, 벵골 사람, 방글라데시아 사람, (근대)벵골 말
bengaline : n, 벵갈린(견사, 레이온 등과 양모 또는 무명과의 교직)
benighted : a, 길이저문, 무지한, 미개의
benign : a, 인정많은, 친절한, 온화한, 양서의
benignancy : n, 자애 깊음, 인자, 온화
benignant : a, 인정많은, 인자한, 유익한
benignity : n, 친절, 자비, 온화
Benin : n, 아프리카서부의공화국(1975년 Dahomey를 개칭)
benison : n, 축복
Benjamin : n, 막내아들, 막내, 귀동이, 이스라엘12지파의하나
Benjy : n, 남자 이름(Benjamin의 애칭)
Benlate : n, 벤레이트(살균용 농약, 상표명)
benne : n, 깨
bennet : n, 뱀우무의일종
bennett : n, 남자 이름, 베넷 Enoch Arnole ~(1867-1931)(영국의 소설가)
ben nevis : x, 스콜렌드서쪽에있는산, (영국의 최고봉)
Ben Nevis : x, 스코틀랜드 서쪽에 있는 산(영국의 최고봉)
benny : n, benze drine정제
benomyl : n, 베노밀(살균제)
bent : v, a, n, 굽은, 허리가 굽은, 마음을 기울인, 열심인, 기호, 경향, 성벽
bent : n, 겨이삭속 또는 그와 비슷한 포아풀과의 잡초, 그 줄기, 황야, 초원(moor)
bentham : n, 영국 철학자, 법학자
benthic : a, 심해저의, 심해저에 사는
benthos : n, 바다생물
benthoscope : n, 해저 조사용 강구
bentonite : n, 벤토나이트, (화산재의 분해로 된 점토)
bentonitic : a, 
ben trovato : x, 교묘한, 그럴듯한
bentrovato : ad, 교묘한, 그럴 듯한
bentwood : a, 나무를휘어만든, (의자 따위)
benumb : vt, 감각을잃게하다, 마비시키다, 저리게하다
benumbed : a, 감각을 잃은
Benz : n, 벤츠(서독제 자동차명)
benz : n, 서독제자동차명
benzedrine : n, 각성제상표명
benzene : n, 벤젠
benzine : n, 벤진, 가솔린(benzene과 구별하기 위하여 benzoline이라고도 함)
benzoate : n, 안식향산염
benzocaine : n, 벤조카인(결정성 분말, 국부 마취제)
benzodiazepine : n, 벤조디아제핀(정신 안정제용)
benzoic : a, 안식향의
benzoin : n, 안식향
benzoin : n, 안식향, 벤조인 수지(방향성 수지, 약제, 식품 방부용)
benzol : n, 조제벤젠
benzopyrene : n, 벤조피렌(콜타르에 함유된 발암 물질)
benzyl : n, 벤질
Beowulf : n, 베어울프(8세기 초의 고대 영어로 된 서사시, 그 주인공)
bepaint : vt, ...에 칠하다, 색칠하다
beplaster : vt, 회반죽을 바르다..., 에 두껍게 (남김없이)바르다
bepo : n, 영국의 원자 실험로
bepowder : vt, 가루를 뿌리다, 분을 진하게 바르다
bepraise : vt, 국구 칭찬하다
bequeath : vt, 남기다, 전하다, (재산을)유증하다
bequest : n, 유증, 유산, 유물
berate : vt, 꾸짖다, 야단치다
Berber : n, a, 베르베르 사람(북아프리카 산지의 한 종족), 베르베르 말, 베르베르 사람(말)의
berberry : n, =BARBERRY
berceuse : a, n, 자장가
bere : n, 보리의일종
bereave : vt, 빼앗다(deprive)(be~d lf one, s mother 어머니를 여의다/be bereft of hope 히망을 잃다)
bereaved : n, (가족, 근친의)죽음을 당한, 유족, 사별한 사람(들)
bereavement : n, 사별
bereft : v, bereave의과거(be utterly~어찌할 바를 모르고  있다
Berenice : n, 베레니케(고대 이집트의 왕비, 그 머리털은 성좌가 되었음)
beret : n, 베레모, 베레형 군모(a green~ 특전 부대원)
berg : n, 빙산
bergamot : n, 베르가모토, (귤의 일종), 그 껍질에서 채위하는 항유
bergschrund : n, 빙하의갈라진데, (균열)
Bergson : n, 베르그송, (프랑스의 철학자)
Bergsonian : n, a, 베르그송 철학(의), 베르그송 철학도
Bergsonism : n, 베르그송 철학
berhyme : vt, 시로짓다
beribboned : a, 리본으로장식한
beriberi : n, 각기
Bering : n, 베링 Vitus ~(1680-1741)(덴마크의 항해가, 베링 해협 발견)
bering sea : x, 베링해
bering sttrait : x, 베링해협
berk : n, 얼간이, 지겨운 놈
Berkeleian : a, n, 바클리(철학)의, 바클리 철학도
Berkeley : n, 바클리(미국 캘리포니아주의 도시), 바클리 George~(1685-1753)(아일랜드의 철학자, 성직자)
berkelium : n, 버클륨(방사성 원소, 기호 Bk, 번호 97)
berkelium : n, 베르켈륨, (알파 방사성 원소)
Berkshire : n, 잉글랜드남부의주, 버크셔종의 돼지
Berlin : n, 베를린(본래 독일의 수도), (=~wool질이 좋은 가는 털실)
Berliner : n, 베를린 시민
Berlioz : n, 프랑스의 작곡가
berm : n, 벼랑길, 둑의 물매턱, 포장 안 된 길섶(shoulder)
Bermuda : n, 대서양의 영령군도
Bernard : n, 3인의 프랑스 성자의 이름, 스위스의 알프스 산중의 고개의 이름, (성베르나르 고개의)구명견
Bernardine : a, n, 성베르나르도(St, Bernard)의, 베르나르도(시토)교단의, 시토회 수도사
berne : n, 베른(스위스의 수도)
bernoulli's principle : x, 베르누이의 정리
beroul : vt, 더럽히다, 부정하게 하다, 헐뜯다
berretta : n, =BIRETTA
berried : a, 장과를 뱅는, 장과 모양의, (새우 등이)알을 밴
berry : n, vi, 열매, 딸기의 열매, 커피의 열매, 물고기의 알-열매가 열리다, 열매를 따다
bersagliere : n, (이탈리아의)저격병
berserk : a, ad, 광포한, 사납게
berserker : n, 사나운 전사, 폭한
Bert : n, 남자 이름(Albert, Bertram, Gilbert, Herbert 의 애칭)
berth : n, vi, vt, (선박, 기차의)침대, 정박지, 숙소, 지위, 직업-정박하다, 정박시키다
bertha : n, (여자 옷의)장식깃
Bertha : n, 여자 이름(애칭 Bertie), =BIG BERTHA
berthage : n, 정박 구역, 정박 설비, 정박세
berthing : n, (배의)정박, 계선 위치, 침대 설비, 현장
Bertie : n, 여자 이름(Bertha의 애칭), 남자 이름(Herbert등의 애칭)
Bertillon system : x, 베르티용식 범인식별법(지문을 중시)
Bertram : n, 남자 이름
Bertrand : n, 남자 이름
Berty : n, =BERTIE
Berwick : n, 베릭(스코틀랜드 남동부의 주)
beryl : n, 녹주석, 연한 청색
berylline : a, 녹주석의, 연한 청록색의
beryllium : n, 베릴륨, (금속원소의 하나)
bescreen : vt, 덮어서 숨기다
beseech : vt, 간청하다, 탄원하다
beseeching : a, 간청(탄원)하는
beseechingly : ad, 탄원 하듯이
beseem : vt, 어울리다, 적당하다
beset : vt, 둘러싸다, 방해하다, 공격하다, 괴롭히다, 꾸미다, 범하기 쉬운, 빠지기 쉬운
besetting : a, 범하기(빠지기)쉬운(죄 나쁜 버릇, 유혹 따위)
beshawled : a, 숄을 두른
beshrew : vt, 저주하다
beside : xprep, 곁에, 비교하여, 떨어져서, 벗어나서
besides : ad, prep, 그위에, 게다가-더하여, 제외하고(execpt)
besiege : vt, 포위하다, (질물, 요구 따위로)몰아세우다
besiegement : n, 포위(공격)
besieger : n, 포위자, 포위군
beslaver : vt, 군침투성이가되게하다, 지나치게 아첨하다
beslobber : vt, 마구 키스하다
besmear : vt, 뒤바르다
besmirch : vt, 더럽히다, 때묻히다
besom : n, 마당비, 금작화(broom), 닳고닳은 여자
besot : vt, 곤드레만드레로 취하게 하다(intoxicate), 멍(열중)하게 만들다
besotted : a, 정신못가누게된, 취해버린
besought : v, beseech의과거
bespake : v, bespeak의 과거
bespangle : vt, 금박으로장식하다, 은박으로 장식하다, 번쩍거리게 하다
bespatter : vt, 튀기다, 더럽히다, 욕설하다(slander)
bespeak : vt, 예약하다, 주문하다, 입증하다, 나타내다, 예시하다, 말을 걸다
bespeckle : vt, ...에 반점을 찍다
bespectacled : a, 안경을낀
bespoke : v, bespeak의 과거분사
bespoken : v, bespeak의 과거분사
bespot : vt, ...에 반점을 찍다, 오점을 찍다
bespread : vt, 펼치다, 덮다
besprent : a, 흩뿌려진
besprinkle : vt, 흩뿌리다, 살포하다
Bess : n, 여자 이름(Elizabeth 의 애칭)
Bessemer : n, 베세머 Sir Henry ~(1813-98)(영국의 기술자, 베세머 제강법 발명자)
bessemer steel : x, 베세머강(Bessemer의 전로로 만들어 낸 강철)
Bessie : n, 여자 이름(Elizabeth의 애칭)
best : a, ad, n, vt, 가장좋은, 최상의-최량, 최선, 전력-가장 잘, 제일- ...에게 이기다
best : vt, vi, n, 치다, 매질하다, 지게하다, 연거푸 치다, 때리다, 뛰다, 치는 소리, 박자, 고동소리
bestar : vt, 별로 꾸미다, 별로 온통 뒤덮다
bestball : a, 두사람(이상)이 팀을 짜서 각 홀의 베스트스코어를 그 팀의 스코어로 하는 방식의
bestcase : a, 최고 조건(상태)의
bestead : vt, a, ...에 도움이 되다, 원조하다, (어떤)처지에 있는
bested : vt, vi, 돕다, 소용에 닿다
bestefforts : a, 최선의 노력을 한다는 조건의 (발행 인수)
bestial : a, 짐승같은, 무도한, 비열한
bestiality : n, 수성, 짐승같은 행위(욕심), 수간
bestialize : vt, 짐승 같이 되게 하다, 금수화하다(brutalize)
bestiary : n, (중세의)동물우화집
bestir : vt, 분기시키다
bestknown : a, 가장유명한
best man : x, 최적임자, 신랑 들러리
best man : x, 최적임자, 신랑 들러라(groomsman)
bestoffive : a, (스포츠)(야구 등에서)5판 3승 승부의
bestofseven : a, (스포츠)(야구 등에서)7판 4승 승부의
bestow : vi, 주다, 수여하다, 쓰다, 간직하여 두다, 숙박시키다
bestowal : n, 증여, 수여, 처치, 저장
bestraddle : vt, =BESTRIDE
bestrad dle : vt, -BESTRLKE
bestrew : vt, (표면에)살포하다, 뒤덮다..., 에 산재하다
bestridden : vt, 흩뿌리다
bestride : vt, (말, 의자 등에)걸터 앉다, 걸터 타다, 건너 넘다, (무지개 등이 벌판에)걸리다
bestride : vt, 걸터타다, 가랑이를 벌리고 건너 뛰다
bestrode : v, bestride의 과거
bestseller : x, 베스트셀러(일정 기간에 가장 많이 팔린 책, 레코드), 그 저자
bestsellerdom : n, 베스트셀러
bestselling : a, 베스트셀러의
bestud : vt, 표면을 장식 못으로 온통 박다, 점재 시키다(dot)
bet : n, vi, 내기, 건돈-(bet, betted)내기를 하다, 걸다
beta : n, 베타(그리스어 알파벳의 둘째 자)
betaine : n, 베타인
betake : vt, 가다, 호소하다, 의지하다, 착수하다
betaken : vt, betake의 과거분사
beta minus : x, 2류의하, 2류보다 좀 못한
beta particle : x, 베타입자
beta rays : x, 베타선
beta rhythm : x, 베타리듬(매초 10이상의 뇌파의 백동)
betatron : n, 베타트론(저자 가속 장치)
betel : n, 구장, (후추과의 나무, 인도 사람은 그 잎에 ~nut를 싸서 씹음))
Betelgeuse : n, 오리온자리중의적색일등성
betel nut : x, 빈랑나무의 열매
betel palm : x, 빈랑나무
bete noire : x, 무서운것, 질색인 것
beth : n, 베트(헤브라이 말 알파벳의 둘째자)
Beth : n, 여자 이름(Elizabeth의 애칭)
Bethany : n, 베다니(Palestine의 마을, 예수가 나사로를 죽음에서 소생기킨 곳)
bethel : n, 수상교회, 비 국교도 예배당
bethink : vt, 생각하다, 숙고하다, 생각해내다
Bethlehem : n, 베들레헴, (예수의 탄생지)
bethought : v, bethink의 과거분사
betide : vt, vi, 발생하다, 닥치다, 생기다
betimes : ad, 일찍
betise : n, 우둔, 어리석음, 어리석은 짓(말), 사소한 일
betoken : vt, 보이다, 나타내다, 전조이다, 예시하다
betony : n, 석잠풀속의 일종
betook : v, betake의 과거
betray : vt, 배반하다, 저버리다, 유괴하다, 누설하다, 나타내다
betrayal : n, 배반, 배신
betrayal : n, 매국노(traitor), 배신자, 배반자, 밀고(내통)자, 유혹자
betroth : vt, 약혼하다, 약혼
betrothal : n, 약혼
betrothed : a, 약혼자의, 약혼한(engaged)
Betsy : n, 여자 이름(Elizabeth의 애칭)
better : a, n, ad, vi, vt, 더좋은-더 좋은 것, 손윗 사람, 선배-더좋게더욱, 오히려-개선하다, ...보다 낫다
better : n, 내기하는 사람
betterment : n, 개선
bettermost : a, 가장 좋은, 태반의
betteroff : a, 부유한
betting : n, 내기
bettor : n, 내기(걸기)하는 사람
Betty : n, 여자 이름(Elizabeth의 애칭)
between : xprep, ad, (두 물건의)사이에, 중간으로, 사이를
between decks : x, 중창, (두 갑판 사이의 부분)
betweenmaid : n, 허드렛일하는 하녀
betweentimes : ad, 틈틈히, 때때로
betweenwhiles : ad, 틈틈이, 이따금씩
betwixt : xprep, ad, 중간에, 이도저도 아니게
betwray : vt, 나타내다, 제시하다, (비밀을)누설하다, 폭로하다
Beulah : n, 쀼라(결혼한 부인), 이스라엘의 빛나는 미래를 상징함, 이사야 62:4, (만년의)안식의 땅, 여자 이름
bevatron : n, 베바크론(양자 가속 장치의 일종)
bevatron : n, 베바트론(고성능 사이믈로트론)
bevel : a, vt, 사각의, 경사진-사각을 만들다, 비스듬하게 하다
bevel gear : x, 베벨기어(삿갓 모양의 톱니바퀴)
beverage : n, 음료(alcoholic~알콜 음료)
bevvy : n, 음료, (특히)술, 술을 즐기는 하룻밤
bevy : n, (작은 새, 사슴, 미인 따위의)떼
bewail : vt, vi, 비탄하다, 슬퍼하다
beware : vi, vt, 주의(조심)하다
bewhiskered : a, 구레나룻을 기른, (익살 등이)케케묵은, 진부한
bewigged : a, 가발을 쓴
bewilder : vt, 당황케하다
bewilderingly : ad, 당황하게
bewilderment : n, 당황
bewitch : vt, 마법을걸다, 매혹하다, 황홀케하는, 매력있는
bewitchery : n, 매혹, 매력
bewitchingly : ad, 매혹시키듯, 황홀케 할 만큼
bewitchment : n, 마력, 매혹, 매력
beyond : xprep, ad, n, 저쪽편에, 넘어서, 이치지 않는-저쪽에, 외에-저편(의 것), 내세(the back lf~ 세계의 끝)
Beyrouth : n, =BEIRUT
bezant : n, (옛로마)베잔트 금화(은화), 금빛의 작은 원
bezel : n, 날의사면, (보석의)사면, (반지의)보석 물리는 데, (시계의)유리 끼우는 홈
bezique : n, 카드놀이일종
bezoar : n, 우황(소, 염소 따위의 위 장내의 결석, 예살 해독제로 씻음)
bhang : n, 인도대마, 마취약
Bharat : n, 바라트(India의 힌디(Hindi)말 명칭)
bheesty : n, (인도의)음료수 운반인
bhong : n, 마리화나 흡연용 파이프
Bhorizon : n, B층(토양 층위의 하나, A층 바로 아래
Bhutan : n, 인도북동부의왕국
Bhutanese : a, n, 부탄(사람, 말)의, 부탄사람, 부탄 말
bi : x, 둘, 쌍, 2배
bi : a, 양성애의
Biafran : a, n, 비아프라(사람)의, 비아프라 사람
bialy : n, 비알리(납작하고 가운데가 움푹한 롤빵, 썬 양파를 얹음)
biangular : a, 2각의
biannual : a, ad, 1년에 두 번의, 반년마다의, 반년마다
biannual : a, 연2회의
Biarfra : n, 비아프라(Nigeria의 동부 지방, 1967년 선언했으나 1970젼 붕괴)
bias : n, vt, 사선, 바이어스, 경사, 경향, 성벽-기울이다, 치우치게하다, 편견을 갖다
biathlete : n, 동계올림픽2종경기선수
biathlon : n, 동계 올림픽 2종 경기(스키의 장거리 레이스에 사격을 겸함)
biaxial : a, 2축의
bib : n, 턱받기, (에이프런 따위의)가슴부분
bibasic : a, 2염기성의
bibber : n, 술꾼, 음주가
bibbing : n, 음주(의 버릇)
bibcock : n, 수도꼭지
bibelot : n, 실내장식품, (소형의), 소골동품, 초소형판
bibivalent : a, 쌍이가의(2가의 양, 음 이온에 해리하는 전해질에 대하여 말함
Bible : n, 성서, 성전
Biblebasher : n, =BIBLETHUMPER
bible belt : x, 미국남부의신앙이두터운지역
Biblical : a, 성경의, 성경에서 인용한, 성경에 관한
biblicism : n, 성서(엄수)주의
biblicist : n, 성서학자, 성서의 내용을 그대로 믿는 사람
biblio : a, 책의, 성서의
bibliofilm : n, 도서복사필름
bibliog : x, bibliographer, bibliographic(al), bibliography
bibliograph : vt, (책 등에)서지를 달다, 서지를 작성하다
bibliographer : n, 서적 해제자, 서지학자
bibliographic : a, 서지의, 도서 목록의
bibliography : n, 참고서목록, 서지학
biblioklept : n, 책 도둑
bibliokleptomania : n, 도서벽
bibliolater : n, 서적숭배자, 성서 숭배자
bibliolatrous : a, 성서(서적)숭배의
bibliolatrous : a, 서적 숭배의, 성경 광신의
bibliolatry : n, 서적학, 서적 해제, 성서학
bibliological : a, 성서학의
bibliology : n, 서적학, 서지학(bibliography)성서학
bibliomania : n, 장서벽
bibliomaniac : a, n, 장서광의(사람)
bibliopegy : n, 제본술
bibliophile : n, 애서가
bibliophilism : n, 장서벽(취미)
bibliophilist : n, =BIBLIOPHILE
bibliophilistic : a, 애서가의
bibliophobe : n, 서적 증오자(기피자, 불신자)
bibliopole : n, 책 상인, 진서, 상인, 서점
bibliopolic : a, 상인의, 서점의, 책 상인의
bibliopolist : n, =BIBLIOPOLE
bibliopoly : n, 진서매매
bibliotheca : n, 장서, (개인의)문고, 서점의 (재고) 카탈로그
bibliotherapeutic : a, 독서 요법의
bibliotherapy : n, 독서 요법(신경증에 대한)
bibliotics : n, 필적 감정학
Biblist : n, 성서 신앙자=BIBLICIST
bibulous : a, 술꾼의, 술을 좋아하는 사람, 흡수성의(absorbent)
bicameral : a, 양원제의
bicarb : n, 중탄산소다
bicarbonate : n, 중탄산염
bice : n, 남청색의 물감(안료)
bicentenarry : a, 중심의, 쌍심의
bicentenary : a, n, =BICENTENNIAL
bicentennial : a, 200년의, 200 년제의
bicentric : a, 2중심의, 쌍심의
bicephalous : a, 쌍두의
biceps : n, 이두근
bichloride : n, 이염화물
bichromate : n, 이염화물
bichrome : a, 2색의
bicipital : a, 								      머리가두개인, 이두근
bicker : n, vi, 말다툼, 반짝거림, 후드득거림-말다툼하다, (비가)후드득 떨어지다
bicolor : a, n, 이색의(것)
bicolored : a, =BICOLOR
biconcave : a, 양면이 오목한
biconcavity : n, 양면이 오목함
biconditional : n, a, 상호 조건(적인), 쌍조건(의)
biconvex : a, 양면이 볼록한, 양볼록의(convexocoxvex)
bicorn : a, 두개의 뿔(모양)을 가진, 초승달 모양의
bicorporal : a, 두 몸체를 가진, 양체의
bicron : n, 비크론, (1m의 10억 분의 1)
bicultural : a, 두문화의, 병용의
bicuspid : n, a, 이두치-뾰족한 끝이 둘 있는
bicuspidate : a, =BICUSPID
bicycle : n, vi, 자전거, 자전거에 타다
bicycleclip : n, (자전거 탈때)바지 자락을 고정시키는 집게
bicycler : n, =BICYCLIST
bicyclic : a, 두 원으로 된, 두 윤생체를 이룬, (화합물이)두 고리식의
bicyclist : n, 자전거 타는 사람
bid : vt, vi, n, 명하다, 말하다, 값매기다, 입찰하다-값을 매기다, 입찰하다, 값을 다루다(이 뜻의 과거는 bid), 초대하다, 공고하다-값을 매기다, 입찰하다-부른값
biddable : a, 유순한, 겨눌수 있는
bidden : v, bid의과거분사
bidder : n, 값을 부르는 사람, 입찰(경매)자, 입후보자, 명령자, 초대자
bidding : n, 입찰, 명령, 초대, 공고, 선언
biddy : n, 암탉, 하녀
bide : vt, vi, 기다리다, 참다, 살다, 멀물다
bidentate : a, 이가 둘 있는
bidet : n, 비데(국부 세척기)
bidialectal : a, n, 두 방언을 사용하는(사람)
bidirectional : a, (안테나, 마이크 등이)양지향성의
bidonville : n, (도시 교외의)날림집(판잣집)지구
Biedermeier : a, 비더마이어 양식의(19세기의 가구 양식), (경멸)인습적인, 판에 박힌, 독창성이 없는
biennale : n, 격년 행사, 비엔날레(짝수 해에 Rome에서 개최되는 현대 회화, 조각의 전람회)
biennial : a, n, 2년에한번의, 2 년간의, 2년생의(식물), 2년마다 여는 전람회, 2년 마다 보는 시험
biennium : n, 2년간
bier : n, 관가, 관대
bierce : n, 미국의 단편작가
bierkeller : n, =beer cellar, (독일식으로 장식한)맥주홀
biestings : n, pl, =BEESTINGS
bifacial : a, 두 면이 있는, (유사한)양면이 있는, (잎 등이 서로 다른)양면이 있는
bifarious : a, 이중의, 2열의, 2종렬의
biff : n, vt, 강타, 강타하다
biffin : n, 요리용의검붉은사과
bifid : a, 이열의, 두 갈래의
biflex : a, 두 곳에서 구부러져 있는, 곡면이 둘 있는
biflorate : a, 꽃을 두 개 가진
bifocal : a, n, 이중초점의, 이중 초점의 안경
bifold : a, 둘로 접게 된, 두겹의
bifoliate : a, 쌍엽의
bifoliolate : a, (복엽이)두 소엽(leaflet)을 가진
biforked : a, 두 갈래의
biform : a, 두 모양을 가진
bifrost : n, 무지개다리(하늘과 땅 사이의)
bifurcate : a, vi, vt, 두갈래진, 두갈래로 가르다, 갈리다
bifurcated : a, =BIFURCATE
bifurcation : n, 분기, 분기점, (갈라진)한 가지
big : a, ad, 큰, 성장gks(grown-up)중요한, 높은, 잘난 체하는, 뽐내는(boastful)-뽐내며
big : a, ad, 큰, 성장한, 중요한, 높은, 잔난체하는, 뽐내는
bigaman : n, 중요 인물, 두목
bigamist : n, 중혼자
bigamous : a, 중혼을 한, 중혼 생활의
bigamy : n, 중혼
bigamy : n, 중혼, 중혼죄
bigaroon : n, =BIGARREAU
bigarreau : n, 비가로송(경육종)버찌, 그 나무
big bang theory : x, 우주가 폭발에 의하여 생성하고 팽창, 수축을 되풀이한다는 설
bigbangtheory : x, 우주가 폭발에의해 생성, 수축, 팽창을 되풀이한다
big beat : x, 로큰롤 음악
big beat : x, 록큰롤음악
big ben : x, 영국의사당위의 큰시계
Big Board : x, 뉴욕 증권 거래소(상장의 주실 시세표)
big board : x, 뉴욕증권거래소
big brother : x, 형(고아, 불량 소년 등을 선도하는), 형대신이 되는 남자, 독재자
big bug : x, 중요인물, 거물(bigwig)
big business : x, (종종 나쁜 뜻의)큰회사, 재벌
big deal : x, 하찮은 것
Big Dipper : x, 북두 칠성
bigeminal : a, 쌍생의, 이란성의, 쌍의, 이단맥의
bigener : n, (두)속간 잡종
bigeneric : a, 두 속에 관한, 속간의
Bigfoot : n, SASQUATCH의 별칭
bigg : n, 보리의 일종
big game : x, 큰 시합, 큰 사냥감(법 따위)
biggie : n, 훌륭하신분, 대단한 것
biggie : n, 훌륭하신분, 대단한 것
biggish : a, 좀 큰, 젠체하는
bighead : n, 두부 팽장중(양 머리의 심한 염증), 숙취, 자기 도위, 그런 사람
bighead : n, 두부팽창증, 숙취, 자기 도취
bighearted : a, 진절한, 관대한
bighearted : a, 친절한, 관대한
bighorn : n, 큰뿔양(로키산지에 야생하는 양)
bight : n, 후미, 만곡보, 이완
bight : n, 후미, 만곡부, 이완
bigleague : a, (직업 분야에서)톱 클라스의
bigly : ad, 대규모로, 거드럭대며, 오만하게
bigmouth : n, 일방적으로 잘 지껄이는 사람
bigmouthed : a, 입이 큰, 큰 목소리의, 큰소리치는, 자랑하는, 재잘재잘(일방적으로)잘 지껄이는
bignonia : n, 능소화 나무의 무리
bignonia : n, 능소화, 나무의 무리
bigot : n, 완고한 사람, 광신자, 괴팍스런 사람
bigot : n, 완고한사람, 광신자, 괴팍스런 사람
bigoted : a, 편협한, 완고한
bigotry : n, 고집불통, 완미, 괴팍
Big Science : x, 거대 과학(대규모의 과학 연구)
big sister : x, 누나, (고아, 불량 소녀 등을 선도하는)언니 구실을 하는 여자
big stick : x, 압력, 힘의 과시
big talk : x, 호언장담, 허풍
bigticket : a, 비싼 가격표가 붙은
bigtime : a, 일류의
bigtimer : n, 최고의 인물, =BIGWIG
big toe : x, 엄지발가락
bigwig : n, 높은사람, 요인
bijou : n, 보석, 작고 아름다운 것
bijouterie : n, 보석류, 자잘구레한 장신구
bijugate : a, 잎이 두 쌍 있는
bike : n, vi, 자전거, 오토바이(motorbike), 자전거(오토바이)를 타고 가다, (야생의)벌집, (사람의)무리
biker : n, =BICYCLIST, =MOTORCYCLIST
bikeway : n, 자전거전용도로
bikie : n, 오토바이 폭주족의 한 사람
biking : n, =CYCLING
Bikini : n, 비키니환초(마샬 군도의), (투피스의)여자 수영복
bikinied : a, 비키니를 입은
bilabial : a, n, 양순음, 두입술로 발음하는, 양순음
bilabiate : a, 두 입술 모양의
bilateral : a, 양자간의, 양측이 있는, 쌍무적인
bilateralism : n, 좌우 대칭, 쌍무 계약제
bilberry : n, 월귤나무속
bilbo : n, 검, 빌보검, 쇠차꼬
Bildungsroman : n, 교양소설(주인공의 정신적, 정서적 성장을 다룬 것)
bile : n, 담즙, 기분이 언짢음, 짜증
bilestone : n, 담석
bilevel : a, n, 상하2층의, 준 2층의(가옥)(반지하식)
bilge : n, vi, vt, 만곡부, 중배, 허튼소리, 구멍을 뚫다-구멍이 뚫리다, 불룩하게 하다, 북룩해지다(bulge)
bilge water : x, 배밑에괸더러운물
bilgy : a, (배 밑바닥의)물비린내가 나는
bilharzia : n, 빌하르츠 수혈흡충(이집트에 많음), 주혈흡충병
bilharziasis : n, 주혈흡충병
biliary : a, 담즙의, 담즙을 나르는, 담즙 이상에 의한
bilinear : a, 쌍일차의
bilingual : a, 두나라말을하는, 두 나라 말로 쓴
bilingualism : n, 2개 국어 상용, 2개 국어를 말하는 능력
bilinguist : n, 두 나라 말을 할 줄 아는 사람
bilious : a, 담즙의, 담즙질의, 까다로운
bilirubin : n, 빌리루빈(담즙속의 적황색 색소)
biliteral : a, 두 글자의
bilk : vt, n, 떼먹다, 떼먹고 도치다-잘라먹음, 사기꾼
bill : n, vt, vi, 계산서, 목록, 환어음, 의안-광고하다, 예고하다, 청구서를 보내다, 부리, 부리를 맞대다
bill : n, vi, 부리(모양의 것)-(비둘리가)부리를 맞는다
bill : n, (옛날의)갈고리 창
billabong : n, (장의)분류, (괸)역수
billboard : n, 게시판, 방송 전후의 배역, 스폰서
billbook : n, 어음장
bill broker : x, 증권중매인, 어음 중매인
billbug : n, 바구미
billed : a, (보통 복합어를 이루어)(어떤)부리를 가진
billet : n, vt, 숙사, 숙사 할당 명령서, 일자리, 직업-(병사에)숙사를 할당하다
billet : n, 굵은 장작, 철봉
billetdoux : n, 연애편지
billfold : n, (둘로 접게 된)지갑
billhead : n, 용지의위쪽에인쇄한상호와소재지명
billhook : n, 전지 등에 쓰이는 낫의 일종
billiard : a, 당구용의
billiard room : x, 당구장
billiards : n, pl, 당구
billibi : n, 빌리비 수프(조개 수프에 백포도주와 크림을 섞은 것)
Billie : n, 남자 이름
Billiken : n, 빌리켄(앉아서 미소짓는 복신의 상)
billing : n 게시, 광고, 프로에서의 서열
billing machine : x, 자동경리계산기
billingsgate : n, 런던의 어시장, 폭언, 상말
billion : n, a, 10억의, 1조의
billionaire : n, 억만장자
billow : n, vi, 큰파도, 놀치다
billposter : n, 삐라붙이는사람
billy : n, 곤봉, 경찰봉, 주전자
billy : n, (양철)주전자
billyboy : n, (하천, 연안용의)바닥이 평평한 짐배, 거룻배
billycan : n, =BILLY
billyclub : vt, 폭력으로 강요하다
billycock : n, 중절모
billy goat : x, 숫염소
billyoh : n, 맹렬하게
bilobate : a, 이열편의
biltong : n, 육포
bimane : n, 이수류의(동물)
bimanous : a, 손이 둘 있는, 이수(류)의
bimanual : a, 두 손을 쓰는
bimbashi : n, (터키의)육군 소령, 해군 지휘관
bimbo : n, (평판이 나쁜)사나이, 녀석, 몸가짐(행실)이 나쁜 여자, 매춘부
bimensal : a, 격월의(bimonthly)
bimester : n, 2개월간
bimestrial : a, 2개월간의, 두 달에 한번의
bimetal : a, n, 바이메탈, 두가지 합금의
bimetallic : a, 두금속의, 두 금속으로된, 복본위제의
bimetallism : n, 복본위제
bimetallist : n, 복본위제론자
bimillenary : n, a, 2천년(간)(의), 2천년 기념일(제)(의)
bimolecular : a, 2분자의(로 된)
bimonthly : a, ad, n, 2개월에 한번의, 격월의, 격월로-격월 발행지
bimorphemic : a, 두 형태소에 관한(로 이루어진)
bimotored : a, (비행기가)쌍발식의
bin : n, vt, 큰상자, 저장하다
binacle : n, 나침합
binal : a, 2배(중)의, 2개의 고음부를 가진
binary : a, n, 둘의, 둘로된
binate : a, (잎이)한쌍(대생), 쌍생의
binate : a, 쌍생의
binaural : a, 두귀의, 두 귀에 쓰이는
binbusting : a, 창고가 터질 듯한
bind : vt, vi, n, 동이다, 매다, 감다, 속박하다-굳어지다, 구속하다-묶는 것, 덩굴, 끈, 제본
binder : n, 묶는것, 묶는사람, 끈, 제본
bindery : n, 제본소
binding : a, n, 묶는, 동이는, 제본, 붕대, 속박, 속박하는
binding energy : x, 결합에너지
bindle : n, (떠돌이의)침구 꾸러미, 모르핀, 코카인 등의 한 봉지
bindle stiff : x, (침구를 갖고 다니는)부랑인
bindweed : n, 메꽃(무리의 덩굴풀)
bine : n, 덩굴, (인도인 굴의 일종)
Binet Simon test : x, 지네시몽식 지능 검사법
binge : n, 법석대는술잔치
bingle : n, vi, vt, 안타, 안타를 치다, 치켜 깎은 단발, 단발로 하다
bingo : n, 빙고(lotto의 일종)
binnacle : n, 나침함
binocle : n, 쌍안경
binocs : n, 쌍안경(binoculars)
binocular : a, n, 두눈용의, 쌍안경(opera glass)
binocularity : n, a, 2항식(의), 2명법(의)
binomial : n, a, 이항식(의), 이명식의, 이명식 이름
bint : n, 여자
binuclear : a, (세포 등이)핵을 2개 가진, 2핵의
bio : n, (짧은)전기, (예능인의)경력, (연감, 선전기사 등에서의)인물 소개, 약력
bioacoustics : n, pl, 생체 음향악(생체가 내는 음향과 생체와의 관계를 다룸)
bioactivity : n, (약품 등의)대 생물 작용(활성)
bioassay : n, 생물학적 정량
bioastronautics : n, pl, 우주생리학
bioavailability : n, (약물의)생체 이용률
bioblast : n, 부정형 원형질의 작은 집단
biocenology : n, 생물 군집합
biocenose : n, 생물 군집
biochemical : a, 생화학의
biochemist : n, 생화학자
biochemistry : n, 생화학
biochip : n, 바이오칩(생체 주입용의 실리콘 집적 회로 소자)
biocidal : a, 생명 파괴(살균)성의
biocide : n, 생물독, 생명의 파괴
bioclean : a, 유해 (미)생물이 없는
bioclimatology : n, 생물기후학
biocoenosis : n, 생물군집
biocrat : n, 생물 과학자(전문가, 기사)
biocritical : a, (작가 등의)생활(과 작품)연구의
biocybernetics : n, 바이오사이버네틱스(사이버네틱스를 생물학에 응용시킨 연구)
biodegradability : n, 생물 분해성
biodegradable : a, 미생물로분해되는
biodegradation : n, 미생물에 의한 생물 분해
biodegrade : vi, (세균작용으로)생물 분해를 일으키다
biodeterioration : n, 미생물에 의한 생물 분해
biodeterioration : n, 생물 열화(세균 등에 의해 재료가 열화, 변질되는 일)
biodynamic : a, 생활기능학의
biodynamics : n, 생활 기능학, 생체(동)역학
bioecological : a, 생물 생태학의
bioecology : n, 생물생태학
bioelecricity : n, 생물 전기
bioelectromagnetics : n, 생체 전자기학(생체에 대한 전자기 현상을 대상으로 한 의학)
bioelectronics : n, 생물 전자 공학
bioenergy : n, 생물 에너지(동식물성 폐기물에서 얻을 수 있는 에너지)
bioengineering : n, 생의학 공학(biomedical engineering)
bioenvironmental : a, 생물 환경의(생물의 환경과 특히 그 속의 유해 요소에 관한)
bioethics : n, 생명윤리학(유전자 공학이나 심장이식등에 관해 야기되는)
biofeedback : n, 바이오피드백(뇌파계를 따라 알파파를 조절, 안정된 정신 상태를 얻는 방법)
biofrel : n, 생물(화석)연료(석탄 등)
biog : x, biographer, biographical, biography
biogas : n, 생물 가스(유기 폐기물이 생물 분해하여 생기는 메탄과 이산화탄소의 혼합 기체)
biogenesis : n, 속생설
biogenic : a, 유기물에 의해 생긴, 생물 기원의, 생명유지에 꼭 필요한
biogenous : a, 생물에 기원하는, 생명을 만드는
biogeocenology : n, 생태계 연구
biogeocenose : n, 생태계
biogeocenosis : n, 생태계
biogeography : n, 생물지리학
biograph : vt, ...의 전기를 쓰다
biographee : n, 전기의 주인공
biographer : n, 전기 작가
biographic : a, 전기의
biographical : a, 전기(체)의
biographically : ad, 전기식으로, 전기체로
biography : n, 전기
biogrpher : n, 전기작가
biohazard : n, 생물학적 위험(사람과 그 환경에 대해 위험이 되는 생물학적 물질 상황)
biological : a, 생물학상의, 생물학의, 생물학응용의
biologist : n, 생물학
biology : n, 생물학
bioluminescence : n, 생물발광
biolysis : n, (생물체의)미생물에 의한 분해, 생물 분해
biomagification : n, (생태계의 식물 연쇄에 있어서의)생물학적 (독물)농축
biomass : n, 생물량
biomaterial : n, 생체 적합 물질(재료)(생체 조직에 닿는 부위의 보철에 사용하는 물질, 재료)
biomathematics : n, 생물 수학(생물현상에의 수학 응용)
biome : n, 생물군계
biomechanics : n, pl, 생물역학
biomedical : a, 생물의학의
biomedicine : n, 생물의학
biometeorology : n, 생물 환경학
biometric : a, 생물 측정(학)의, 수명 측정(법)의
biometrics : n, 생물측정학
biometry : n, 수명측정법
biomolecular : a, (생물체내의)생체(고)분자의
biomolecule : n, 유생분자(바이러스처럼 생명 있는)
bionic : a, 생체(생물)공학의, 초인적인, 사이보그(cyborg)같은
bionics : n, pl, 생체공학(인간, 동물의 행동 양식을 연구하여 컴퓨터 설계에 응용하는 학문)
bionomics : n, 생명학, 생태학
bionomy : n, 생명학, 생리학, 생태학
biont : n, 생리적 개체, 비온트
bioorganic : a, 생물 유기화학의
biopharmaceutics : n, 생물약제학
biophore : n, 생물 구조의 기본적 입자
biophysicist : n, 생물 물리학자
biophysics : n, 생물물리학
biopic : n, 전기 영화
bioplasm : n, 원생질
bioplast : n, 원생체, 원생질 세포
biopolymer : n, 생물 고분자 물질, 생물 폴리머
biopsy : n, 생검법(생체 조직으리 현미경 겸사)
bioresearch : n, 생물 과학 연구
biorheology : n, 생체 유동학
biorhythm : n, 바이오리듬(t생체의 주기성)
biosatellite : n, 생물위성
bioscience : n, 생물과학, 우주생물학
bioscientific : a, 생물 과학의, 우주생물학의
bioscope : n, (초기의)영화 영사기
bioscopy : n, 생사반응검사
biosensor : n, 바이오 센서(우주 비행사 등의 생리학적 데이터를 계측, 전달하는 장치)
bioshield : n, 바이오실드(무균화 처리후 발사까지의 우주선 차폐 케이스)
biosis : n, (특정한)사는 방식, 생활 양식
biospeleology : n, 동굴 생물학
biosphere : n, 생물권
biostatics : n, 생물정력학
biostatistics : n, pl, 생물 통계학
biosynthesis : n, 생합성
biosynthetic : n, 생합성의
biota : n, 생물군, 생물상
biotechnology : n, 생물공학
biotelemetry : n, 생물원격측정법
biotherapy : n, 생물(학적)요법
biotic : a, 생명에관한, 생명의
biotin : n, 비타민B복합체
biotite : n, 흑운모
biotope : n, 소생활권
biotoxic : a, 생물독의, 생체 소독의
biotron : n, 바이오트론(환경조건을 인위적으로 제어하여, 그 속에서 생물을 기르는 장치)
biotype : n, 생물형(동일 유전자형을 가진 개체군, 그 유전자형)
biovular : a, (2 란 생의)쌍생아
biowarfare : n, 생물 전쟁, 세균전
bioysis : n, 미생물에의한분해
bipack : n, 2중천연색필름
biparental : a, 양친의(에 고나한, 으로부터 얻은)
biparous : a, 쌍둥이를 낳는, 이생의, 축이 둘인
bipartisan : a, 양당의
bipartite : a, 2부로된, 잎이 두갈래로 째진
biparty : a, 두 당으로 된, 2대 정당의
biped : n, a, 두발동물, 두발의
bipedal : a, 두 발 동물의
bipetalous : a, 꽃잎이둘있는
biphenyl : n, 비페닐(2개의 페닐기로 된 무색의 결정 화합물)
bipinnate : a, (잎이)이회우상의
biplane : n, 복엽, 비행기
bipolar : a, 2극이있는, 정반대의
bipolarity : n, 2극성
bipropellant : n, 이액성 추진약
biquadratic : a, n, 4차의, 4차 방정식
biquinary : n, 이오진법(2진법과 5진법의 병용)
biracial : a, 두 인종의(으로 이루어진)
birch : n, vt, 자작나무, 자작나무 회초리, 때리다
birchen : a, 자작나무의(로 만든)
Bircher : n, 버치 당원(미국 극우 정치 조직 Johb Birch Society 회원(동조자)
Birchism : n, (미국의)버치주의, 초보수주의, 극우 반공주의
Birchite : n, =BIRCHER
bird : n, vi, 새, 엽조, 녀석, 야유, 비행기-들새를 관찰하다, 새를 잡다
birdbanding : n, 조류 표지법(이동 상황의 조사를 위해 다리에 띠를 묶어 놓아 줌)
birdbath : n, 수반(새들의 미역감는 그릇)
birdbrain : n, 얼간이
birdcage : n, 새장
birdcall : n, 새소리, 새소리가 나는 피리
birdcatcher : n 새 잡는 사람(덫)
birdclaw : a, 새의 발톱처럼 여윈
bird dog : x, 새사냥개
birddog : vt, vi, bird dog 노릇을 하다, 열심히 찾아내다, 끈질기게 뒤밟아 탐정하다, 자세히 조사하다
birddogging : n, 좇아 다님, 줄곧 괴롭힘, 데이트 상대를 가로챔
birddom : n, 미녀의 세계
birder : n, 새사냥꾼, 들새 관찰자
birdeyed : a, 눈이날카로운, 잘 놀라는
birdfancier : n, 조류애호가, 새장수
birdfarm : n, 항공모함
birdfoot : n, =BIRD'SFOOT
birdhouse : n, 새장, 새 기르는 집(새를 구경시켜 주는)
birdie : n, 새, 작은새
birdlike : a, (얼굴, 목소리 등이)새 같은, (몸집이)가냘픈, 날씬한, 민첩한, 경쾌한
birdlime : n, (새잡는)끈끈이
birdman : n, 조류전문가
birdseed : n, 새 모이
birdseye : a, n, 위에서본, 조감적인, 새눈의-새눈 무늬의 무명
birdsfoot : n, 콩과 식물의 목초(잎, 꽃이 새의 다리 모양임)
birdsnest : n, 새둥우리, 바다 제비집(요리용)
birdsnesting : n, 새집 뒤지기
birdwatch : vi, 들새의 생태를 관찰하다, 탐조하다
birdwoman : n, 여류 비행가
birdy : a, 새같은, 엽조가 많은, (사냥개가)새를 잘 찾는, 괴상한, 기묘한
birefringence : n, 복굴절
bireme : n, (고대 그리스, 로마의)2단식 노의 갤리선
biretta : n, 모관(4각의 성직모)
birgade : n, vt, 대, 여단, 대로 편성하다
birk : n, =BIRCH, 바보, 멍청이
birl : vt, vi, n, (떠있는 통나무를)발로 돌리다(굴리다), (경화를)팽이처럼 빙빙 돌리다(spin), 빙빙 돌면서 나아가다, (특히 경주에서)통나무 굴리기를 하다, 시도하다, 시도
Birmingham : n, 영국 중부의 공업 도시
Biro : n, 볼펜의 일종
birr : n, vi, 힘(특히)바람의힘, 공격의 기세, 강타, 공격, 윙하는 회전음, 윙하고 소리내다(소리내며 움직이다), 비르(에티오피아의 화폐 단위, =100cents)
birth : n, 출생, 탄생, 출산, 혈통, 가문, 태어난 것
birth certificate : x, 출생증명서
birth control : x, 산아 제한
birthdate : n, 생년월일
birthday : n, 생일
birthday honours : x, 국왕생일에 행해지는 서훈
birthday suit : x, 알몸
birthmark : n, 모반(날 때부터 몸에 지닌)점
birth pang : x, 진통, 일시적 혼란, 불행한 사태
birth pill : x, 경구 피임약
birthplace : n, 출생지, 발생지
birth rate : x, 출산율
birthrate : n, 출생률
birthright : n, 생득권
birthstone : n, 탄생석, 난 달을 상징하는 보석
bir watcher : x, 들새 관찰자, 로켓(위성)관측자
bis : ad, 두번, 2회, 되풀이하여
Bisayan : n, 비사야 족(필리핀의 원주민), 비사야 말
Biscay : n, 스페인 북쪽 해안과 프랑스 서해안 사이에 있는 큰 만
biscuit : n, 작은 빵, 비스킷
bise : n, 찬 북동풍(스위스, 남프랑스, 이탈리아의)
bisect : vt, 2등분 하다
bisection : n, 2등분선
bisectional : a, 2등분한
bisector : n, 2등분선
bisexual : a, 양성의, 양성을 갖춘
bisexuality : n, 양성 소질, 양성교
bish : n, 실수, 잘못
bishop : n, 주교, 감독, 승정, 비숍(모자꼴의 말)
bishopric : n, BISHOP의 직(교구), 감독회
bisk : n, 진한 수프
Bismarck : n, 독일건설을 한 프러시아의 정치가
bismillah : xint, 신에 맹세코!(회교도의 맹세말)
bismuth : n, 창연
bison : n, 들소
bisque : n, 애벌 구운 오지 그릇
bissextile : n, a, 윤년의
bissextus : n, 윤일, 2월 29일(윤년의)
bistability : n, (회로의)쌍안정
bistable : a, 쌍안정의(깜박이처럼 스위치오 두 가지 상태가 되는 장치나 회로에서)
bistate : a, 2국(2주)(간)의
bister : n, 고동색(그림 물감)
bistort : n, 범꼬리
bistoury : n, 유엽도(와과용 메스의 일종)
bistro : n, 작은 술집
bisulfate : n, 중황산염
bisulfide : n, 이황화물
bisulfite : n, 중아황산염
bit : n, 작은 조각, 조금, 소량, 잠시, 잔돈, 비트(정보량의 기본 단위)
bitch : n, (개, 이리, 여유의)암컷, 개년, 가보, 매춘부
bitcher : n, 불평가
bitchery : n, 암캐같은 행동, 심술궂은 (음탕한) 여자같은 행위, 심술, 악의, 보복, 복수
bitching : a, 굉장한, 아주 좋은
bitchy : a, (특히 여자가)성질이 고약한, 심술궂은, 성마른, 육감적인, 성적 매력이 있는
bite : vt, vi, n, 물다, 물어뜯다, 스미다, 부식하다, 한 번 묾, 한 입, 물린 상처
BITE : x, built in test equipment 내장방식의 자기 진단 장치
bitebybite : a, 야금야금(조금씩)먹어 들어가는, 한 발짝 한 발짝씩 다가가는
biter : n, 무는 사람(것), 물어뜯는 짐승, 미끼를 잘 무는 물고기, 속이는 사람
biting : a, 찌르는듯한
bitt : n, 계주
bitten : v, bited의과거분사
bitter : a, n, 쓴, 격심한, 가엾은, 비참한, 모진, 쓴맛, 쓴맥주
bitterender : n, 끝까지 견디는 사람, 철저한 항전론자
bitterish : a, 씁쓸한, 씁쓰레한
bitterly : ad, 쓰게, 격심하게, 비참하게
bittern : n, 알락해오라기
bitterness : n, 씀, 격심함, 비참함
bitterroot : n, 쇠비름과의 화초
bittersweet : a, n, 쓰고도 단, 고생스럽고도 즐거운
bitting : a, 찌르는듯한, 날카로운, 부식성의
bitty : a, 단편적인, 가늘게 자른
bitumen : n, 역청, 암갈색
bitumen : n, 가연 광물(아스팔트, 석유, 피치 따위)
bituminize : vt, 역청화하다, 역청을 섞다
bituminous : a, 역청의, 역청탄
biunique : a, 2방향 유일성의(음소 표시와 음성 표시가 1대 1의 대응 관계에 있음)
bivalence : n, 이가
bivalent : a, 2가의, 2가 염색체의
bivalved : a, 양판의, 쌍각 조개의
bivalvular : a, 양판의, 쌍각 조개의
bivlave : a, 쌍각
bivouac : n, vi, 야영하다
bivouac sheets : x, 천막, (등산가용)
bivvy : n, 작은 천막(피난처)
biweekly : a, ad, n, 격주의-격주 간행물
biwwow : n, vi, 멍멍, 멍멍짖다
biyearly : a, ad, 1년의 2번의, 2년에 한번
biz : n, =BUSINESS, 잘했다!, 잘한다!, 멋지다!
bizarre : a, 괴기한, 기묘한
bizarrerie : n, 괴기(한 것), 그로테스크
Bizet : n, 비제(1838-75)(프랑스의 작곡가)
bizonal : a, 2국 공동 통치 지구의, (제 2차 대전 후의 서독의)미영 양국 점령지구의
bizone : n, 서독의 미영점령지구
Bizonia : n, 서독의 미영 점령 지구
bizzbazz : n, 부질없는 수다
Bjornson : n, Bjornstjerne(1832-1910)뵤른슨(노르웨이의 시인, 소설가, 극작가)
blab : vt, vi, n, 지절거리다, 비밀을 누설하다, 지절거리는(비밀을 누설하는) 사람, 지절거림
blabber : n, 수다쟁이
blabbermouth : n, 수다쟁이, 비밀을 지껄여 대는 사람
black : a, n, vt, vi, 검은, 더러운, 암담한, 지르퉁한, 불길한, 사악한, 험악한-검정, 흑색, 흑점, 검은 그림물감, 흑인-검게 하다, (구두를)닦다, 더럽히다
blackamoor : n, 흑인, 아프리카 흑인, 피부색이 검은 사람
blackandblue : a, (얻어 맞아서)시퍼렇게 멍이 든
blackandtan : a, n, (개가)검은 바탕에 갈색이 섞인, 백인과 흑인의 비례 대표제를 주창하는, 백인과 흑인 양편이 빈번히 출입하는, 테리어 개의 일종, 백인, 흑인이 모두 잘 출입하는 나이트클럽
blackandwhite : a, n, 흑백의, 펜화의, 단색의, 흑백 텔레비전(사진), 흑백 얼룩의, 측백이 뚜렷한 (논리 등), 초콜릿 크림
black art : x, 마술, 마법
blackavised : a, 색이 검은, 얼굴 색이 검은(거무스름한)
blackball : vt, n, (검은 공을 던져서)반대 투표하다(vote against), (사회에서)배척하다, 반대 투표, (반대 투표용의)검은 공
blackballer : n, 반대 투표자
blackbeetle : n, 바퀴, 진딧물
black belt : x, 흑인지대
blackberd : n, 찌르레기, 지빠귀, 노에선에 붙잡힌 캐너켜 원주민
blackberry : n, vi, 검은딸기(의 열매), 검은 딸기를 따다
blackbird : n, 검은새(지빠귀 무리), 찌르레기과의 새, 흑인, 노예선에 유괴된 카나카(Kanaka)사람
blackbirding : n, 흑인 노예 유괴(매매)
blackboard : n, 칠판
blackbody : n, 흑체(모든 파장의 복사를 흡수하는 가상 물체)
black book : x, 블랙리스트, 요시찰인명부
black box : x, 전자장치
Blackcap : n, (머리가 검은 유럽산의)꾀꼬리의 무리, (미국산의)박새의 무리, (열매가 검은)나무딸기류
blackcapped : a, (새가)머리가 검은, 검은머리의
black chamber : x, 첩보기관
blackcoat : n, (검은 옷을 입는)성직자, 월급장이
black comedy : x, 블랙코메디(빈정ㄷ는 유머가 깃든 희극)
Blackdamp : n, (탄갱 안의)질식 가스
black death : x, 흑사병, 페스트
black diamond : x, 석탄
black dog : x, 우울, 기분이 언짢음
black draught : x, 화제의 일종
blacken : vi, vt, 검게(어둡게)하다, 비방하다
Black Engish : x, 흑인 영어
blacker : n, 검게 하는 사람, 비방하는 사람
blacketeer : n, 암거래 상인
black eye : x, (맞아서 생긴)눈언저리의 멍
blackeyed : a, 눈이 까만, 눈언저리가 퍼런, 멍이 든
blackface : n, 흑인으로 분장한 배우(가수), 굵은(블랙)활자
blackfaced : a, 얼굴이 검은, 침울한 표정을 한, 굵은(흑체)글자의
blackfellow : n, 오스트레일리아 원주민
blackfish : n, 둥근 머리의 돌고래, 검은 물고기(농어 따위)
blackflag : n, (해골을 그린)해적기
Blackfoot : n, 블랙푸트족(북미 토인의 한 종족), 그 언어
Black Forest : x, 독일 서남부의 삼림 지대
Black Friday : x, 불길한 금요일(예수가 처형된)
black gold : x, 석유
blackguard : vt, vi, 불량배, 깡패, 악한, 악담하다, 욕지거리하다, 불량배처럼 행동하다
blackguardly : a, 불량배의(와 같이), 말 버릇 더러운(더럽게)
Black Hand : x, 흑수단(범죄를 일삼던 이탈리아계 미국인의 비밀 단체), 폭력단
blackhead : n, 검은 여드름, 머리가 검은 각종 새
blackheart : n, (야채, 감자 등)속썩음병, 검은 버찌
blackhearted : a, 뱃속 검은
black humo(u)r : x, 블랙 유머(빈정거리는 병적인 유머)
blacking : n, 흑색 도료, 구두약
black ink : x, 검정 잉크, 흑자, 대변
blackish : a, 거무스름한
blackjack : n, vt, 큰잔, 조끼, 해적기, 곤봉(으로 때리다), 협박하다
blackjack : n, vt, 큰 잔, 해적기, 협박하다
black lead : x, 흑연
blacklead : vt, 흑연을 칠하다(으로 닦다)
blackleg : n, 사기꾼, 파업파괴자
black letter : x, 고딕활자
blackletter : a, 흑체 문자의, 블랙(고딕)활자의, 불길한, 불행한
black lie : x, 악의 있는 거짓말
blacklist : n, 요주의 인물 명
black lung : x, 탄진폐
blackly : ad, 검게, 어둡게, 암흑으로, 음울하게(gloomily), 화가 나서, 간악하게(wickedly)
blackmail : n, vt, 갈취(한돈), 공갈(하다)
Black Maria : x, 죄수 호송차
black maria : x, 죄수호송차
black mark : x, 흑점
black market : x, 암시장
black marketeer : x, 암거래상인
Black Monday : x, 방학 후의 첫 등교일
black monday : x, 방학후의첫등교
Black Muslim : x, 흑백인의 완전 격리를 주장하는 흑인 회교 단체
black muslim : x, 흑인회교단체
black nationalism : x, 흑인민족주의
blackness : n, 검정, 흑색, 흑점
blackout : n, (무대의)암전, 등화 관제, (방향 급변 따위로 인한)일시적 시력(의식)상실
blackout : n, 암전, 등화 관제, 일시적 시력 상실
Black Panther : x, 검은 표범(미국의 흑인 과격파 당원)
black panther : x, 검은표범
black pepper : x, 후춧가루(껍질째 빻은)
blackplate : n, 흑판(부식 방지의 도금이나 마무리 칠을 하지 않은 철판)
black point : x, 흑수병
blackpoll : n, 검은머리솔새(미국산)
Black Power : x, 흑인(지위 향상)
black power : x, 흑인운동
black pudding : x, 검은 소시지(돼지의 피나 기름을 넣어 만듦)
black pudding : x, 검은소시지
black sea : x, 흑해
Blackshirt : n, 검은 셔츠 당원(이탈리아의 Fascist의 별명)
blacksmith : n, 대장장이
blacksnake : n, 먹구렁이, 쇠가죽 채찍
blacksploitation : n, =BLAXPLOITATION
black spot : x, 위험 구역
Black Stream : x, 흑조
black tea : x, 홍차
black tea : x, 홍차
blackthorn : n, 자두나무, 산사나무
blacktie : n, 검은 넥타이, 신사, 명사
blacktop : n, (포장에 쓰이는)아스팔트, 아스팔트 도로
blackwash : vt, 폭로하다
black watch : x, 스코틀랜드고지 제42연대
blackwater fever : n, 흑수열(악성 말라리아)
blacky : n, 검둥이, 검은 동물(새 등)
bladder : n, 방광, (물고기)부레
bladderwort : n, 토알속의 식물
bladdery : a, 방광 모양의, 기포가 있는, 부푼
blade : n, 잎, 칼날, 칼, 검객, 멋장이, 날개, 견갑골
bladebone : a, (...의)잎사귀가 있는, (...의)칼날이 있는
bladebone : n, 견갑골
bladelette : n, 세석인(박편 석기의 하나)
bladesmith : n, 칼 대장장이
blaebery : n, =BILBERRY
blague : n, 속임수, 엉터리, 허풍
blah : xint, n, 바보같이-허튼소리, 어리석은 것
blain : n, 수포, 종기, 농포
Blake : n, 영국의 시인작가
blamable : a, 비난할 만한
blame : vt, n, 나무라다, 비난하다..., 의 탓으로 돌리다-비난, 책임, 허물
blamed : a, 지긋지긋한, 빌어먹을
blameful : a, 비난할 만한, 나무랄만한
blameless : a, 나무랄만한
blameworthy : a, 나무랄만한
blanch : vi, vt, 희게하다, 표백하다, 창백해지다
Blanche : n, 여자 이름
blancmange : n, 블랑쥬아(우유가 든 흰 젤리, 디저트용)
blanco : n, vt, 백색 도료(벨트, 군화 등의 가죽 제품용, (가죽 제품에)백색 도표를 칠하다
bland : a, 온화한, 부드러운, 기분 좋은, 상냥한, 순한
blandish : vt, 아첨하다, 비위를 맞추다, 설득하다
blandishment : n, 추종, 감언, (사람을 호리는)수단
blank : a, n, vt, 백지의, 공허한, 흥미 없는, 단조로운, (벽따위)문이나 창이 없는, 무표정한, 멍한-백지, 기입 용지-비우다, 공백으로하다
blankbook : n, 백지(미기입)장부
blank check : x, 백지 수표(person a~ 얼마든지 돈을 주다, 멋대로 하게 하다)
blanket : n, a, vt, 담요, 모포-총괄적인, 차별하지 않는, 일률적인-담요에 싸다, (사건을)덮어 버리다(obseure), (전화를)방해하다, 숨기다
blanket area : x, (방송국 주변의)난청구역
blanket bombing : x, 융단, (무차별)폭격
blanket chest : x, 이불장
blanketing : n, 담요감, 전파 방해(강력 전파로 수신 불가능하게 하기)
blanket insurance : x, 전종보험
blanket visa : x, 일괄 사증(세관이 선객 전부에게 일괄하여 주는 비자)
blankety : a, ad, 괘씸한, 괘씸하게도
blanketyblank : n, 바보, 멍청이, 망할 놈(wretch)
blank form : x, 기입 용지
blankly : ad, 멍하니, 우두커니, 딱잘라서, 완전히
blankness : n, 공백, 단조
blank verse : x, 무운시(보통 5각약강격)
blanquette : n, 블랑켓(백소스로 조리한 송아지고기스튜)
blare : vi, vt, n, 외치다, (동물이 굵은 소리로)울다-울리다-울림, 외치는(우는)소리치는 소리
blarney : n, vi, vt, 알랑거리는 말, 말을 하다
blase : a, 환락에 지친
blaspheme : vt, vi, (신에 대하여)불경한 언사를 쓰다, 험담을 하다
blasphemer : n, 불경스러운 말을 하는 사람, 모독자, 욕설하는 사람
blasphemous : a, (사람이)불경스러운, (말, 내용등이)모독적인
blasphemy : n, 불경, 모독
blassed : a, 치우친, 편견
blast : n, vi, vt, 돌풍, 한 바탕 부는 바람, 소리, 울려퍼짐-폭파하다, 시들게 하다
blastdown : n, (로켓의)착륙
blasted : a, 시든, 결단난, 저주받은
blastena : n, 아주, 유배의 세포 집단
blaster : n, 발파공, 블래스터(벙커용의 타면이 넓은 클럽, (SF소설에서)우주 총, 건, 건맨
blastfreeze : vt, (냉각공기를 순화기켜)급속 냉동하다
blast furnace : x, 용광로, 고로
blasting : n, 폭파, 발파, (서리 등이 초목을)말림, (나팔등의)소리, 울림, 호된 꾸지람, 야단
blasto : n, =BLAST
blastocyst : n, 배반포, 낭포
blastoderm : n, 배반엽, 포배엽
blastoff : n, (로켓 등의)발사
blastomere : n, 할구, 난할구
blastopore : n, 원구
blast pipe : x, 송풍(배기)관
blastula : n, 포배
blast wave : x, 폭풍
blat : vi, vt, (송아지, 양이)울다, 시끄럽게지껄이다
blatancy : n, 소란함
blatant : a, 소란스러운, 성가시게 참견하는, 야한
blather : vt, vi, n, 지껄여대다, 허튼소리, 허튼소리를 하다
blatherskite : n, 허튼 소리를 하는 사람, 떠버리
blatter : vi, vt, 귀찮게 발리 지껄여대다, 마구 수다떨다
blaxploitation : n, (영화, 연국 등에서의)흑인 개발(흑인에 대한 관심을 개발시키기), 흑인 고객 유치 방안
blaze : n, vi, 화염, 빛, 광휘, (명성의)드날림, (감정의)격발, -불타다, 빛나다, 불같이 노하다
blaze : n, vt, 길잡이로 나무껍질을벗긴)안표
blaze : vt, 포고하다(proclaim), (널리)알리다
blazer : n, 블레이저코트(화려한 빛깔의 스포츠용 상의)
blazing : a, 타는, 타는 듯한, 강렬한, 심한
blazing star : x, 리아트리스속의 식물, 흥미의 대상(사람, 물건)
blazon : n, vt, 문장, 문장묘사, 과시-문장을 그리다, 말을 퍼뜨리다, 공표하다
blazonry : n, 문장(해설, 화법), 화화한 겉치레, 미관
bleach : vt, 표백하다, 마전하다, 노천 관람석
bleached : a, 표백한
bleacher : n, 표백하는 사람, 표백업자, 표백기(제), 지붕없는 관람석(대중석), 외양석
bleacherite : n, 외야석의 구경꾼
bleachery : n, 표백 공장
bleaching : n, 표백, 표백법
bleak : a, 황량한, 으스스 추운, 쌀쌀한, 쓸쓸한(dreary)
blear : a, (눈이 눈물이나 염증으로)흐린, 침침한, 헌, 희미한(dim)
blear : a, vt 흐린, 침침한-흐리게하다
bleareyed : a, 흐린 눈의, 눈이 잘 보이지 않는
bleary : a, 눈이 흐린, 몽롱한
bleat : vi, n, (염소, 송아지 따위가)매애 울다, 매애
bleating : n, 울음소리, 우는 소리
bleb : n, 물집, 기포
bled : v, bleed의 과거 (분사)
bleed : vi, vt, n, 출혈하다, 피흘리다, 슬퍼하다-(환자의)피를 뽑다, 돈을 우려내다-찍힌 부분까지도 자른사진, 인쇄된 부분까지도 자른 사진
bleeder : n, 피를 잘 흘리는 사람, 혈우병자
bleedering : n, 출혈, 방혈(bloodletting)
bleeding heart : x, 금낭화
bleep : n, 삐익하는 소리(휴대요 라디오 등에서 나는)-삐익 소리를 내다
blemish : n, vt, 흠, 결점, 손상하다
blench : vi, vt, 뒷걸음치다, 주춤하다, 휘어지다, 푸르게 하다
blench : vi, vt, 희어(푸르러)지다, 희게(푸르게)하다
blend : vi, vt, n, 섞이다, 융화하다, 조화하다, 혼합물
blende : n, 섬아연광
blended : a, (차, 담배, 술 등이)혼합된, 블렌드된, (직물이)혼방의
blended whiskey : x, 블랜드위스키(보통 malt whiskey와 grain whiskey를 혼합한 것)
blender : n, 혼합하는것, 믹서, 혼합하는 사람
blending : n, 혼합(물), 혼성어
Blenheim : n, 황금빛 사과, 삽살개의 일종
blenny : n, 베도라치
blent : v, BLEND의 과거, 과거분사
bleomycin : n, 블레오마이신(항생 물질, 폐암, 피부암 치료용)
blepharitis : n, 안검염
blepharoplasty : n, 안검 형성
blesbok : n, 블레스복(얼굴에 크고 흰 반점이 있는 남아프리카산 영양)
bless : vt, 정화하다, 찬미하다, 은총을 내리다, 수호하다
blessed : a, 신성한, 복된, 축복을 받은, 행복한
blessedly : ad, 다행히도(happily)
blessedness : n, 행운, 행복
blessing : vt, (신의)가호, 은총, 축복, 식전(식후)의 기도, 행복, 고마운 것
blest : v, a, bless의 과거부사-=BLESSED
blether : v, n, =BLATHER
blew : v, blow의 과거
blight : n, vt, 말라죽는 병, 병균, 해충, 암영-말라죽게 하다, 파멸시키다
blighter : n, 영국 본국, (제 1차 대전때)본국에 송환될 정도의 큰 부상, 귀국 휴가
blimey : xint, 아차!, 아뿔싸!, 제기랄!, 깜짝이야!
blimp : n, 소형 연식 비행선, 완고한 보수주의자
blind : a, vt, n, 장민의, 눈먼, 맹목적인, 어리석은, 이성을 잃은, 숨은, 문, 막다른-눈멀게 하다, 속이다-블라인드, 커튼, 발, 차일
blindage : n, 방탄벽(참호 내의)
blind alley : x, 막다른 골목, 막바지, 전도가 없는 형세
blind date : x, (소개에 의한)서로 모르는 남녀간의 데이트
blinder : n, 혼합물, 혼성어
blindfish : n, 맹어(눈이 없는 물고기, 눈이 퇴화된 심해어)
blind flying : x, 맹목 비행(레이다 따위의 계기에만 의존하는 비행)
blindfold : vt, a, ad, 눈을 가리다, 어찌할 바를 모르게 하다, 속이다-눈이 가려진9가려져), 무모한
blindfoled : vt, 눈을 가리다, 어찌할 바를 모르게 하다, 속이다, 눈이 가려진, 무모한
blinding : n, 눈을 멀게 (부시게)하는, 현혹시키는, 새 포장 도로의 틈새기를 메우기 위한 모래, 자갈, 침상(mattress)
blind landing : x, 계기착륙
blindly : ad, 맹목적으로, 무턱대고
blind man : x, 장님
blindman : n, 수신인 주소 성명 판독계원
blindman's buff : x, 소경놀이
blindpig : x, 주류밀매점
blindreader : n, =BLINDMAN
blind shell : x, 불발탄
blindside : vt, (상대의)무방비한 곳(약점)을 공격하다, 기습 공격을 감행하다
blind spot : x, 맹점, 수신감도가 나쁜지역
blindstamp : vt, (표지에)민누름하다
blindstitch : vt, vi, 공그르다
blindstory : n, 창문이 없는 층(교회당의 광선을 들어오게 하는 창 밑의 복도)
blindworm : n, 발없는도마뱀
blinger : n, 극단적인 것(사례)
blink : vi, vt, n, 깜박거리다, 반짝거리다, 힐끔보다, 무시하다-깜박거림, 섬광
blinkard : n, 눈깜작이, 얼간이, 바보
blinker : n, 눈깜작이, 추파를 던지는 여자, (말의)눈가리개 가죽, 먼지 막는 안경(goggles), 눈, 명멸광(신호등)(경계표), (자동차의)방향 지시기, 깜박이(winkers)
blinking : a, ad, 깜박거리는, 명멸하는, 어처구니 없는, 지독한(bloody), 지독하게, 굉장히
blintz : n, 일종의즐은핫케이크
blintze : n, 블린츠(치즈, 잼 등을 채워서 구운 팬케이크)
blip : n, 영상, 레이더의 영상
blisery : a, 물집이 있는, 물집투성이의
bliss : n, 더없는행복, 지복
blissful : a, 행복한
blister : n, vi, vt, 물집, 물집이생기다, 돌출부, 중상하다
blister copper : x, 조동
blistering : a, 물집이 생기게 하는(듯한), 타는 듯한, (비평이)신랄한, 통렬한, 격렬한, 비난하는, 창피를 주는
blithe : a, 명항한, 쾌활한, 유쾌한, 행복한
blithering : a, 수다스러운
blithesome : a, =BLITHE
blitz : n, vt, 전격전을가하다, 급습하다
blitzed : a, 술에 취한(drunk)
blitzkrieg : n, 전격전
blizzard : n, 심한눈보라
bllowy : a, 너울의, 물결이 높은
bloat : vi, vt, 부풀리다, 자부하다, 훈제하다
bloated : a, 부풀은, 우쭐대는
bloater : n, vt, 훈제한 청어, (청어를)훈제하다
blob : n, vi, vt, 한방울, 작은 얼룩점, 영점-뚝하고 듣다, 떨어지다, 튀다
blobberlipped : a, 입술을 두껍게 내민(사람 등)
bloc : n, 권한, 권, 블럭
block : n, vt, 덩어리, 받침, 모탕, (시가의)한 구획, 한 장씩 떼어 쓰게 된 것, 불록(한 단위로 취급하는 연속된 언어의 집단)-방해하다, 막다, 봉쇄하다
blockade : n, vt, 봉쇄, 폐쇄, 교통차단, 경제봉쇄
blockader : n, 봉쇄하는 사람(것), 폐색선
blockaderunner : n, 봉쇄 돌파시(선), 밀항자(선)
blockage : n, 봉쇄, 방해, 저해, 방해물, (파이프 등에)막혀 있는 것
blockball : n, 장애구
blockboard : n, 합판, 베니어판
blockbust : vt, (백인 부동산 소유주에게)blockbusting을 하다
blockbuster : n, 고성능대형폭탄
block diagram : x, 장치부품배치도표
blocked : a, 막힌, 폐색된, 봉쇄된, 마약에 취한
blockfront : n, (책상, 장롱 등의)중앙이 양끝보다 쑥 들어간 정면, 가구(블록)의 정면
blockhead : n, 바보
blockhead : n, 멍청이, 얼간이, 아둔패기
blockhouse : n, 토치카, 작은 목조 요새, 로켓발사 관제소
blockhouse : n, 작은 요새, 토치카, (옛날의)통나무 방책, (로켓 기지 등의)철근 콘크리트 건물(열, 돌풍, 방사능 등을 막는)
blocking : n, 오리대(틈을 메우는 나뭇조각), 블로킹, 저지 현상(바람직하지 않은 상념에 의한 연상 중단), (배우의)연출, 블로킹하기
blockish : a, 목석같은, 어리석은
block letter : x, 블럭자체
block letter : x, 블로 자체
block printing : x, 목판인쇄
block printing : x, 목판 인쇄
blockship : n, (항구, 항로를 사용 불능케 하려고 침몰시키는)폐색선
blocky : a, 뭉툭한, 농담의 채가 있는
bloke : n, 놈(fellowchap)
blonde : a, n, 블론드의사람, 금발 흰 피부의 사람
blondie : n, 금발(블론드)의 여자, 블론디(만화의 여주인공, 남편은 Dagwood)
blood : n, 피, 혈액, 혈통, 순종, 살육
bloodandguts : a, 끔찍한, 지독한(적개심), 피비린내 나는 (이야기)
bloodandthunder : a, 폭력과 유혈의, 살벌한, 저속한(소설, 영화 등)
blood bank : x, 혈액은행
blood bath : x, 대학살
blood brother : x, 친형제, 피로서 맺은 형제
blood cell : x, 혈구
blood clot : x, 혈병, 혈괴
blood count : x, 혈구수측정
bloodcurdler : n, 센세이셔널한 이야기(기사, 책 등)
bloodcurdling : a, 소름끼치는
blood donor : x, 헌혈자
blooded : a, ...혈의, ...기질의, 순혈의, 전투를 경험한 (군대), 새로운 경험을 쌓은
bloodgiven : a, 혈연에 의한, 동족의
blood group : x, 혈액형
bloodguilt : n, 유혈의 죄, 살인죄
bloodguilty : a, 사람을죽인
blood heat : x, 혈온(인간의 표준 체온, 보통 37도)
bloodhorse : n, 순종의말
bloodhound : n, 경찰견, 탐정
bloodily : ad, 피투성이가 되어, 참혹하게, 무참하게
bloodiness : n, 피투성이, 잔인
bloodless : a, 핏기가없는
bloodletting : n, 방혈, 유혈
bloodline : n, 혈통, 혈족
bloodlust : n, 유혈에의욕망
bloodmobile : n, 피흘리지 않는, 무혈의, 기운 없는, 무정한
blood money : x, 살인사례금, (적기를 격추한 자에게 주는)공로금, 위자료
blood poisoning : x, 패혈증
blood pressure : x, 혈압
bloodrags : n, pl, 월경
bloodred : a, 피처럼 새빨간, 피로 물들인
blood relation : x, 혈족
bloodroot : n, 양기비과의식물
blood royal : x, 왕족
bloodshed : n, 유혈, 참사
bloodshot : a, 충혈된
bloodstained : a, 피묻은, 살인을 한
bloodstock : n, 순종의말
bloodstone : n, 혈옥수
bloodsucker : n, 흡혈귀, 고혈을 빠는 사람, 식객
blood test : x, 혈액검사
bloodtest : vt, 혈액 검사를 하다
bloodthirsty : a, 피에굶주린
blood transgusion : x, 수혈법
blood vessel : x, 혈관
bloodwarm : a, 혈온의, 뜨듯한
bloodworm : n, 붉은 지렁이(낚시 밥용)
bloodworm : n, 붉은지렁이
bloody : a, vt, 피투성이의, 잔인한, 피의, 심한, 피투성이를 만들다
bloody mary : x, 보드카와 토마토쥬스를 섞어만든 칵테일
bloodyminded : a, 냉혹한, 살벌한, 잔인한, 심술궂은, 비뚤어진, 괴팍한
blooey : a, 고장난
bloom : n, vi, 꽃, 개화기, 건강한-피다, 번영하다
bloom : n, 쇳덩이
bloomary : n, =BLOOMERY
bloomed : a, (렌즈가)코팅된(coated)
bloomer : n, =BONER
bloomers : n, pl, 블루머, (여자 소녀용의 운동용 팬츠)
bloomery : n, 괴철로, 괴철공장
Bloomfield : n, 블룸필드(1887-1949)(미국의 언어 학자
blooming : a, 활짝핀, 한차인, 번영하는, 지독한, 어처구니없는
bloomy : a, 꽃이 만발한, (과실 등이)흰 가루가 생긴, 청춘의, 꽃피는, 젊고 아름다움과 힘에 넘치는
bloop : vt, 텍사스히트를치다
blooper : n, 큰실수, 역회전의 높은공, 텍사스 히트
bloshevism : n, 과격주의사상
blossom : vt, n, 꽃, 청춘, 피다, 번영하다
blot : n, vt, (잉크 따위의)얼룩, 때, 오점, 오명, 결점-더럽히다, 지우다, 감추다
blotch : n, 얼룩, 종기, 점
blotched : a, 얼룩진
blotchy : a, 부스럼(얼룩)투성이의
blotter : n, 압지, 기록부
blottesque : n, 마구 그린, 조잡하게 만든 (예술품 등)
blotting paper : x, 압지
blotto : a, 곤드레만드레취한
blouestone : n, 황산동, 푸른돌(청회색의 바닥돌, 건축재료)
blouse : n, 블라우스(여자, 어리이용의 셔츠의 웃옷), 군복의 상의
blouson : n, 여성용재킷(허리 부분을 고무나벨트로 대어 불록하게 되도록 한옷)
bloviate : vi, 거침없이 장황하게 말하다
blow : vi, vt, n, 불다, 바람에 날리다, 휘몰아치다, 한번 불기, 취주, 개화, 타격, 강타
blowball : n, 관모구(민들레 등의 솜털이 붙은 열매)
blowby : n, 블로바이(피스톤과 실린더 사이의 가스 누출)
blowbyblow : a, 상세한
blowdry : n, (머리를)드라이어로 매만지다, 블로 드라이(드라이어로 머리를 매만지기)vt, n, 
blowfish : n, 몸을 부풀리는 고기(복어 등)
blower : n, 부는사람, 송풍기, 유리부는 사람
blowfly : n, 금파리
blowgun : n, (불어서 화살을 쏘아 보내는 남미 인디언 등의)취관, 분무기
blowhard : n, 허풍선이
blowhole : n, (고래의)물뿜는 구멍, (지하실의)통풍구, 바람 구멍, (고래, 바다표범 등이 호흡하러 오는)얼음에 난 구멍, (주물의)기포
blowin : n, 환영받지 못하는 신참자, 타관 사람
blowing : n, (공기나 증기의)분출하는 소리, 취입 성형, 재즈 연주
blowlamp : n, =BLOWTORCH
blowmobile : n, (북극에서 쓰는)스키 자동차(프로펠러를 이용함)
blown : v, blow의과거분사
blowninthebottle : a, 진짜의, 진정한
blownup : a, (사진을)확대한, 파괴된, 과장된
blowoff : a, 분출(장치), 허풍선이, 끝(end), 흥미를 끄는 것, 인기 있는 것 n, 
blowsy : a, =BLOWZY
blowout : n, 분출, 빵꾸, 용해, 큰잔치, 대향연
blowpipe : n, 취관, 제트기
blowtop : n, 불뚱이, 뼛성쟁이
blowtorch : n, (파이프공의)발염장치, 토치램프
blowtube : a, =BLOWPIPE=BLOWGUN
blowup : n, 폭팔, 발끈화냄
blow wash : x, 뜨거운가스분출
blowwave : n, vt, 블로 웨이브(머리를 드라이어로 매만지기), (머리를)드라이어와 브러시로 매만지다
blowy : a, 바람이 센
blowzed : a, =BLOWZY
blowzy : a, 단정치못한, 봉두난발의, 지저분한, 고상치못한, 얼굴이 불그레한
blubber : vi, vt, 엉엉욺, 엉엉울다, 눈물로 얼룩지게하다, 울며 말하다
blubber lip : x, 두꺼운입술
blucher : n, 혀와 닫이가 한 가죽으로 된 단화, 반장화의 일종
bluchers : n, 한장의가죽으로된구두
bludge : n, vi, vt, 간단한(쉬운, 편한)일, (일자리가 없어 놀고 있는)시기, 때, (일을)꾀부리다, 농뗑이 부리다
bludgeon : n, 곤봉
blue : 푸른, 하늘색(청색)의, 남색의, 우울한, 비관적인, (사태가)여의치 않은, 푸른 옷을 입은, (영국)보수당(Tory)의, (바람 등이)찬(cold, chill), (추의, 공포 등으로)창백한, (맞거나 하여)검푸른, 푸르죽죽한, 엄격한, 딱딱한, 음란한, 외설한, 학식이 있는, 인텔리의(여자), 블루스 조의
blue : a, n, 푸른, 음울한, 우울한-파랑, 남빛
blue baby : x, 청색아(선천성 심질환, 페확장 부전의 유아)
bluebag : n, (흰 세탁물용의)청분(의 작은봉지)
bluebeard : n, 푸른수염(6명의 아내를 죽였다는 전설의남자), 잔인한 남편
bluebell : n, 초롱꽃, 종 모양의 푸른 꽃이 피는 풀(야신의 히아신스, 초롱꽃 따위)
blueberry : n, 월귤나무의일종
bluebill : n, 물오리(미국산)
bluebird : n, (날개가)푸른 울새(북미산 유리울새속, 순경
bluebird : n, 푸른새, 지빠귀과의 일종(일종)
blueblack : a, 짙은 남빛의
blueblack : a, 암청색의
blue blood : x, 명문(피부가 희고 정맥이 비쳐 보이는 데서), 귀족
blueblooded : a, 귀족 출신의, 명문의
bluebonnet : n, 청색 모자, 스코틀랜드 사람, 수레국화
bluebonnet : n, 스코트랜드병, 수레국화
blue book : x, 영국의회보고서, 푸른 표지 답안지 철, 신사록
bluebottle : n, 수레국화, 청파리
bluebottle : n, 금파리, 수레국화
bluebrick university : x, 전통있는대학
bluechip : a, 확실한, 우량한(증권), (특정 분야에)일류의, 탁월한
bluecoat : n, 청람색 제복의 사람(미국의 순경, 옛 육, 해, 군인, 특히 미국 남북 전쟁 때의 북군 군인), 경관
bluecoat : n, 경관, (19섹의)병사
bluecoated : a, 남색 제복을 입은
bluecollar : a, (작업복용 청색 셔츠에서)육체 노동(자)의
bluecollar : a, 육체노동의, 작업복의
blue devils : x, 우울증
blueeyed : a, 눈알이 푸른, 푸른 눈을 가진, 백인의, 백색 인종의(특히 흑인 영어에서)순진한
bluefish : n, 전갱이, 전갱이의 무리
bluegill : n, 송어의 일종(미시시피강 유역산의 식용어)
bluegrass : n, 새포아풀속의 풀(목초, 건초용), 블루그래스(미국 남부의 백인 민속음악에서 생긴 컨트리 음악)
bluegrass : n, 새포아풀속의목초
bluegreen : n, 청록색
blueing : n, =BLUING
blueish : a, =BLUISH
bluejacket : n, (해병대와 구별하여)수병
bluejacket : n, 수병
blue jeans : x, 청바지
blue laws : x, 엄법(주일의 오락, 근로를 금지한 식민지 시대의청교도적인 법률)
blue monday : x, 사순절전의월요일, 우울한 월요일
blueness : n, 푸른 상태, 푸름
bluenose : n, (극단적으로)청교도적인 사람, (캐나다의)Nova Scotia주의 주민
bluenose : n, 극단적인도덕가, 잔소리꾼
bluepencil : vt, 파란연필로원고를수정하다, 정정하다
blue peter : x, 출범기
bluepoint : n, (날로 먹는)작은 굴
blueprint : n, vt, 청사진(을 찍다), 상세한 계획(을 세우다)
blueprint : n, vt, 청사진, 계획하다
blueprinting : n, 청사진(법)
blue racer : x, 뱀의일종
blueribbom jury : x, (중대 형사 사건의)특별 배심원
blue ribbon : x, 카터 훈장의)푸른리본, 일등상, 최고의 명예, 금주의 회원장
blueribbon : a, 일류의, 최고의
blueribbon jury : x, 특별배심원
blue ruin : x, 질이낮은진술
blues : n, a, 우울한 기분, 우울증(melancholy), (재즈 음악의)블루스(노래, 곡, 춤), 미국 해군 (육군, 공군)제복, 블루스의
Blues : n, (영국의)근위기병 제 3연대(the Royal Horse Guards의 통칭)
blue scy law : x, 부정 증권 거래 단속법
bluesky : a, 창공의, 거의 무가치한 (증권), 재정적으로 불건전한, 막연한, 구체성이 없는
blue sky : x, 푸른하늘
bluesky law : x, 부정증권거래단속법
bluesman : n, 블루스 가수(연주자)
bluestocking : n, (18세기 런던의)청탑회원, 엷 문핫자
bluestocking : n, 청탑회원, 여류문학자
bluestone : n, 황산동, 푸른돌(건축재료)
blue stread : x, 번개, 전광석화(같이 빠른것)
blue streak : x, 번개, 전광석
bluet : n, 파란 꽃이 피는 식물, 꼭두서니과의 화초(북미산)
bluet : n, 파란꽃이피는식물
bluff : n, a, vi, vt, 허세, 허세부리다, 속임, 속이다
bluffy : a, 벼랑의(이 있는)
bluing : a, 청색물감(표백제의 일종)
bluish : a, 푸르스름한
blunder : n, vi, vt, 큰실수, 큰실수를 하다, 잘못하다, 머뭇머뭇하다
blunderbuss : n, 나팔총
blunderer : n, 큰 실수를 저지르는 사람, 얼간이
blundering : a, 실수하는, 서투른, 투미한
blunge : vt, (도토 등을)물과 섞어 반죽하다
blunger : n, 반죽하는 사람(그릇)
blunt : a, 날이무딘, 날 없는, 들지 않는-무디게하다, 무디어지다
bluntly : ad, 무디게
blur : vt, vi, 더럽히다, 더러워지다, 흐리게하다-더러움, 몽롱, 오점, 오명
blurb : n, 선전, 광고, 광고문구
blurry : a, 더러워진, 흐릿한
blurt : vt, 무심결에말하다
blush : n, vi, 얼굴을붉히다, 부끄러워하다, 빨개지다, 붉히다
blusher : n, 볼연지
blushful : a, 얼굴을 붉히는, 수줍어 하는, 볼그레한
blushing : a, n, 얼굴이 빨개진, 부끄럼을 잘 타는, 조심성 있는, 얼굴을 붉힘, 부끄러워함
blushingly : ad, 얼굴을 붉혀서, 부끄러운 듯이
blushless : a, 염치없는, 철면피한
bluster : vi, n, 휘몰아치다, 휘몰아침, 거세게 일다
blusterer : n, 호통치는 사람, 난폭한 사람, 뽐내는(거드름 피우는)사람
blustering : a, 세차게 몰아치는, 호통치는, 뽐내는
blusterous : a, =BLUSTERING
boa : n, 큰구렁이, 보아(모피로 만든 길 목도리)
BOADICEA : x, British Overseas Airways Digital Information Computer for Electronic Automation
Boanerges : n, 보아너게(우뢰의 아들, 예수가 제자 야고보(James)및 요한(Jhon)에게 붙인 이름, 마가복음 3:17), 목소리가 큰(열변의)연설가(설교사)
Boanywash : n, 보스니워시(미국 동부의 인구 조밀 지대, New England에서 Washington)
boar : n, 수퇘지, 멧돼지
board : n, vt, vi, 널판, 대판, 판지, 마분지, 식탁, 식사, 회의, 평의원회, 위원회, 증권거래소-널을대다, 식사를주다, 승차하다-하숙하다, 식사하다
boardasiling : n, 보드 세일링(서핑과 세일링을 합친 수상 스포츠)
boarder : n, 학숙인, 기숙생
boarding : n, (널)판장, 기숙
boardinghouse : n, 하숙집, 기숙사
boarding out : x, 외식
boarding school : x, 기숙사제학교
board meeting : x, 중역회
board meeting : x, 중역회의
boardroom : n, (주로)중역회의실
boardwalk : n, 판자를 깐 길, (바닷가 등의)판자 산책로, (공사장의)비계
boardwalk : n, 널을깐보도
boardy : a, 단단한, 딱딱한(stiff)
boarhound : n, 멧돼지 사냥용의 큰 개(그레이트 데인 등)
boarish : a, 돼지같은, 잔인한, 음욕이성한
boast : vi, vt, 자랑하다, 가지고 있다
boaster : n, 자랑꾼, 허풍선이
boastful : a, 자랑하는, 자랑하고 싶어하는, 허풍을 떠는, 과장된, (이야기 등)자화자찬의
boasting : a, 자랑, 거만, 자랑하는(하고 싶어하는)
boat : n, vi, vt, 보트, 기선, 배 모양의 그릇-배로 가다, 나르다, 배에 싣다
boatable : a, (강 등이)거슬러 올라 갈 수 있는, 항행할 수 있는, 배로 나를수 있는
boatage : n, 뱃삯, 작은 배의 운반력(적재량)
boatbill : n, 넓은 부리해오라기(열대 아메리카산)
boatbuilder : n, 보트(배)건조인, 선장
boatel : n, 보텔, (자가용배로 여행하는 사람을 위한 물가의 호텔
boater : n, 보텔(보트 소유자나 선객을 위한 물가의 호텔), boatel영업의 배
boatful : n, 한 보트(배) 가득한 수(양)
boathook : n, (보트를 잡아당기는)갈고리 장대
boathouse : n, 보트창고
boating : n, 뱃놀이
boating : n, a, 배젓기, 뱃놀이, 작은 배로 하는 운송업, (형용사적으로)보트 젓기(용)의, 뱃놀이의
boatlift : n, 긴급 해상 수송 작전(대소 선박에 의한 많은 인원, 물자의)
boatload : n, 배의적재량, 배 한 척 분의 화물
boatman : n, 뱃사공, 보트 젓는 사람, 보트 세 놋는 사람
boatrace : n, 보트경주
boatrocker : n, 문제를일으키는인물
boatswain : n, 갑판장, 병조장
boatyard : n, 소형선 조선(수리)소(보트, 요트 등의 수리, 보관, 제조)
bob : n, vt, vi, 추, 휙움직임, 찌-휙움직이다, 짧게자르다, 가볍게 침, 실링
bob : n, vt, 가볍게 침
bob : n, 실링
bobbed : a, 꼬리를 자른, 단발의(을 한)
bobber : n, 낚시찌
bobbery : n, 대소동, 야단법석
Bobbie : n, 남자 이름, 여자 이름(Barbara, Roberta의 애칭
bobbin : n, 살감개, 보빈, 가는실
bobbinet : n, 망사직
bobbing : n, 단발(법), 보빙(레이더의 반사파가 불규칙적으로 수신되는)
bobbish : a, 기분좋은, 기운찬
bobble : vi, vt, 깐닥깐닥상하로움직이다
bobby : n, 경관, 순경
Bobby : n, 남자 이름, 여자 이름(Barbara, Roberta의 애칭)
bobbydazzler : n, 번쩍번쩍 하는 것, 멋있는(굉장한) 것, 매력적인 아가씨
bobby pin : x, 머리핀의 일종
bobbysocks : n, 양말(발목까지 오는 소년용)
bobbysoxer : n, (유행을 따르는)10대의소녀
bobcat : n, (아메리카산의)살쾡이
boblet : n, 2인승 BOBSLED
bobolink : n, 쌀새류(미국산의 명금)
bobsled : n, vi, 연결썰매, 썰매를 타다
bobsledding : n, 봅슬레이 경기
bobstay : n, 제1사장 버팀
bobtail : n, 자른꼬리
bobwhite : n, 메추라기의일종(북미산)
Boccaccio : n, Giovani(1313-75)이탈리아의 작가, 시인
boceful : a, 징조가 되는, 불길한
bocega : n, 포도주 파는 술집, 포도주 저장 창고, 식품 잡화점
bock : n, 독한흑맥주
bocor : n, 부두(voodoo)의 마술사, 주의
bod : n, 몸
BOD : x, biochemicl oxygen demand 생물 화학적 산소 요구량
bodacious : a, 틀림없는, 완전한, 주목할만한, 대담무쌍한
bode : vi, vt, 조짐을나타내다, 조짐이되다, 징조가 나쁘다
bode : v, bide의 과거
bodement : n, 징조, 전조, 조짐, 예언
bodge : n, vt, vi, =BOTCH
bodger : a, 하등의, 무가치한, 가명의
bodice : n, 보디스, 꽉끼는
bodied : a, 동체(육체)가 있는, 몸이 ...한, 실체가 있는, (음료 등이)감칠맛이 있는
bodiless : a, 몸통이없는, 실체가 없는, 무형의
bodily : a, ad, 몸의, 육체적인-몸소, 통째로, 모조리
boding : a, n, 징조의, 징조가 되는, 불길한, 징조(omen), 흉조
bodkin : n, 돗바늘, 송곳바늘, 긴 머리 핀
bodsman : n, 보증인
body : n, vt, 몸, 육체, 몸통, 동의, 시체, 신병, 주부, 본문(서문, 일러두기, 무록 따위에 대하여), 대, 떼, 사람, 물체-형체를 주다
bodybuilder : n, 보디빌딩용기구, 보디빌딩 하는 사람, 영양식
bodybuilding : n, 보디 빌디, 육체미 조형
bodyguard : n, 호위, 호위병
body shop : x, 차체공장, 차체 수리공장
body stocking : x, 보디스타킹, (몸에 꼭 맞는 스타킹식의 속옷)
bodywork : n, 차체, 차체의 수리 공장
Boeotian : a, n, 보에오티아(고대 그리스의 한지방)의 사람, 둔흔, 느리광이
Boer : n, 보어 사람(남 아프리카 Transvaal 등지의 네델란드계의 백인)
bofey : n, 기준타수
boff : n, 큰웃음, 폭소를 노린 대사, 히트
boffin : n, 과학자
boffo : a, n, 히트의
Bofors : n, 2연장 자동 고사포
bog : n, vi, vt, 소택지, 수렁, 수렁에 가라앉다
boggle : vi, n, 주춤거리다, 주춤거림, 머뭇거리다
bogle : n, 도깨비, 귀신, 요괴
bogota : n, 남미콜롬비아의 수도
bogus : a, 가짜의, 엉터리의
bogwood : n, 묻힌나무
bogy : n, 도깨비, 귀신, 유령
bohea : n, 질이 낮은 홍차
bohemia : n, 체코슬로비아 사부의 주
bohemian : a, n, 보히미아의, 보히미아 사람, 방랑자
bohunk : n, (외국인 특히, 동유럽계 이민의)하급노동자
boil : vi, vt, 끓이다, 비등하다, 삶다, 데치다, 격분하다, 비등, 종기, 부스럼
boiler : n, 보일러, 끓이는 그릇
boilermaker : n, 보일러 제조자, 맥주를 탄 위스키
boiling : n, a, 비등, 끓음, 비등하는
boiling point : x, 비등점
boiloff : n, 연료의증발
boilover : n, (경마 등에서의)예상밖의 결과
boilup : n, 차 끓이기
boisterous : a, 사납게몰아치는, 난폭한, 야단법석의, 소란스러운
BOK : x, Bank of Korea
boke : n, 코(nose)
boko : n, 코
bola : n, 올가미
bold : a, 대담한, 거리낌없는, 굵은, 뚜렷한, 가파른
boldface : n, 굵은활자, 볼드체 활자
boldfaced : a, 뻔뻔한, 볼드체의
boldly : ad, 대담하게, 뻔뻔스럽게, 뚜렷이
boldness : n, 대담함
bole : n, 나무줄기(trumk)
bolection : n, 볼록 몰딩
bolero : n, 볼레로(경쾌한 스페인 무도곡)'블레로(여자의짧고 앞이 트인 웃옷)
bolide : n, 불덩이(폭발)유성, 폭발 화구
bolivar : n, 은화, 화폐단위
Bolivia : n, 남미의공화국, 부드러운 모직물의 일종
Bolivian : a, n, 볼리비아의(사람)
boliviano : n, 볼리비아노(볼리비아의 화폐 단위, 기호 B, =100 centavos), 1 볼리비아노 화(지폐)
boll : n, (목화, 아마 따위의)둥근꼬투리
bollard : n, 배매는기둥
bollix : vt, 엉망이되게하다
bollocks : n, vt, 시시한(얼빠진) 짓, 허튼소리(nonsense), 고환, 불알, (...을)엉망으로 만들다, 망쳐놓다
bollworm : n, 솜벌레의유충(목화씨를 먹음)
bolo : n, (외날의)대형 나이프(필리핀 제도와 미육균에서 사용)
bologna : n, 아탈리아북부도시, 볼로냐소시지(굵고 네모)
bolograph : n, 자기 저항 복사계
bolometer : n, 저항방사열제
boloney : n, =BALONEY
Bolshevik : a, n, 볼셰비키, 다수파, 과격파
Bolsheviki : n, pl, 다수파, 과결파(러시아 사회 민주당의 급진파, 동국 공산당(1918-)의 모체)
Bolshevism : n, 과격주의
Bolshevist : n, a, 볼셰비키의 일워, 과격론
Bolshevize : vt, 볼셰비키화 하다, 적화 하다
Bolshie : a, 과격주의자, 과격파의, 체제에 반항하는, 좌익의
bolster : n, vi, vt, 긴베개, 받침, 메우는 물건, 메우다
bolt : n , vi, 빗장, 볼트, 전광, 번개불, 굵은 화살, 도주-뛰어나가다, 빗장으로 걸다, 음미하다
bolt : n, vt, 체질하다, 음미하다
bolter : n, 질주하는 말, 탈주자, 탈당자
bolthole : n, (토끼 등이 숨는)구멍, 안전한 은신처, (현실로부터의)도피소
bolting : n, 볼토(로)조이기, 음식물을 통째로 삼킴, 도망, 추대
bolton : a, (차의 부품 등이)볼트로 죄는
boltrope : n, 볼트로프(돛 주변의 보강 밧줄), 질 좋은 (튼튼한) 밧줄
bolus : n, 큰알약
boma : n, (중앙 및 동 아프리카), 방벽, (경찰, 군대의)초소, 치안 판사 사무소
bomb : n, vt, 폭탄, 수류탄, 폭탄 선언, 큰 실패, 대성공-폭격하다
bomb : n, vt, 폭탄, 수류탄, 폭탄선언, 폭격하다
bombard : vt, 포격하다, 욕하다, 비방하다
bombardier : n, 폭격수, 포병 하사관
bombardment : n, 포격, 폭격, 충격
bombardon : n, 대형 저음 금관악기의 일종, (풍금의)저음 음전
bombast : n, a, 호언 장담, 과장된
bombastic : a, 과대한, 과대한
Bombay : n, 봄베이(인도의 항구 도시, Maharashtra주의 수도)
bombazine : n, 봄버진(날실은 명주실, 씨실은 털실 증직, 주로 여성 상복)
bomb disposal : x, 불발탄처리
bombe : n, 멜론에 수종의 아이스크림을 넣어 얼린 식후용 과자
bombed : a, 술이나마약에취한
bombedout : a, 공습으로 집이 타 버린
bomber : n, 폭격기
bomber : n, 폭탄병, 폭탄 투하자, 폭격기, 폭파법, 마리화나 담배
bombhappy : a, 포탄(전투)노이로제의, 폭격으로 신경쇠약에 걸린(shellshocked)
bombing : n, 폭격, (상대방 등을)무찌르기
bombing plane : x, 폭격기
bombita : n, (마약 상용자가 쓰는)암페타민의 정체(캡슐)
bomblet : n, 소형 폭탄
bomb load : x, 폭탄적재량
bombproof : a, 폭탄에 견디는
bomb rack : x, 폭탄시렁
bomb rack : x, (비행기의) 톡탄 시렁
bombshell : n, 폭탄, 돌발사건
bombsight : n, 폭격조준기
bombsite : n, (공습 받아)폭파된 터(잔해), 피폭지
bombycid : n, 누에 나방의 일종
bon : a, 안녕하십니까
bona fide : x, 진실한, 성의있는
bonanza : n, 노다지광맥, (함유량이 풍부한)광맥, 대성공, 행운, 노다지, 운수 대통, (농장의)대풍년, 보고
Bonaparte : n, 보나 파르트
Bonapartist : n, a, 나폴레옹 1세 지지자(의)
bonbon : n, 대성공, 큰벌이
bonbonniere : n, 봉봉 그릇
bonce : n, 큰 공기돌, 그것
bond : n, vt, 묶는것, 끈, 새끼, 기반, 증서, 보증인-채권으로 대체하다, 사로 잡히다, 보세 창고에 넣다, 결합하다, (벽돌, 돌을)엇물림으로 샅다
bond : a, 사로잡힌, 노예의
bondage : n, 노예의신분
bonded : a, 접착제로 붙인, 공채(채권)로 보증된, 담보가 붙은, 보세 창고에 유치된, 보세품의
bonded factory : x, 보세공장
bonded warehouse : x, 보세창고
bonder : n, 보세 화물의 소유주=BONDSTONE
bondholder : n, 공사채권소유자
bonding : n, 조적식 쌓기, 접합, 결합, 접속, 긴밀한 유대(공동 생활로 인한 모자간 등의)
bondmaid : n, 여자 노예
bondman : n, 노예, 농노, 보증인
bondocks : n, 삼림지대, 오지, 벽지
bondstone : n, 받침돌, 이음돌
bondswoman : n, =BONDWOMAN, 여성 보증인
bondwoman : n, 여자 노예
bone : n, vt, vi, 뼈, 뼈로만든것, 해골, 골격, 몸-뼈를발라내다, 골분 비료를 주다-공부만 들이 파다
boned : n, 뼈가 ...한, 고래 수염을 넣은(코르셋 등), 뼈를 추려낸(생선 등)
bonedry : a, 바싹마른, 절대금주의
bone dust : x, 골분
bone dust : x, 골분(비료, 사료)
boneeater : n, 개
bonehead : n, 얼간이, 바보
boneidle : a, 매우 게으른
bonelazy : a, 매우 게으른
boner : n, 큰실수, 실책
boneset : n, 등골나무의일종
bonesetter : n, 무면허접골사
bonesetting : n, 접골(술)
boneshaker : n, 구식 자전거(고무 타이어가 없는), 털털이 자동차(rattletrap)
bonetired : a, 지칠 대로 지친
boneweary : a, 매우 지친
boneyard : n, 폐차장, 묘지
bonfire : n, 화롯불, 모닥불
bong : n, vi, (종 등의)둥하는 소리, 댕, 동, 궁, 둥(댕, 궁)소리를 내다
bongo : n, 영양의일종, 봉고로 두드리는 긴북
bongoed : a, 술취한(drunk)
bonhomie : n, 혼용, 붙임성
bonhomous : a, 온후한, 쾌활한
boniface : n, 여인숙의 주인
boning : n, 뼈르 추려 냄, 골분 비료를 줌
bonism : n, 낙관설, 선세설(현세를 선으로 보는)
bonito : n, 가다랭이
bonk : n, 퉁, 통(부드러운 것이 부딪치는 소리), 일격, 1발
bonkers : a, 머리가 돌아, 정신이 이상하여, 열중하여
Bonn : n, 서부독일의수도
bonnet : n, 보닛, 여자모자, 남자모자, 덮개
bonny : a, 아름다운, 건강해 보이는
bonus : n, 보너스, 상여금, 특별배당금, 할증금
bony : a, 뼈의, 골질의, 뼈만 앙상한
bonze : n, (불교의)중
bonzer : a, 참 좋은, 근사한
boo : vi, vt, int, 피이하다, 피이(남을 놀라게 할때 지르는 소리)
boo : n, 마리화나
boob : n, 멍청이
boob tube : x, 텔레비젼
booby : n, 얼간이, 멍청이, 꼴찌, 가마우지의 일종
booby : n, 견조, 멍청이(fool)
booby hatch : x, 정신병원
booby prize : x, 꼴찌상
booby trap : x, 함정장치, 장난끼있는 함정장치
boobytrap : vt, 장치하다
boodle : n, 떼, 무리, 패, 뇌물, 매수금, 부정이득이 많은 돈
boodler : n, 독직공무원, 수회자
boogaloo : n, 부걸루(2박자로 발을 끌 듯이 어깨와 허리를 놀리는 춤)
boogie : n, 흑인, 매독, 코딱지=BOOGIEWOOGIE
boogiewoogie : n, 부기우기(재즈피아노곡의 일종)
boohoo : vi, n, 엉엉울다
book : n, vt, 책, 성서, 권, 편, 대본, 장부, 회계부, 명부, 공부하고 있는 중이다-(장부에)기입하다, (좌석을)예약하다, (...행의)표를 사다-좌석을 예약하다
bookable : a, (좌석 등)예약할 수 있는
book agent : x, 서적외판원
bookaholic : n, 독서 중독 환자
bookbinder : n, 제본업자(공)
bookbindery : n, 제본소
bookbinding : n, 제본(술)
book burning : x, 분서, 금서, 사상탄압
bookcase : n, 책장, 책꽃이
book club : x, 도서클럽, 독서회
book concern : x, 도서출판회사
bookend : n, 북엔드, 책버팀(책이 쓰러지지 않게 양끝에 세우는 것)
book end : x, 북엔드(책꽃이의 일종)
bookholder : n, 서안
bookie : n, 마권업자
booking : n, 치부, 기입, 예약, 출연 계약
bookish : a, 책의, 책을 좋아하는, 학식이 많은, 학자연하는, 서적상의, 탁상의
book jacket : x, 책 커버
bookkeeper : n, 장부계원
bookkeeping : n, 부기
bookland : n, 특허 자유 보유지(지대만 물면 됨)
booklearned : a, 책으로만 배운, 탁상 학문의, 실지 경험이 없는
booklet : n, 팸플렛, 작은 책자
booklore : n, 탁상의 학문
book louse : x, 책좀
booklover : n, 애서가
bookmaker : n, (이익 본위의)저작가, 편집가, 마권업자
bookmaker : n, 저술가(특히 돈만을 목적으로 난작하는), 책을 만드는 사람(제본, 인쇄업자 등), (사설)마권업자(bookie)
bookmaking : n, 서적 제조(업), (사설)마권업
bookman : n, 독서인, 문인, 학자, 서적상, 출판업자
bookmark : n, 서표
book matches : x, 종이성냥
bookmobile : n, 자동차 이동 도서관, 순회 도서관(traveling library)
book notice : x, 신간도서안내
bookplate : n, 장서표
bookrack : n, 책장, 책꽃이
bookrest : n, 서안, 서견대
book review : x, 서평
bookseller : n, 책장수
bookselling : n, 서적 판매(업)
bookshelf : n, 서가, 책선반
bookshop : n, 책방, 서점(bookstore)
bookslide : n, 자재 서가, 이동식 서가
bookstack : n, (도서관 등의)서가
bookstall : n, 헌책 파는 노점
bookstand : n, 서가
bookstore : n, 서점
booksy : a, 책을좋아하는척하는
bookteller : n, (녹음하기 위해 책을 읽는)낭독자
book token : x, 도서구입권
booktrough : n, V자형 서적 전시용 선반
book value : x, 장부가격
bookwork : n, 책(교과서)에 의한 연구(학습)(실습, 실험에 대하여), 학업
bookworm : n, 좀, 독서광
boolean algebra : x, 울림
boom : n, vi, vt, 벼락경기, 인기상승, 급등-진동하다, 울리다, 경기가 오르다-추어올리다, 돛의 아래 활대, 방
boom : n, 돛의 아래 활대, (항구의)방재, 기중의 가로대
boomandbust : n, 벼락경기, 일시적호황
boomer : n, 신흥지역으로모이는사람, 뜨내기 노동자, 큰 수캥거루
boomerang : n, 부메랑(던지 자리로 되돌아오는 오스트레일리아 통인의 무기), 하늘에 대고 침뱉기, 긁어부스럼
booming : a, 벼락 경기의, 급등하는
boomlet : n, 소 경기, 소형 붐
boomster : n, 경기를 부채질하는 사람(boomer)
boom town : x, 신흥도시
boom town : x, (벼락 결기로 생긴)신흥 도시
boomy : a, n, 경제적 붐의, 활황
boon : n, a, 은혜, 부탁, 유쾌한, 명랑한, 기분이 좋은
boondagger : n, 거친 성품의 힘센 여자(tough woman), 남자역의 여성 동성애자
boondoggle : n, vi, 쓸데없는짓, 쓸데 없는 짓을하다
boong : n, 오스트레일리아(뉴질랜드)의 원주민, 흑인, 유색인
boonies : n, pl, =BOONDOCKS
boor : n, a, 시골뜨기, 농사꾼, 우락부락한 사나이
boorish : a, 촌사람의, 촌티 나는, 상스러운, 본데없는(rude)
boost : n, vt, 뒤에서밀다, 값을 올리다
booster : n, 후원자(supporter), 승압기, (텔레비전, 리디오 등의)증폭기, 부스터(미사일, 노켓의 보조 추지니 장치)
boosterism : n, 열렬한 지지, 격찬, (도시, 관광지의)추어올리는 선전
booster rocket : x, 부스터로켓(로켓, 미사일의 추진, 증속에 쓰는 보조로켓)
boot : n, vt, 장화, 장화를 신기다, 구듯발질, 구둣발질하다, 덤, 쓸모있다
boot : n, vt, 덤으로-쓸모 있다
bootblack : n, 구두닦이
booted : a, 부츠(장화)를 신은, 해고당한, 경골에 깃털이 난
bootee : n, 여자용의목긴구두, 어린이용의 부드러운 구두
Bootes : n, 목자자리(일등성 Arcturus를 포함하는 북방 별자리)
bootfaced : a, 엄한표정의
booth : n, 노점, 오두막, 매점, 전화실
Booth : n, 부드(1829-1912)(구세군을 창시한 영국 목사)
bootie : n, =BOOTE
bootjack : n, 장화벗는기구
bootlace : n, 구두끈
bootleg : vt, n, 밀매하다, 밀수하다, 밀매주
bootlegger : n, (특히 미국의 금주법 시대의)주류 밀매(밀수, 밀조)자
bootlegging : n, 주류 밀매(밀수, 밀조)
bootless : a, 무익한
bootlick : vi, vt, 아첨하다
bootlicker : n, 아첨하는 사람
bootloader : n, 부트스트랩(bootstrap)로더(프로그램을 읽기 위한 프로그램을 넣는 장치)
bootmaker : n, 구두 만드는 사람, 구두 직공
boots : n, (호텔의)구두닦이(짐을 나르기도 함)
bootstrap : n, 편상화의손잡이가죽
bootstrapper : n, 입지전적인 사람, 자수 성가한 사람
boottle party : x, 술을 가자 지참하느 파티
boot tree : x, 구둣골
boot tree : x, 구둣골
booty : n, 전리품, 포획물, 이득
booze : n, vi, vt, 술, 술을 들이키다, 주연
boozehound : n, 대주가
boozer : n, 술꾼, 술집
boozeroo : n, 떠들썩한 술잔치, 싸구려 술집
boozeup : n, 주연, 술잔치
boozy : a, 술 취한, 술을 많이 마시는
bop : a, =bebop
bopeep : n, 아웅깍꼭놀이, 신출귀몰하다, 정체를 들어내지않다
bopster : n, 밥광
BOQ : n, Bachelor Officers' Quarters 독신 장교 숙사
bora : n, 보라, 아드리아해 연안 겨울의건조한 북동 한풍, 원주민의 성의식
boracic : a, =BORIC
boracic : a, =boric
boracite : n, 방붕석
borage : n, 서양지치
borate : n, vt, 붕산염, 붕산염으로 처리하다
borax : n, a, 붕사, 값싸고 번쩍이는
Borazon : n, 보라존, 다이아몬드보다 귿은 질화붕소의 결정체
Bordeaux : n, 보르도(항구도시)
border : n, vi, vt, 가장자리, 가, 가선, 경계, 국경-접하다, 가를 두르다
bordereau : n, 명세서, 각서
borderer : n, 국경(변경)의 주민, 잉글랜드와 스코틀랜드 경계지방의 주민, 테를 두르는 사람
bordering : n, 경계선 설치, 단대기, 테 두르기
borderland : n, 국경지대, 국경중간지대
borderline : n, a, 경계선, 경계선의, 이것도 저것도 아닌
bore : v, 구멍, 송곳구멍, 총구멍, 싫증나게하다, 구멍을 뚫다, bear의과거, 밀물, 해일
boreal : a, 북쪽의, 북풍의
Boreas : n, 북풍의신
bored : a, 지루한, 따분한
boredom : n, 권태, 지루한 것
borehole : n, (석유, 수맥 탐사용)시추공, 시굴공, 보링 구멍
borer : n, 구멍 뚫는 사람(기구), 송곳, 끌, 천공충, 나무좀, 좀조개
boresome : a, 지루한, 진절머리나는
boric : a, 붕소의, 붕소를 함유하는
boride : n, 붕화물
boring : n, a, 구멍뚫기, 시굴, 보링-싫증나게하는
born : v, a, 타고난, 태어난, bear의 과거분사
borne : v, bear의과거분사
Bornean : a, n, 보르네오의, 보르네오 사람, 보르네오 말
Borneo : n, 보르네오섬
borneol : n, 보르네올, 용뇌
bornite : n, 반동광
boron : n, 붕소
borough : n, 자치읍면, 자치도시, 국회의원선거구(로서의 시)
borrow : vi, vt, 빌다, 차용하다
borrowed : a, 빈, 차용한, 다른 데서 따온
borrower : n, 빌어 쓰는 사람, 꾸는 사람, 차용차
borrowing : n, 차용, 차용어, 빈 것
borscht : n, (당근즙을 넣은)러시아식 수프의 일종
borstal : n, (비행 소년들을 위한)감화원, 소년원
bort : n, 저품질의 다이아몬드, 공업용다이아몬드 부스러기
borzoi : n, 보르조이개
bos : n, vi, vt, 실책을하다
boscage : n, 수풀, 숲
bosk : n, 작은(관목) 수풀
bosk : n, 수풀
bosket : n, 수풀, 총림
bosky : a, 숲이 우거진, 나무 그늘이 있는(shady)
bosn : n, =BOATSWAIN
Bosnian : n, 보스니아(발칸 반도 서부의 옛 왕국)
Bosnian : a, 보스니아의
bosom : n, 가슴, 흉부슴속, 내부, 믿고 있는, 껴안다, 마음속에 간직하다
bosomy : a, (여자가)가슴이 풍부한
boson : n, 보존, 보스입자(소립자의 일종)
Bosporus : n, 보스포러스 해협(흑해와 Marmara해를 연결함)
bosquet : n, =BOSKET
boss : n, vi, vt, 두목, 보스, 감독, 감독하다, 우두머리가되다, 둥근 돌기, 사마귀
bossa nova : x, 보사노바, 브라질 기원의 재즈춤
bossdom : n, 정계 보스로서의 지위, 정계 보스의 영향력 범위, 보스 정치
bossed : a, 양각 장식한, 돋을 새김(장식)이 붙은, 돌기물이 붙은
bosseyed : a, 애꾸눈의, 사팔뜨기의, 일방적인
bosshead : n, 우두머리(boss), 반장(foreman), 주임(head)
bossism : n, 보스 제도, 보스 정치
bossmanship : n, 경영자 정신(corporate leadership)
bossy : a, 두목 행세하는, 으스대는(domineering)
Boston : n, 미국 Massachusetts주의 주도
Bostonian : a, n, 보스턴의(시민)
bosulfide : n, 이황화물
bosun : n, =BOATSWAIN
Boswellian : a, n, 보즈웰다운, 보즈웰류의, 보즈웰 연구(숭배)자
bot : n, vt, vi, 말파리(botfly)의 유충, 보트증(말파리의 유충이 말의 위에 기생하여 생기는 병), 조르는 사람, 등치다, 조르다, 강청하다
botanical : a, 식물학의
botanist : n, 식물학자
botanize : vi, 식물을채집하다, 식물을연구하다
botany : n, 식물학
botargo : n, 다랑어, 숭어 등의 알을 소금에 절여 말린 것
botch : n, 서투르게수선하다, 망치다-서투른 수선, 흉한 기움질
botcher : n, 서투른 직공
botchery : n, 보기 흉한 기움새, 서투른 수선, 서투른 솜씨, 실수
botchwork : n, 서투른(조잡한)일(작품)
botchy : a, 누덕누덕 기운, 보기 흉한, 솜씨가 서투른
botel : n, =BOATEL
botfly : n, 말파리
both : pron, a, 둘다, 쌍방의, 둘다의, 다같이
bother : vt, n, vi, 괴롭히다, 귀찮게하다, 괴로워하다, 번민하다
botheration : n, int, 성가심, 속상한(vexation), 귀찮다!, 제기랄!, 빌어먹을!
bothersome : n, 귀찮은, 성가신
bothhanded : a, 양손을 쓰는, 양손잡이의
bothsay : a, 왕복의
bothsided : a, 양면이 있는, 양쪽에 듣는
bo tree : x, (인도의)보리수
botryoidal : a, 포도송이 모양의
Botswana : n, 아프리카남부의독립국(수도는 Gaberones)
bottle : n, vi, 병, 젖병, 술, 병에 담다, 붙잡다, 억누르다
bottle baby : x, 인공영양아
bottlebrush : n, 병 닦는 솔, 쇠뜨기
bottled : a, 병에 담은, 병에 든, 술에 취한
bottlefed : a, 인공영양의, 인공영양으로 자란
bottlefeed : vt, (아이를)우유(인공영양)로 기르다
bottleful : n, 한 병(의 분량)
bottleholder : n, 병 받침대, 권투 선수의 보조자, 세컨드, 후원자
bottleman : n, 술꾼, 주정꾼
bottleneck : n, 애로, 장애
bottlenose : n, 돌고래의 일종(약 3미터), 주먹코, 주부코
bottle party : x, 술을각자지참하는파티
bottler : n, 병에 담는 사람(장치), 탄산 음료 제조업자, 멋진(근사한)사람(것)
bottlewasher : n, 병씻는사람, 병씻는기계, 잡역부(신분이나 지위의)말석
bottling : n, 병에 채워넣기, 병에 든 음료, 포도주
bottom : n, vi, vt, 밑바닥, 기초, 바다 밑, 근거, 원인, 배밑, 바닥을 대다, 근거로하다, 기초를두다, 바닥의
bottomend : n, 보텀엔드(엔진의 크랭크샤프트, 메인베어링, 연접봉 베어링)
bottoming : n, 지염, 애벌염색
bottomland : n, 강변의 낮은 지대
bottomless : a, 바닥의
bottomline : a, 손익계산만을 문제삼는, 실리적인, 현실주의의
bottommost : a, 제일밑의, 최저의
bottomry : n, vt, 선박 저당 계약(을 하다)
bottomup : a, 일반인(하급자, 비전문가)의, 하급자에서 비롯된
botulin : n, 보틀리누스, 식중독의 원인이 됨
botulism : n, 소시지중독
boubou : n, 부부(아프리카의 소매없는 긴 옷)
bouchee : n, 부셰(쇠고기, 생선등을 넣은 작은 파이)
boucle : n, 매듭실, 부클레 털실, 부클레 직물
boudoir : n, 부인의침실
bouffant : a, n, 불룩한, 불룩하게 한 머리 모양
bouffe : n, 희가극
bougainvillaea : n, 부겐빌리다, 빨간 꽃이 피는 열대 식물
bough : n, 큰가지, 교수대
boughed : a, 
boughpot : n, 큰 꽃병, 꽃다발
bought : v, buy의과거
boughten : a, 가게에서 산, 가게에서 파는 물건인
bougie : n, 소식자, 존데, 좌약, 양초
bouillabaisse : n, 부여베이스(생선, 조개류에 향료를 넣어 찐 요리, 마르세유의 명물)
bouilli : n, 삶은 고기, 찐 고기
bouillon : n, 부용 (소, 닭고기의 맑은 수프)
boulder : n, 큰둥근돌
bouldering : n, 볼더링(큰바위 오르기), 옥석을 깐 포도
Boule : n, (근대 그리스의)의회, 하원
boulevard : n, 넓은길, 한길
boulevardier : n, 파리의카페단골, 플레이보이
boulinus : n, 보툴리누스균(botulin을 만들어 냄)
boulle : n, 불(상감)세공
boult : vt, =BOULT
boulter : n, 주낙
bounce : vi, vt, n, ad, 뛰어오르다, 튀다, 튀어돌아오게하다, 해고하다, 되튐, 툭 튀어, 불쑥
bounceable : a, 으스대는, 싸우기 좋아하는
bouncer : n, 거대한것, 뛰는사람, 허풍, 허풍선이
bouncily : ad, 생기있게, 탄력있게, 쾌활하게
bouncing : a, 튀는, 거대한, 강한, 기운찬, 원기왕성한
bouncy : a, 생기(활기)있는, 쾌활한, 탄력 있는
bound : n, vt, vi, 경계, 한계, 범위, 한도(limits)-한정하다, 경계를 접하다-인접하다
bound : n, vi, vt, 뜀, (공 따위)되퇸, 탄력-뛰다, 되튀다, 튀다
bound : v, a, bind의 과거- ...의 의무가 있는, 제본한, 확실한, 결심을 한, 열중하여, 밀접한 관계에
bound : a, ...행의..., 에 가려고
bound : n, vi, vt, v, a, 경계, 한계, 범위, 한정하접하다, 인접하다, 뜀, 튀다, bind의 과거분사
boundary : n, 경계, 한계
bounden : a, 책임있는, 은혜를입고
bounder : n, 버릇없는사람, 벼락출세자
boundless : a, 한없는
bounteous : a, 활수한(generous), 풍부한
bountied : a, 장려금을 받은, 장려금이 나오는
bountiful : a, 풍부한
bounty : n, 활수함, 관대, 하사품, 장려금, 보수
bouquet : n, 꽃다발, 향기
bouquiniste : n, 고서적상, 헌책방
bourbon : n, 버번 위스키
Bourbon : n, (프랑스의)부르봉 왕가의 사람, 고한 보수(정치)가, 위스키의 일종
bourdon : n, (파이프 오르간의)최저음 음전, bagpipe의 저음 음전의 하나, (편종의)최저음의 종
bourg : n, 고을, 마을, 성시
bourgeois : a, n, 중산계급의, 중산계급의사람, 유산계급의, 부르조아
bourgeoise : n, BOURGEOIS의 여성형
bourgeoisie : n, 부르주아(중산, 상공업)계급, 자본가(유산)계급
bourgeoisification : n, 
bourgeoisify : vt, vi, 부르주화하다
bourgeon : n, vi, =BURGEON
bourn : n, 시내, 개울, 경계, 목적지
bourse : n, (특히 파리의)증권거래소
bousrimes : n, pl, 화운(주어진 운에 맞추어서 만든 시)
boustrophedon : n, a, ad, 첫행을 우측에서 조측으로 다음 행을 좌측에서 우즉으로 번갈아 쓰는 초기 그리스어의 서법
bousy : a, 술취한
bout : n, 한판, 한바탕, 한참
boutique : n, 가게, 여성복 장식품점
boutiquier : n, 부트크 소유자, 가게 주인
boutonniere : n, 단추구멍에꽂는꽃
bouzouki : n, 부주키(만돌린 비슷한 그리스의 민속 현악기)
bovarism : n, 제 자랑, 자기의 과대평가
bovid : a, n, 소과의(동물)
bovine : a, n, 소과의, 소의, 소같은, 느린
Bovril : n, 쇠고기 엑스
bovver : n, (불량 소년 그룹에 의한)소란, 싸움, 난투
bow : n, vi, vt, 활, 나비넥타이, 만곡부, 구부리다, 꾸부러지다, 켜다, 인사하다, 절하다, 이물, 함수
bowarm : n, 활을 잡는 손(왼손(팔)), 악기의 활을 잡는 손(오른손(팔))
bowback : a, 곱사등이의, 꼽추의
Bow bells : x, (런던 구시내의)St MaryleBow 성당의 종, 그 종소리가 들리는 범위, 런던 토박이
bowdlerism : n, (저작물의)무단 삭제(정정)
bowdlerization : n, 
bowdlerize : vt, 속악한데를삭제하다
bowed : a, 굽은, 머리를 숙인
bowed : a, 활을 가진, 활 모양의
bowel : n, 창차, 장의일부, 동정
bower : n, 정자, 나무그늘, 내실, 나무그늘의, 이물닻, 주묘, 최고의 패, 절하는 사람, 굴복자
bowerbird : n, 풍조과 새의 일종(오스트레일리아산)
bowery : a, n, 정자가 있는, 나무 그늘이 많은(shady), 나뭇잎이 우거진, (식민지 시대 New York부근의)네덜란드 이민의 농장, 바워리가(New York시의 큰 가로의 한, 싸구려 술집, 여관이 모여 있음), 싸구려 술집, 여관이 많아 부랑자가 들끓는 구역
bowfin : a, 북미산 민물고기의
bowfront : a, (수평방향으로)달아 낸(찬장 등), 활모양으로 달아낸 (창문)
bowhead : n, 북극고래(Greenland whale)
bowhunt : vt, 활로 사냥하다
bowie : n, (외날의)사냥칼
bowing : a, 절을 하는, 휘는
bowing : n, (현악기의)운궁법, 보잉
bowknot : n, 나비매듭
bowl : n, 사발, 대접, 공기, 큰잔, 저울의 접시, 나무공, 굴리다, 볼링경기
bowlder : x, =BOULDER
bowleg : n, a, 앙가발, 앙가발의
bowlegged : a, 내반슬의, 앙가발이의
bowler : n, 중산모, 공굴리는사람, 투수, 투구자
bowlerhat : vt, 제대시키다
bowlful : n, 한 사발(잔 공기)(의 분량)
bowline : n, (가로돛의 양끝을 팽팽하게)당기는밧줄
bowling : n, 볼링
bowman : n, 활의사수(archer), (이물)노 젓는 사람
bowser : n, 급유용 트럭, 급유용 펌프
bowshot : n, 화살이닿는거리, 사정거리
bow sindow : x, 활 모양의 퇴장
bow sow : n, vi, 멍멍(짖다
bowsprit : n, 제일사장
bowstring : n, 시위, 교수용 밧줄
bow tie : x, 나비넥타이
bow tie : x, s나비 넥타이
bow window : x, 활모양의퇴창
bowwindowed : a, (활 모양의)내달이창이 달린, 불룩배의
bowwow : int, 멍멍, 와아와(야유하는 소리)
box : n, vi, vt, 상자, 회양목, 상자모양의것, 선을두른기사, 상자에넣다, 따귀, 따귀를갈기다
Box and Cox : x, 동시에는 안 나타나는 두 사람, 한 역할을 교대로 하는 두 사람
boxboard : n, 종이상자용 판지, 보드지
boxcar : n, 유개화차
boxed : a, 술취한, 교도소에 수감된
boxer : n, 권투선수, 복서, 복서(bulldog 비슷한 꼬리 짧은 개), 실크해트
boxer shorts : x, 허리에 고무를 넣은 헐렁한 남성 바지
boxful : n, 한 상자(의 분량)
boxhaul : vt, 이물을 바람 불어오는 쪽으로 하여 침로를 바꾸다
boxholder : n, (극장, 경마장 등의)칸막이 좌석의 관람객, (우체국의)사서함을 가진 사람
boxing : n, 권투, 복싱, 포장, 상자 꾸리기(작업), 상자 재료, 창문틀, (창문의)두껍닫이
boxing day : x, 크리스마스의이튿날
boxkeeper : n, 좌석계원
box kite : x, 상자모양의연
box kite : x, 상자 모양의 연(주로기상 관측용)
boxman : n, (전문)금고털이, (블랙잭에서)프로의 카드 딜러, 도박장 직원
box office : x, 매표소
box office : x, 매표소
boxoffice success : x, 대성공
boxroom : n, (상자, 트렁크 등을 넣어 두는)작은 골방, 작은 방
box seat : x, 간막은좌석, 특별좌석
box seat : x, (극 따위의)간막은 좌석, 특별 좌석
box supper : x, 기금을모으는자선단체, 교회가 주최하는 파티
box supper : x, box lunch를 팔아 기름을 모으는 자선 단체 교회가 주최하는 파티
boxtree : n, 회양목
boxup : n, 갖가지 양떼의 뒤섞임(혼란)
boxwood : n, 회양목, 회양목재
boy : n, 소년, 사내아이, 남학생, 녀석, 급사, 보이
boyandgirl : a, 소년소녀의
boyard : n, (옛 러시아)귀족, (옛 루마니아)특권 귀족
boycott : vt, n, 불매동맹을하다, 배척하다, 보이콧, 불매동맹
boyfriend : n, 애인, 남자친구
boyhood : n, 소년기, 소년사회
boyhusband : n, 나이 어린 남편
boyish : a, 소년의
boymeetsgirl : n, 판에 박은 듯한 로맨스의, 정석대로의 (이야기 등)
boy scout : x, 소년단원(Boy Seouts의 단원)
boysenberry : n, 나무딸기의 일종(반포복성)
bozo : n, 놈, 녀석(fellow, guy), 크고 (힘세고) 촌스런(멋없는)남자
bozz bomb : x, 폭명탄
Br.Col : x, British Columbia
bra : n, 브래지어(brassiere)
Brabanconne : n, 벨기에 국가
brabble : n, vi, 말다툼, 언쟁, 말다툼하다
brace : n, vt, vi, 지주, 버팀대, 거멀장, (사냥개 따위의)한 쌍, 바지 멜빵, 부목꺾쇠-버티다, 죄다, 긴장 시키다, 기운을 내다
bracelet : n, 팔찌
bracer : n, 받치는(긴장시키는)것(사람), 죄는 것, 죄는 끈, 밧줄, 띠, 자극성 음료, 술(pickmeup), 원기를 돋우는 것, (펜싱, 궁술용)팔 보호구
bracero : n, (미국의)멕시코인 계절 농장 노동자
brach : n, 암 사냥개
brachial : a, 팔의, 팔 비슷한, 팔 모양의
brachiate : a, vi, 십자 대생의, 팔이 있는, (긴팔원숭이 등이)양손으로 매달리며 건너가다
brachiopod : n, a, 완족류(의)(꽈리조개 등)
brachium : n, 상박, 다리
brachycephalic : a, 단두
brachycephaly : n, 단두, 단두증
brachylogy : n, 요어 생략, 간결 표현(어구)
bracing : a, n, 긴장시키는, 기운을 돋우는, 상쾌한, 버팀대, 지주, 원기 돋움, 자극
braciola : n, 브라치올라(이탈리아 요리의 일종)
bracken : n, 고사리, 고사리 숲
bracket : n, vt, 까치발, 선반받이, 동류, 부류, 괄호로 묶다
bracketing : n, (집합적)까치발, 브래킷
brackish : a, 소금기있는, 맛없는
bracteate : a, 포엽이 있는
bractlet : n, 소포
bractscale : n, 포린
brad : n, 곡종, 대가리가 작고 가는 못
bradawl : n, 작은 송곳
brad bean : x, 잠두
Bradbury : n, 1 파운드 지폐, 10 실링 지폐(둘 다 구지폐)
bradkeven point : x, 채산점
bradshaw : n, 철도안내서
brady : a, 늦은, 둔한, 짧은
bradycardia : n, 서맥, 서박(보통 매분 60이하의 맥박)
bradykinin : n, 브래디키닌(혈관 확장 작용을 함)
bradyseism : n, 완만 지동(지각의 완만한 상승, 하강)
brae : n, 가파른비탈, 산허리
brag : vt, vi, n, 자랑하다, 허풍떨다, 자랑, 흰소리, 허풍선이
braggadocio : n, 자랑꾼
braggart : n, a, 자랑꾼, 자랑꾼의
bragger : n, 허풍선이
braggs : n, 훈장
Brahma : n, 범천, 창조의신
Brahmani : n, 브라만 계급의 여자
Brahmanic : a, 브라만(교)의
Brahmanism : n, 브라만교
Brahmaputra : n, 브라마푸트라강, =BRAHMA
Brahmin : n, =BRAHMAN, 지식인
Brahmin : n, 인도의 사성중 최고의지성인
Brahminism : n, =BRAHMANISM, 인텔리적 정신(태도, 습관(등))
Brahms : n, 독일의 작곡가
braid : n, vt, 끈, 땋은끈, 몰, 땋은머리, 꼬다, 땋다
braided : a, 짠, 꼰, 몰로 장식한, (머리를)땋은
braider : n, 끈을 땋는(꼬는) 사람, 노끈 꼬는 기계, 합사 박는 기계
braiding : n, (집합적)짠(꼰), 끈, 합사, 몰 자수
brail : n, vt, 돛을 죄는 줄, (돛을)죄다, 가죽끈으로 묶다
Braille : n, 브레일식 점자(소경용)
brain : n, 뇌, 두뇌, 지력
brain : n, 뇌, 두뇌, 지력
brain cell : x, 뇌신경세포
brainchild : n, 두뇌의 소산, (독자적인)생각, 계획, 창작물, 발명품
brain child : x, 생각, 계획, 두뇌의소산, 작품
brain drain : x, 두뇌유출
brain fever : x, 뇌막염
braininess : n, 
brain pan : n, =skull
brain picker : x, 남의지혜를이용하는사람
brainsick : a, 미친, 광기의
brain storm : x, 정신착란, 갑자기 떠오른 묘안, 영감
brainstorming : n, 브레인스토밍(회의에서 갖자 의견을 제출하여 최선책을 결정하는 일)
brainstorming : n, 브레인스토밍, 회의에서 각자 의견을 제출하여 최선책을 결정하늠 일
brainteaser : n, 난문제, 난제, 퍼즐(puzzle)
brain trust : x, 브레인트러스트, 정부의 정책 고문단
brain truster : x, 정책 고문
brain truster : x, 정책고문
brainwash : n, vt, 세뇌하다
brainwashing : n, 세뇌
brainwashng : n, 세뇌
brain wave : x, 뇌파, 영감, 묘안
brain wave : x, 뇌파, 영감, 묘안
brain work : x, 정신노동자
brainworker : n, 정신(두뇌)노동자
brainy : a, 머리가 좋은, 총명한
brainy : a, 머리가좋은
braird : n, vi, 새싹, 새싹이 트다(나다)
braise : vt, (고기를)베이컨, 야채와 함께 기름으로 살짝 튀긴 후 오래 끓디다
braise : vt, 기름에살짝튀긴후뭉근불에끓이다
brake : n, vt, vi, 브레이크, 브레이크를 걸다, 양치의 무리, 고사리, 덤불, 수풀, break의 과거
brakeage : n, 제동 작용(능력 장치)
brakelight : n, 브레이크 등(stoplight)
brakeman : n, 제동수
brakesman : n, =BARKEMAN
brakie : n, =BRAKEMAN
braky : a, 덤불(풀숲)이 우거진
braless : a, 노브라의
bramble : n, 가시나무, 찔레나무, 검은딸기, 나무딸기
brambling : n, 되새
brambly : a, 가시가 많은, 가시덤불의, 가시덤불같은
Bramin : n, =BRAHMIN
bran : n, 밀기울, 겨, 왕겨
branch : n, vi, 가지, 분파, 분가, 지류, 지맥, 출장소, 가지를내다, 갈라지다
branched : a, 가지가 있는
branchia : n, 아가미(gill)
branchial : a, 아가미의, 아가미같은
branchiate : a, 아가미가 달린, 아가미에 관한
branching : n, a, 갈래, 분기, 가지, 가지를 내뻗은
branchio : n, 아가미
branchlet : n, 말단의 작은 가지
branchy : a, 가지가 많은, 가지가 우거진
brand : n, vt, 상표, 상품명, 품질, 타는나무, 낙인, 인두, 검, 낙인을 찍다, 오명을 씌우다
brandade : n, 브랑다드(견 대구, 올리브유, 향료 등을 넣고 죽처럼 끓인 것)
brander : n, 낙인 찍는 사람(기구)
brandied : a, 브랜대에 담근, 브랜디로 맛을 낸
brandish : vt, (칼 따위를 휘두르다
brandling : n, 붉은줄지렁이, 연어 새끼(parr)
brandname : a, (유명)상표가 붙은
brandnew : a, 아주 새로운, 신품의, 갓 만들어진(들여온)
brandreth : n, 나무틀, (건초 등을 걸쳐 놓는)삼각가, 우물 둘레의 울짱, 삼발이
brandy : n, 브랜디
brandyandsoda : n, 소다를 탄 브랜디
brandyball : n, 브랜디를 넣은 캔디
brandypawnee : n, =BRANDY and water
branknew : a, 아주새로운
branks : n, (철제)재갈(옛날 영국에서 말많은 여자에게 이것을 씌웠음)
brannew : a, =BRANDNEW
brannigan : n, 야단 법석, 헛된 입씨름
branny : a, 겨의, 밀기울의, 밀기울이 든
brant : n, 흑기러기
Braque : n, 프랑스의 화가
brash : a, 성마른, 성급한, 경솔한, 뻔뻔스러운
brashy : a, (목재가)잘 부러지는, 무른
brasier : n, =BRAZIER
brasilia : n, 브라질의수도
brass : n, 놋쇠, 금관악기, 금전, 철면피, 고급장교
brassage : n, 화폐 주조료, 주화세
brassard : n, 완장, 팔막이
brassbound : a, 놋쇠로 보강한(테를 장식한), 인습적인, 완고한, (사람, 규칙 등이)융통성이 없는
brass fathing : x, 하찮은것, 조금
brass hat : x, 고급장교, 고급관리
brassie : n, 바닥에놋쇠를붙인
brassiere : n, 브래지어
brassrie : n, 맥주 등 알코올류도 내놓는 레스토랑
brass tacks : x, 놋쇠못
brass tacks : x, 녹 쇠 못, 요점, 실제 문제
brassware : n, 놋그릇, 요점, 실제문제
brasswind : a, 금관악기의
brass winds : x, 금관악기
brassy : a, 놋쇠같은, 뻔뻔스런
brat : n, 꼬마놈, 선머슴
brattice : n, vt, (광갱의)통풍 칸막이, 판자 울타리(기계류를 둘러싼), 칸막이를 만들다
brattishing : n, 투각, 섭새김, 통풍용 칸막이
brattle : n, vi, 덜컹덜컹(둥둥, 쿵쿵), 쿵쾅거림, 덜컹덜컹(둥둥, 쿵쿵)울리다, 쿵쾅거리며 뛰다
bratty : a, 건방진, 개구쟁이의
braunite : n, 브라운광
braun tube : x, 브라운관
brava : n, =BRAVO(여성에 대해 사용)
bravado : n, 허세
brave : a, vt, 용감한, 화려한, 훌륭한, 용사, 용감하게 해내다, 도전하다
bravely : ad, 용감하게, 화려하게
bravemess : n, 용감성
bravery : n, 용감, 화려
bravo : n, int, 브라보를외치는소리, 잘한다, 좋다
bravura : n, 화려한곡, 연주, 용맹, 의기
braw : a, ad, 옷차림이 화려한, 훌륭한, 매우
brawl : n, vi, 말다툼, 말다툼하다
brawler : n, 싸움(말다툼)하는 사람
brawling : a, 시끄러운, 떠들썩한, 요란한
brawn : n, 근육, 완력
brawny : a, 근골이 억센, 강건한
braxy : n, (양의)비탈저
bray : n, vi, 나귀의 울음소리, 나팔소리, 나귀가울다, 울리다
bray : vt, 의깨다, 찧다, 찧어 바수다
brayer : n, 나귀 소리를 내는 것, 나귀, 절굿공이, 손으로 미는 롤러
braze : vt, 놋쇠로만들다, 땜질하다
brazen : a, vt, 놋쇠로만든, 놋쇠빛의, 놋쇠처럼 단단한, 시끄러운, 뻔뻔스러운, 뻔뻔스럽게하다
brazenface : n, 철면피
brazenfaced : a, 뻔뻔스러운, 염치없는
brazier : n, 화로, 놋갓장이
braziery : n, 놋쇠 세공, 놋쇠 세공장
Brazil : n, 브라질
Brazilian : a, n, 브라질의, 브라질사람
brazilwood : n, 브라질 소방목(빨간 물감을 채취하는 나무)
Brazzaville : n, 브라자빌(콩고 공화국의 수도)
breach : n, 깨뜨림, 위반, 파기, 절교, 깨뜨리다
bread : n, 빵, (일상의)주식물, 양식(staple food), 생계(livelihood), 돈, 현금, 고용주, 주인
breadandbutter : a, 생계를위한, 한창 먹을 나이의, 환대에 감사하는
breadbasket : n, 빵광주리, 보리의산지, 위, 밥통
breadbin : n, 빵 상자
breadboard : n, 밀가루반죽하는대, 빵을 써는 도마
breadboarding : n, 평평한실험대위의회로조립
breadfruit : n, 빵나무
breading : n, 번식, 사육, 버릇, 뱀뱀이, 증식작용
breadless : a, 빵(식량)이 없는
bread line : x, 빵배급을받는사람
breadline : n, 식료품의 무로 배급을 받는 실업자, 빈민들의 줄
bread mold : x, 빵에서 생기는) 검은 곰팡이
bread mould : x, 검은곰팡이
breadnut : n, 뽕나무과의 식물(이 열매로 빵을 만듦, 서인도산)
breadroot : n, 북미산 콩과의 다년초(의 뿌리)
breadstick : n, 가는 막대 모양의 딱딱한 빵
breadstuff : n, 빵의원료
breadth : n, 폭, 나비, 넓은도량
breadthways : ad, 가로
breadwinner : n, 버는사람
break : vt, vi, n, 부수다, 깨뜨리다, 부서지다, 무너지다, 돌발하다, 교제를 끊다, 관계를 끊다, 무너지다
breakable : a, n, pl, 부술(깨뜨릴)수 있는, 깨지기(부서지기)쉬운, 무른, 깨지기 쉬운 것
breakage : n, 파손, 파손물, 파손액
breakaway : n, 분리기, 절단, 탈주, 무리에서 이탈한 동물, 일탈, 탈퇴, 출발 신호전에 뛰어 나감, 공을 갖고 골로 돌진하기
breakdown : n, 브레이크 댄싱(동작이 격렬한 춤, 디스코의 주류를 이룸)
breakdown : n, 고장, 분석, 사고, 붕괴, 쇠약
breaker : n, 깨뜨리는사람, 깨뜨리는 기계, 부서지는 파도
breakerven : a, 수입과지출이맞먹는:이익도 손해도 없는
breakfast : n, vi, vt, 조반, 조반을먹다
breakfaster : n, 조반을 먹는 사람
breakfront : a, 양쪽 끝 선보다도 중앙 부분이 나온(책장, 찬장)
breakin : n, 침입, 연습운전
breaking : n, 파괴, 단선, 길들이기
breakingpoint : n, 극한, 파열점
breakneck : a, 목이부러질것같은, 위험한
breakoff : n, 갑작스런 중단, 결렬행
breakout : n, 포위진돌파, 탈출
breakpoint : n, (어느 과정에서의)중지점, 구분점, 브레이크 포인트
breakthrough : n, 적진돌파, 난국의 타개
breakup : n, 해산, 붕괴, 종말
breakwater : n, 방파제
breakwind : n, 방풍림
bream : n, 잉어과의담수어, 도미 비슷한 바다물고기
breast : n, vt, 가슴, 흉부, 유방, 가슴에받다, 무릅쓰다
breastbone : n, 가슴뼈
breastfed : a, 모유로키운
breastfeed : vt, (유아를)모유로 키우다
breasthigh : a, ad, 가슴 높이의(로)
breastpin : n, 브로치
breastplate : n, (갑옷의)가슴받이
breastrail : n, (뱃전, 창가의)손잡이, 난간
breast stoke : x, 개구리헤엄
breaststroke : n, 평영, 개구리 헤엄
breast stroke : x, 개구리 헤엄
breast wall : x, 흉벽, 제방의 흉벽
breast wall : x, (제방의)흉벽
breastwork : n, 흉벽, 급히만든 흉벽
breath : n, 숨, 호흡, 한숨, 순간, 선들거림, 향기, 생기
breathalyse : vt, vi, 주기(음주)탐지를 하다, 주기 탐지(검사)를 받다
Breathalzer : n, 몸속알코올분측정기
breathe : vi, vt, 호흡하다, 살아있다, 휴식하다, 쉬다, 선들거리다-불어넣다, 풍기다, 휴식 시키다, (향기를)풍기다, 속삭이다, (불평을)털어놓다, 
breathed : a, 무성음의
breather : n, 심한운동, 한숨돌리기, 생물, 환기구멍
breathing : n, 호흡, 휴식, 미풍, 발성, 열망, 동경
breathing capacity : x, 폐활량
breathingless : a, 숨가쁜
breathing space : x, 휴식, 휴식장소, 숨돌릴짬
breathless : a, 숨가쁜, 죽은, 숨을 죽인, 바람 없는
breathlessly : ad, 
breathtaker : n, 깜짝 놀라게 하는 것(사건)
breathtaking : a, 깜짝놀랄만한, 손에 땀을 쥐게하는, 흥분시키는
breath test : x, 주기검사
breath test : x, 주기검사
breathy : a, 기식음(질)의, 기식음이 섞이는, 성량이 적은
breccia : n, 각력암
Breck : x, Brecknockshire
bred : v, a, breed의과거, ...하게 자란
bredinthebone : a, 타고난, 떨쳐버릴 수 없는
breech : n, 궁둥이, 뒷부분, 총미, 포미
breechblock : n, (포의)미전, (총의)놀이쇠
breechcloth : n, 허리에두른천
breechclout : n, 기저귀(diaper)
breeches : n, pl, 반바지, 승마용 바지
breeching : n, (말의)엉덩이 띠, 포삭(포를 고정시키는 줄)
breechless : a, 포미(총미)가 없는, 반바지를 입지 않은
breechloader : n, 후장총
breechloading : a, 후장식의
breed : vt, vi, n, (동물이 새끼를)낳다, (새가 알을)까다, 양육하다, 기르다, 가르치다, 새끼를 낳다, (동물이)번식하다, 자라다, 가르치다, 기르다, 씨를 받다, 임신하고 있다, (좋지 않은 일이)발생하다, 생기다, (동식물의)품종, 종족, 인종, 종류, 계통(lineage)
breeder : n, 사육자, 종축, 장본인
breeder reactro : x, 증식형 원자로
breeding : n, 번식, 사육, 버릇뱀이, 증식 작용
breeding ground : x, 양식장, 사육장
breed reactor : x, 증식형, 원자료
breen : n, a, 갈색을 띤 녹색(의)
breeze : n, 산들바람, 소문, 법석, 소동, 싸움, 산들바람이 불다, 나아가다
breezeblock : n, =CINDER BLOCK
breezefly : n, 등에, 쇠파리(gadfly)
breezeless : a, 바람기 없는
breezeway : n, (집과 차고 사이의)지붕 있는 통로
breezily : ad, 산들바람이 일어, 기운차게, 쾌활하게
breezy : a, 미풍(성)의, 산들바람이 부는, 바람이 잘 통하는, 상쾌한, 쾌활한
bregma : n, 시상봉합과 관상봉합의 접합점(두계골 계측점의 하나)
bregoil : n, 브레고인(유출 석유를 흡수시켜 회수하는 데 쓰는 제지 폐기물)
brekker : n, 아침 식사
brekky : n, 조반
Bremen : n, 브레멘(서독의 하항)
bremsstrahlung : n, 제동 복사
bren : n, 경기관총의일종
Brenda : n, 여자 이름
bresage : n, 양조주(음료), 맥주, 양조(법), 음모
Bretagne : n, 브르타뉴(Brittany의 프랑스 이름)
brethren : n, 형제, 동포, 회원, 동인
Breton : a, n, 브르타뉴
breve : n, 단모음기호, 2온음표
brevet : n, vt, 명예진급, 명예진급을 시키다
brevetcy : n, 명예 계급
brevi : a, 짧은
breviary : n, 성무일과서
brevier : n, 브레비어 활자(8포인트 활자)
brevipennate : a, 날개가 짧은
brevity : n, 간결, 짧음
brew : vt, vi, n, 양조하다, 조합하다, 끓이다, 꾸미다-일어나려하다, 조짐이보이다, 양조
brewer : n, 양조장
brewery : n, (맥주)양조장
brewhouse : n, =BREWERY
brewing : n, 양조(업), (1회)양조량, 폭풍우의 전조, 검은 구름
brewis : n, 고깃국, 수프, 고깃국(뜨거운 우유)에 적신 빵
brewster : n, 양조자
Brezhnew : n, 브레주네프 Leonid Ilich ~(1906-82)(소련의 공산당 제1서기(1964-82))
brfuddlement : n, 정신을 잃게 함, 어리둥절함
Brian : n, 남자 이름
briar : n, =brier
Briard : n, 브리아르(프랑스산의 양치기 개)
Briareus : n, 손이 100개 있는 거인
briarroot : n, =BRIERROOT
briarwood : n, =BRIERWOOD
bribability : n, 
bribable : a, (뇌물로)매수할 수 있는
bribe : n, vi, vt, 뇌물, 뇌물로 매수하다, 증회하다
bribee : n, 수회자, 뇌물을 받는 사람
bribegiver : n, 뇌물을 주는 사람(briber)
briber : n, 증회자
bribery : n, 증수회
bribetaker : n, 뇌물을 받는 사람(bribee)
bricabrac : n, 골동품, 고물
brick : n, 벽돌, 집짓기 나무, 서글서글한 사람, 호인, 벽돌로 둘러싸다, 벽돌을 깔다
brickbat : n, 벽돌조각, 부스러기
brick field : x, 벽돌공장
brickfield : n, 벽돌 공장
brickfielder : n, (오스트레일리아에 부는)뜨겁고건조한열풍
brickkiln : n, 벽돌가마
bricklayer : n, 벽돌공
bricklaying : n, 벽돌 쌓기
brickle : a, 약한, 깨어지기 쉬운
brickmaker : n, 벽돌 제조인
brickmaking : n, 벽도 제조
brickmason : n, =BRICKLAYER
brickred : a, 벽돌색의
brickred : a, 붉은벽돌색의
brickwork : n, 벽돌로지은것, 벽돌로 지은 집, 벽돌쌓기
bricky : a, 벽돌의, 벽돌같은, 벽돌로 만든
brickyard : n, 벽돌공장
bricolage : n, 브리콜라즈(도구를 닥치는 대로 써서 만든 것(만들기)
bricole : n, 쿠션 먼저 치기, 땅에 일단 떨어진 공 치기, 간접 공격, 기습
bricoleur : n, bricolage를 하는 사람
bridal : n, a, 혼례, 혼례의, 새색시, 신부의
bridal wreath : x, 조팝나무
bride : n, 신부, 새색시
bridecake : n, =WEDDING
bridegroom : n, 신랑
bridesmaid : n, 신부들러리(젊은 처녀)
bridesman : n, 신랑들러리(미혼 남성)
bridetobe : n, 신부가 될 사람
bridewell : n, 감화원, 형무소, 유치장
bridge : n, vt, 다리, 선교, 함교, 푯대, 기러기발, 연결음악, 큐대, 다리놓다, 중개역을하다
bridge : n, 브리지(카드놀이의 일종)
bridgeable : a, 교량을 가설할 수 있는
bridgeboard : n, 층계의 발판을 걸치는 널판
bridgebuilder : n, 다리를 놓는 사람, (양자간의)조정역
bridgehead : n, 교두보
Bridges : n, 브리지스 Robert~ (1844-1930)(영국의 계관 시인)
Bridget : n, 여자 이름
bridge toll : x, 다리통행세
Bridgetunnel : n, 다리와 터널이 이어지는 도로
bridgework : n, 교량 공사, 브리지 기공
bridging : n, 교량 가설, 받침복(대)(strut), 교락
bridle : n, vt, vi, 굴레, 굴레를 씌우다, 고삐를 매다, 구속하다, 몸을 뒤로 젖히다
bridle path : x, 승마길
bridle rein : x, 고삐
bridlewise : a, (고삐에)길든, 훈련된
bridoon : n, 작은 재갈과 고삐
brie : n, 희고말랑말랑한프랑스산의치즈
brief : a, n, vt, 짧은, 간결한, 단시간의, 대의, 요령, 훈령, 요악하다, 변호를 의뢰하다, 명령을 내리다
briefcase : n, 서류 가방
brief case : x, 서류 가방
briefie : n, 단편 영화
briefing : n, 간결한명령, 간결한 명령서
briefless : a, 소송 의뢰인이 없는, 인기가 없는
briefly : ad, 짧게, 간결하게
briefness : n, 간단, 간결, (시간의)짧음, 더없음
brier : n, 찔레나무, 들장미, 브라이어 나무, 파이프
brierhopper : n, 농민
brierroot : n, 브라이어의 뿌리(로 만든 파이프)
brierwood : n, =BRIERROOT
briery : a, 자기 덤불의, 가시가 있는, 곤란한
brig : n, 두대박이범선
brigade : n, vt, 대, 여단, 편성하다
brigadier : n, 여단장
brigand : n, 산적, 도둑
brigandage : n, 산적 행위, 약탈
brigandine : n, (중세의)미늘(사슬)갑옷의 일종
brigandish : a, 산적 같은
brigantine : n, 비슷한범선
bright : a, ad, 환한, 머리가좋은, 밝게빛나는, 화창한, 쾌활한, 유망한
bright'sdisease : x, 브라이트씨병
brighten : vi, vt, 밝아지다, 밝게하다, 상쾌하다
brighteyed : a, 눈이 맑은, 순진한
brightfaced : a, 영리하게 생긴
brightish : a, 조금 밝은
brightly : ad, 환하게
brightness : n, 환함, 머리가 좋음
Brighton : n, 브라이튼(영국 해협에 면한 해변 행락 도시)
brightwork : n, (기계나 배의)닦아서 반짝반짝하는 쇠붙이
brigtisti : n, (이탈리아의)붉은 여단의 단원
Briicke : n, 다리파(1905년 창립된 독일 표현주의 화가 일파)
brill : n, 가자미, 넙치
brilliance : n, 광휘, 광채, 빛남, 훌륭함, 재기
brilliant : a, n, 찬란하게빛나는, 번쩍번쩍하는, 훌륭한, 재기에넘치는, 브릴리언트형의 다이아몬드
brilliantine : n, 포마드의일종, 알파카 비슷한 천
brilliantly : ad, 찬한히, 빈들빈들하게, 찬연히, 훌륭히
brim : n, vi, vt, 가장자리, 양테, 가득채우다, 넘치다
brimful : a, 넘치도록 가득한
brimless : a, 테두리(둘레)가 없는
brimmed : a, 테두리가 있는, 가득찬
brimmer : n, 가득찬 잔(그릇)
brimming : a, 넘쳐흐르는, 가득 차게 부은
brimstone : n, (상업용어)~제기랄
brimstony : a, 유황질(색)의, 유황내가 나는, 악마적인, 지옥 같은
brindle : a, 얼룩, 얼룩무늬, 얼룩개, =BRINDLED
brindle : n, a, 얼룩진색, 얼룩진, 얼룩덜룩한, 얼룩갈색의
brindled : a, 얼룩진
brine : n, 소금물, 바닷물
bring : vt, 가지고오다, 데리고오다, 초래하다, 일으키다, 이끌다, 낳다, 제기하다
bringdown : n, 신랄한 비꼼
bringingup : n, 양육, (가정에서의)교육
brink : n, 가장자리, 물가, 찰나, 위기, 고비
brinkman : n, 극단 정책(brinkmanship)을 잘 밀고나가는 사람
brinkmanship : n, (외교 교섭 등을 위헙한 사태까지 몰고 가는)극한정책
briny : a, 소금물의, 짠
brio : n, 생기, 활발
brioche : n, 브리오시(빵의 일종)
brioche : n, 버터와달걀이든빵
briolette : n, 브리올레트 커트를 한 보석(다이아몬드)
briony : n, =BRYONY
briquet : n, 연탄, 조개탄
briquet : n, 연탄, 조개탄
brisance : n, (폭약의)파괴력
Brisbane : n, 브리즈번(오스트레일리아 동부의 항구)
brisebise : n, (창의 아래쪽 반을 가리는)반커튼
brisk : a, 기운찬, 활발한, 활기있는, 상쾌한
brisket : n, 짐승의가슴고기
briskly : ad, 기운차게, 활발하게, 상쾌하게
brisling : a, 억센 털이 있는(많은), (털이)곤두선
bristle : n, vi, vt, 강모, 뻣뻣한 털, 털을 곤두세우다, 촘촘이나다
bristletail : n, 반대좀
bristling : n, =BRISLING, 작은 청어(북유럽산)
bristly : a, 털이 억센, 억센 털이 많은, 빽빽이(꼿꼿이)들어선, (털이)곤두선, 화낸
Bristol : n, 브리스틀(영국 서부의 항구)
brit : n, 작은 정어리(청어)(고래의 먹이)
Brit : x, Britain, Britannia, British, Briton
Britain : n, 대브리톤
Britannia : n, 브리타니아(Great Britain을 여성으로 의인화한 이름), 브리타니아상
Britannic : a, 영국의(British)
Britannica : a, n, 영국의(The Encydlopaedia Britannica(대영 백과 사전)과 같이 책명 등에 쓰임)), 영국에 관한 문헌
Briticism : x, 영국식 영어(어법)
British : a, 영국인의
british academy : x, 대영학사원
british commonwealth : x, 영연방
british emglish : x, 영국영어
british empire : x, 영연방
british isles : x, 영국제도
british museum : x, 대영박물관
british thermal unit : x, 영국열량 단위(파운드의 물을 화씨 1도 올리는 열량)
british warm : x, 짧은외투
Briton : n, 브리튼사람(로마인 침입 당시의 Britain 남부의 켈트인), 영국인
britska : n, 4륜 포장마차
Brittany : n, 브르타뉴프랑스 북서부의 반도 bretagne의 영어명)
brittle : a, 부서지기쉬운
broach : n, vi, vt, 꼬치, 꼬챙이, 송곳, 꼬챙이에 꾀다, 입을 열다, 꺼내다, 공표하다
broacher : n, 발의자, 제창자
broad : a, n, 넓은, 광대한, 마음이 넓은, 밝은, 대강의, 넓은 뜻의-넓은 곳, 호수
broad arrow : x, 세갈래의 화살표
broad arrow : x, (관물, 죄수복에 붙이는)세 갈래의 화살표
broadax : n, (벌목, 전쟁용)도끼
broadband : a, 광대역의
broadband : a, 광(주파수)대역의
broadbanding : a, (생산성 향상을 위한 각 조동자의)작업 분담 영역의
broad bean : x, 잠두
broadbill : n, 부리가 넓은 새(오리, 넓적부리 등), 황새치(swordfish)
broadblown : a, 만발한, 활작 핀
broadblown : a, (꽃이)만발한
broadbrim : n, 양테가넓은모자
broadbrim : n, 양태가 넓은모자, 퀘이커 교도
broadbrimmed : a, 테가 넓은
broadbrow : n, 취미나 관심이 광범위한 사람
broadbrush : a, 대체적인, 대강의
broad caer : x, 방송자(장치), 살포기
broadcast : vt, vi, n, a, 방송하다, 방송프로, 방송, 살포, 방송의, 살포한, 살포하다, 흩뿌리다-방송(프로), 씨(살포)-방송의, 방송된, 살포한
broadcasting : vi, vt, 방송, 방송사업
broadcasting frequency : x, 방송주파수
broadcasting station : x, 방송국
broad church : x, (영국 국교의)광교회파
broadcloth : n, 고급양복감, 브로드(셔츠용 포플린)
broaden : vt, vi, 넓히다, 넓어지다
broadgauge : a, 광궤의=BROADMINDED
broadish : a, 넓으스름한
broadish : a, 넓으스름한
broad jump : x, 넓이뛰기
broad jump : x, 넓이 뛰기
broadleaf : n, 잎이 넓은 담배(엽궐련용)
broadleaved : a, 잎이 넓은
broadloom : a, 폭 넓게 짠
broadloom : a, 폭넓게짠
broadly : ad, 널리, 노골적으로, 버릇없이, 대범하게, 사투리로, 대체로, 야비하게
broadly : ad, 넓게, 광대하게
broadminded : a, 도량이넓은, 관대한
Broadmoor : n, 브로드무어 수용소(영국 Berkshire에 있는 정신 장애 범죄자의 수용, 치료 시설)
broadness : n, 넓음, 넓이(이 뜻으로는 Breadth가 보통), 광대(함), 노골(적임), 삼가지(사양하지)않음, 야비(함)
broad seal : x, 국새, 정부의 관인
broad seal : x, 국새, 정부의 관인
broadsheet : n, 한면만인쇄한대판지
broadside : n, 뱃전, 한쪽뱃전의 대포의 전부, 그의 일제 사격, 일제공격
broadspectrum : a, 광역항균스펙트럼의(광범위한 미생물에 유효한 약 등에 이름)
broadsword : n, 날넓은칼
broadtail : n, (아시안의)꼬리가 굵은 양, 그 새끼 양의 모피
broadway : n, 뉴욕시의남북으로뻗은번화가(부근에 큰 근장이 많음)
broadwife : n, (남편이 다른 주인의 소유가 돼 있는)여자 노예
broadwise : ad, 가로로, 으로
Brobdingnag : n, (걸리버 여핵기 중의)거인국
Brobdingnagian : a, n, 거대한, 거인
brocade : n, vt, 비단, 비단으로 꾸미다, 비단으 짜다
brocaded : a, 능라의
brocatelle : n, 무늬를 도드라지게 짠 비단
broccoli : n, 모란채(cauliflower의 일종, 식용)
broche : n, a, 능라(의)
brochette : n, (요리용)꼬치
brochure : n, 팸플릿, 가철한 책
brock : n, 오소리(badger)
brockage : a, 잘못 주조된
brocket : n, 두 살 난 붉은 수사슴, 작은 사슴(남미산)
brocoli : n, 모란채
broderie : n, 영국 자수(바탕천을 도려내어 하는)
brodie : n, 대실패, 큰 실수, (다리에서의)투신 자살
brogan : n, 질기고 투박한 단화
brogue : n, 튼튼한구두, 아일랜드 사투리, 시골사투리
broider : vt, =EMBROIDER
broider : v, 	   =EMBROLDER
broidery : n, =EMBROIDERY
broil : v, 굽다, 쬐다, 굽기, 쬐기, 불고기, 싸움하다, 말다툼하다
broiler : n, 불고기용철판, 불고기용 영계
broiling : a, 타는 듯이 뜨거운(더운), 흑서의, 구워지는
broke : v, a, 무일푼의, 파산한(go for~ 기를 쓰고 해 보다
broken : v, a, 깨진, 부서진, 끊어진, 파산한, 길든, 울퉁불퉁한, 서투른, break의과거분사
brokendown : a, 부서진, 기가꺽인, 몰락한, 파산한
brokenhearted : a, 슬픔에잠긴, 실연한
brokenly : ad, 띄엄띄엄, 더듬거리며
brokennecked : a, 목뼈가부러진, 결딴난
brokenwinded : a, 폐기종에걸린, 숨찬
broker : n, 중개인
brokerage : n, 중개(업), 거간, 중개 수수료, 구전
broking : n, 중개업
brolly : n, 양산, 낙하산
brom : n, 브롬, 취소
bromal : n, 브로말(진통데, 수면제)
bromate : vt, n, 브롬과화합시키다, 브롬산염
bromcho : n, (미국 서부의) 야생마(wild pony)
bromic : a, 브롬의
bromid : n, 브롬화물(bromide)
bromide : n, 브롬화물, 취화칼리(약한 수면제)한 말
bromidic : a, 흔해빠진, 평범한, 진부한
brominate : vt, 브롬으로 처리하다, 브롬과 화합시키다
bromine : n, 브롬
bromism : n, 브람 독
bromo : n, 브로모(두통약)
bromocriptine : n, 브로모크립틴(프로락틴 분비 과잉 억제제)
bromyrite : n, 취은광
bronch : n, 기관지
bronchi : n, BRONCHUS의 복수
bronchia : n, 기관지
bronchial : a, 기관지의
bronchiectasis : n, 기관지 확장증
bronchiole : n, 세기관지
bronchitic : a, 기관지염성의
bronchitis : n, 기관지염
bronchium : n, 기관지(bronchus 의 갈라진 부분)
broncho : n, 야생마
bronchobuster : n, 야생마를길들이는카우보이
bronchopneumonia : x, 기관지 페렴
bronchoscope : n, 기관지경
bronchotomy : n, 기관지절개술
bronchus : n, 기관지
bronco : n, 야생마(북미 서부 평원산)
broncobuster : n, 야생마를 길들이는 카우보이
bronk : n, =BRONCO
Bronte : n, Charlotte(1816-55), Emily(1818-48)영국의 작가 자매
brontosaurus : n, (아메리카 주라기의)뇌룡
Bronx : n, 뉴욕시 북부의 독립구의 하나
Bronx cheer : x, 혀를 입술 사이에서 떨어 내는 소리(경멸을 나타냄)
bronze : n, a, vt, vi, 청동, 청동의, 청동색의, 청동색으로 만들다, 갈색으로 만들다
Bronze Age : x, 청동기 시대
bronzer : n, 피부를 햇볕에 그을린 것처럼 보이게 하는 화장품
bronzesmith : n, 청동세공사
bronzing : n, (나뭇잎 등의)갈색화, 퇴색, 변색, 흐림, 청동 장식
brooch : n, 브로치
brood : n, vi, vt, 한배의병아리, 한배 새끼, 아이들, 종류, 종족-알을 품다(안다), 곰곰히 생각하다(on, over), (구름 걱정이(내리 덮이다(over, on)-숙고하다
brooder : n, 인공 부화기, 생각에 잠기는 사람
broodingly : ad, 생각에 잠겨, 시무룩해서
broodmare : n, 번식용 암말
broody : a, 알을 품고 싶어하는, 새끼를 많이 낳는, (여성이)아이를 많이 낳고 싶어하는, 생각에 잠기는, 수심에 잠기는, 시무룩한
brook : n, vt, 시내, 실개천, 견디다, 참다
brookite : n, 브루카이트, 판티탄석
brooklet : n, 실개천, 가는 물줄기
brooklime : n, 개불알꽃속의 식물
Brooklyn : n, 뉴욕시독립구의하나
broom : n, vt, 비, 긴자루 부러시, 금작화, 청소하다, 비로 쓸다
broomball : n, 빗자루와 배구(축구)공을 쓰는 일종의 아이스하키
broomcorn : n, 수수
broomrape : n, 금작화 등의 뿌리에 기생하는 식물의 총칭
broomstick : n, 빗자루(marryover the~ 내연의 관계를 맺다)
broomy : a, 비같은, 양골담초의(가 많은)
broozy : a, 청동의(과 같은), 청동색의
bros : n, 스미스 형제 상회
brose : n, 더운물이나밀크를부은오트밀
broth : n, 묽은수프
brothel : n, 갈못집
brother : n, 형제, 친구, 동료, 동지, 동포(~in arms 저우)
brothergerman : n, 부모가같은형제, 피를 나눈 형제
brotherhood : n, 형제(동포)관계, 동료, 친선 단체, 협회, 결사, 조합, 철도 종업원 조합
brotherinlaw : n, 매부, 처남, 시숙
Brother Jonathan : x, (전형적)미국인
brotherless : a, 형제가 없는
brotherly : a, 형제의(같은), 친절한
Brother uterine : x, 이부 형제
brougham : n, 브룸(마부, 운전사의 자리가 박에 있는 마차, 자동차)
brought : v, bring의과거(분사)
brouhaha : n, 소음, 소동, 센세이셔널한 여론, 열광
brow : n, 이마, 눈썹, 벼랑 꼭대기
browbeat : vt, 노려보다, 위협하다
browed : a, 눈썹이 ...한
brown : n, a, vt, vi 밤색, 다갈색, 갈색 그림 물감-다갈색의, 햇볕에 탄, 거무스름한-갈색이 되다, 햇볕에 타다
Brown : n, 남자 이름
brown betty : x, 사과푸딩
brown bread : x, 흑빵
browncine : n, 곰(옛날 이야기의)
brown coal : x, 갈탄
brownian movement : x, 브라운운동(액제 속의 미립자의 불규칙 운동)
brownie : n, (농가의 일을 도와 준다는)작은요정, 유년단원, 땅콩이든 판초콜릿
browning : n, 브라우닝 자동 권총
Browning : n, Robert(1812-89)Elizabeth(1806-61)영국의 시인 부부
browning robert : x, 영국의 시인부부
brownish : a, 갈색을 띤
Brownism : n, 브라운주의(영국의 청교도 Robert Browne이 제창한 주의)
brownness : n, 갈색(임)
brownnose : vi, ...에게 아첨하다
brownout : n, =dimout
brown paper : x, 갈색포장지
brown race : x, 말레이인종
brown rice : x 현미
brownshirt : n, 나치스당원
brownstate : a, (리넨 등이)염색되어 있지 않은
brownstone : n, a, 갈색의 사암(건축재료), 그것을 사용한 건물, 부유계급의(에 속하는)
brown study : x, 멍하니생각에잠김
brown sugar : x, 노란설탕
browny : a, =BROWNISH
browsability : n, 일람 가능성
browse : n, vi, vt, 어린잎, 새싹, 주사-(소 따위가 어린 잎)을 먹다, 책을 역저기 읽다
browser : n, 연한 잎(새싹)을 먹는 소(사슴), 띄엄띄엄 읽는 사람, 상품을 살 의향도 없이 만지작거리는 사람
Bruce : n, 남자 이름, 브루스(1274-1329)(스코틀랜드왕(1306-29), 영국군 격파, 스코틀랜드 독립 확보)
brucellosis : n, 브루셀라증(열병의 일종)
brucine : n, 브루신(유독 알칼로이드)
Bruin : n, 곰
bruise : n, vt, vi, 타박상, (과일의)흠-(몸, 마음에)상처를 내다, 감정을 상하게 하다
bruiser : n, 권투가, 난폭자
bruising : a, 치열한
bruit : vt, 소문을내다(a bout)
Brum : n, =birmingham
brumal : a, 겨울의, 겨울같은, 황량한
brumby : n, 사나운 말, 야생마
brume : n, 안개(fog, mist)
brummagen : n, a, 가짜(의), 싸구려(의)
Brummie : n, a, 버밍엄 사람, 버밍엄의
brumous : a, 안개짙은, 겨울의
brunch : n, 늦은조반, 조반겸 점심
Brunei : n, 모루네이 북서부의 영국 보호령
brunet : a, n, 브루네트의, 브루네트의 사람(머리와 눈이 검거나 갈색이고 피부색이 거무스름함)
brunette : a, n, (여성이)므루네트인-브루네트인 여자
brung : v, BRING의 과거(=BROUGHT)
Bruno : n, 남자 이름
Brunswick : n, 브라운 슈바이크(독일 중부의 지방 이름)
brunt : n, 공격의주력(bear the~)...의 정면에 맞서다
brush : n, vt, vi, 브러시, 솔, 숲, 꼬리, 질주, 작은 가지, 솔질하다, 털다, 비비다, 스치다, 질주하다
brushback : n, 빈볼(타자의 머리를 노린 볼)
brushburn : n, 찰과상
brush discharge : x, 브러시 방전
brushfire : n, a, 소강상태, 소강상태의
brushing : a, n, 휙 스쳐 가는, 민활한, 빠른, 솔질, 솔로 칠함, 쓸어 모은 것
brushland : n, 관목림 지역
brushless : a, 붓을 쓸 필요가 없는
brushoff : n, 거절, 해고
brushpencil : n, 화필, 그림붓
brushstroke : n, 일필, 일획, 필법
brushup : n, 닦음, 수리, 손질, 몸단장
brushwood : n, 숲, 베어낸 작은 나뭇가지, 물거리
brushwork : n, 그림, 화법, 화풍
brushy : a, 솔 같은, 덤불진
brusque : a, 무뚝뚝한
brusquerie : n, 무뚝무뚝함, 매정함
brussels : n, 브뤼셀(벨기에의 수도)(~sprouts평지과의 다년생 초본(양배추의 일종))
brut : a, (포도주가)단맛이 없는
brutal : a, n, vt, vi, 짐승같은, 잔인한, 야수성, 잔인, 무도, 짐승같이 만들다
brutality : n, 야만성, 잔인성, 무자비, 잔인한 행위, 만행
brutalization : n, 야수(잔인)성을 띠게 함
brutalize : vt, vi, 야수성을 띠게 하다(되다), (사람을)잔인(무정)하게 만들다, 잔인한 짓을 하다
brute : n, a, 짐승, 싫은 놈, 야수적인, 잔인한, 감각이 없는
brutify : vt, vi, =BRUTALIZE
brutish : a, 짐승 같은, 야비한, 잔인한, 우둔한(stupid), 육욕적인
Brutus : n, 브루투스 Marcus ~(85-42 B.C)(로마 공화당 수령, Caesar의 암살에 가담)
bruxism : n, (잠잘때)이갈기
Bryan : n, 남자 이름
Bryhild : n, 브린힐트(Sigurd가 요술의 잠에서 깨게 한 Valkurie)
bryology : n, 선택학
bryony : n, 브리오니아(박과의 덩굴풀), 브리오니아의 뿌리(토제, 하제)
bryophyte : n, 선태류의 식물
bryophytic : a, 
bryozoan : a, n, 이끼벌레류의(동물)
Brythonic : n, 브리손 사람(말)의, 브리손 말(캘트어의 일파로 Welsh, Cornish, Breton을 포함)
bub : n, 유방, 아가, 젊은이(소년, 젊은이엑 대한 호칭)
bubal : n, 영양(북아프리카 산)
bubaline : a, BUBAL 같은
bubble : n, vt, vi, 거품, 속임수, 사기, 거품일다, 부글부글 소리 내다
bubblegummer : n, (10대 전반 정도의)아이, 아이들 취향의 록 음악 연주자
bubblegun : a, (록 음악 등이)아이들 취향의
bubblehead : n, 바보
bubbleheaded : a, 어리석은
bubbler : n, 분수식 물 마시는 꼭지
bubbletop : n, 자동차의 방탄용 플라스틱 덮개, 투명한 비닐 우산
bubbly : a, n, 거품이 많은, 거품이 이는, 샴페인
bubblyjock : n, 칠면조의 수컷(turkey cock)
bubbonic : a, 서혜 임파선 종의
bubbonocele : n, 서혜 헤르니아
bubby : n, =BUB
bubo : n, 임파선종(특히 서혜부, 겨드랑이의)
bubon : a, 서혜선종의(~plague 선페스트)
bubu : n, =BOUBOU
buccal : a, 입의, 볼의
buccaneer : n, vi, 해적, 해적질하다
Bucchahood : n, 불교의 깨달음의 경지, 보리
bucentaur : n, 반우반인의 괴물
Bucephalus : n, Alexander 대왕의 애마, (익살)승용마
Buchanan : n, 뷰캐넌 James ~(1791-1868)(미국 15대 대통령(1857-61)
Bucharest : n, 루마니아의수도
Buchmanism : n, 1921년에 미국인Frank Buchman이 영국 Oxford에서 일으킨 신교 운동(Oxford froup movenent), 종교 재무장 운동
buck : n, vi, vt, 수사슴, (토끼, 염소 따위의)수컷, 멋쟁이, 흑인 남자, 뛰어오르다, 저항하다, 도약, 반항
buckandwing : n, 흑인의 댄스와 아일랜드계의 클로그댄스가 섞인 로큰롤의 빠른 탭댄스
buckaroo : n, 목동
Buck basket : x, 세탁물 공주
buckbean : n, 조름나물
buckboard : n, (차체가 판자로 된)4륜 짐마차, 운반부
bucked : a, 용기를 얻은, 기뻐하는
buckeen : n, 지체만 놓고 교양이 없는 가난한 청년 귀족
bucker : n, (탄 사람을 떨어뜨리는 버릇이 있는)사나운 말, 운반부
bucket : n, 바께쓰, 물통
bucketeer : n, 불법 비밀 브로커
bucketer : n, 불법 비밀 브로커
bucketful : n, 버킷 하나 가득(의 양)
bucket seat : x, (자동차 따위의)접의자
bucket shop : x, 무허가중개소, 엉터리 거래소, (주식의)장외 거래점
buckeye : n, 칠엽수류
buckhorn : n, 사슴뿔
buckhound : n, 사슴 사냥에 쓰는 작은 사냥개
Buckingham Palace : x, 버킹엄궁전(런던의 왕실 궁전)
Buckinghamshire : n, 영국의한주
buckish : a, 멋부리는, 플레이보이인
buckjump : n, 말이(탄 사람을 떨어뜨리려고)등을 굽히고 껑충 뛰어 오름
buckjumper : n, =BUCKER 1
buckle : a, vt, vi, 혁대장식, 구부리다, 비틀어지다
buckled : a, 죔쇠가 달린
buckler : n, 둥근방패
bucko : n, =BULLY, 뻐기는 사람, 젊은이(lad)
buckpassing : n, a, 책임회피
buckra : n, 백인, 주인
buckram : n, 아교를먹인천
Bucks. : x, Buckinghamshire
bucksaw : n, 틀톱
buckshee : a, n, 무료의(로), 특별한(히), 특별 수당, 횡재
buckshot : n, 사슴사냥용총알
buckskin : n, 사슴가죽, 고동색, 사슴가죽바지
bucktail : n, 사슴 꼬리 등의 털로 만든 제물 미끼
buckthorn : n, 털갈매나무
bucktooth : n, 뻐드렁니
buckwagon : n, =BUCKBOARD
buckwheat : n, 메밀, 메밀가루
buckwheater : n, 초심자, 신출내기
bucolic : a, n, 시골의, 양치는사람의, 목가
bucolical : a, =BUCOLIC
bud : n, vi, vt, 눈, 싹, 꽃봉오리, 싹트게하다, =BUDDY
Budapest : n, 부다페스트(헝가리의 수도)
budded : a, 싹튼, 꽃봉오리를 밍은, 아접한
Buddha : n, 부처
Buddhism : n, 불교
Buddhist : n, a, 	    불교도, 불교(불타)의
Buddhistic : a, 부처의, 불교(도)의
budding : a, n, 싹트기 시작한, 나타나기 시작한, 신진의, 발아, 움틈, 싹틈, 아접(법)
buddle : n, vt, 세광조(에서 씻다)
buddleia : n, 취어초속
buddy : n, 동료, 소년, 여보게(불는 말)
buddybuddy : a, n, 아주 친한, 막역한, 친구, 적, 미운 녀석
budge : vi, vt, 조금움직이다
budgereegah : n, 잉꼬(호주산)
budgerigar : n, 잉꼬(호주산)
budget : n, vi, 예산, 한묶음, 예산을세우다
budgetary : a, 예산상의
budgeteer : n, 예산을 짜는 사람, 예산 위원
budgie : n, =BUDGERIGAR
budlet : n, 어린싹
buds : n, 남성용 내의
budworm : n, 새순을 갉아 먹는 모충
buenos aires : x, 아르헨티나의수도
buff : n, vt, 담황색의가죽, 부드러운가죽으로닦다
buffalo : n, 물소, 아메리카들소, 수륙양용탱크
buffalofish : n, (북미산의)잉어 비슷한 민물고기
buffer : n, (기차 따위의)완충기
buffering : n, 난타, 난기류에 의한 항공기의 큰 진동
buffet : n, vt, vi, 일격, 치다, 싸우다, 찬장
buffoon : n, 익살꾼, 익살, 조잡한농담
buffoonery : n, 익살, 저속한 익살(농담)
buffy : a, 들소 가죽같은, 담황갈색의, 술 취한
bufotenine : n, 뷰포테닌(유독성 환각제)
bug : n, 빈대, 벌레, 고장, 결함, 젠체하는사람
bugaboo : n, 도깨비, 무서운것
bugbear : n, 도깨비, 무서운것
bugeyed : a, (놀라서)눈알이튀어나온
bugger : n, vt, vi, 비역쟁이, 싫은놈...와비역하다
buggerall : n, 무(nothing)
buggered : a, 기진맥진한
buggery : n, 비역, 남색
bugging : n, 도청
buggy : n, a, 말한필이끄는4륜마차, 빈대가많은
bughouse : n, 정신병원
bughunter : n, 곤충 학자(채집가)
bughunting : n, 곤충채집
bugle : n, vi, vt, (군대용)나팔(을 물다, 불어 집합시키다), 뿔피리
bugled : a, 관옥 장식이 달린
bugler : n, 나팔수
buglet : n, 작은 나팔
bugleweed : n, 쇱싸리(약용), =BUBLE, (북미산)콩과의 야초(wild indigo)
bugloss : n, 지치과의약초의일종(alkanet)
bugout : n, 전선 이탈(자), 적전 도망(병), 꾀부리는 사람
bugs : a, 미친(crazy)
buhl : n, (금은 따위의)상감
buhrstone : n, 규석(맷돌용)
buibui : n, 부이부이(아프리카 동부 연안의 이슬람 여교도가 숄로 쓰는 검은 천)
BUIC : n, BackUp Intercept Control예비 요격 관제 시스템
build : vt, n, 짓다, 세우다, 만들다, (재산 따위를)쌓아 올리다, 에의지하다, 만듦새, 뼈대, 구조
builder : n, 건물, 건축
building : n, 건물, 건축
building block : x, 집짓기나무
building line : x, (도로 따위에 임하는)건축제한선
building lot : x, 건축용대지
buildup : n, 형성, 발전, 선전, 매명, (장면을)최고조로 돋구어올리기, 날조 조작)
built : v, build의과거분사
builtin : a, 붙박이의, 고유의
builtup : a, 짜 맞춘, 조립한, 건물이 빽빽이 들어찬
Bujumbura : n, 부줌부라(Burundi의 수도)
bulb : n, a, 구근, 전구, 동글동글한
bulbaceous : a, 구근(구경)(모양)의, 구근성의
bulbar : a, 구근(인경)의, 연수의
bulbed : a, =BULBOUS
bulbiferous : a, 구근(인경)이 생기는
bulbil : n, =BULBLET
bulblet : n, 소인경, 구아, 구슬눈
bulbous : a, 구근(구경)의, 구근에서 생기는, 구근 모양의
bulbul : n, 명금의일종(nightingale의 일종), 가수
Bulgar : n, a, =BULGARIAN
Bulgaria : n, a, 불가리아, 불가리아의
Bulgarian : a, n, 불가리아(사람, 말)의, 불가리아 사람, 불가리아 말
bulge : n, vi, 부푼것, 이익, 배밑의만곡부, 전선의돌출부, 부풀다
bulger : n, 벌저(철면 나무 골프제)
bulgy : a, 불룩한
bulidup : n, 형성, 선전, 날조, 조작
bulimia : n, 식욕항진, 병적기아
bulimic : a, 폭식하는
bulk : n, vi, vt, 부피, 크기, 대부분, 더미(heap), 적하, 부풀다, 쌓아올리다
bulk buying : x, 매점
bulk cargo : x, 포장않은뱃짐
bulk fare : x, 단체여행할인항공운임
bulkhead : n, 격벽, 들어서여는문
bulky : a, 부피가큰, 거대한, 다루기힘든
bull : n, a, 황소, 수컷, 사는편, 경관, 쓸데없는소리, 센, 큰, 교서
bulla : n, 수포, 물집, 공문서용 인장, 관인, (특히)로마 교황인
bullace : n, 서양 자두나무의 일종
bullbaiting : n, (개를 부추겨서 괴롭히는)소놀리기
bullbat : n, 쏙독새(nighthawk)
bullboat : n, 쇠가죽배, 가죽배
bulldagger : n, 남성역의 여성 동성 연애자
bulldog : n, 불독, 용한사람
bulldoze : vt, 불도저로고르다, 강행하다
bulldozer : n, 불도저
bulldyke : n, =BULLDAGGER
bullet : n, 소총탄
bullethead : n, 둥근 머리(의 사람), 바보, 고집쟁이
bulletin : n, vt, 게시, 공보, 회보(~board 게시판)-게시하다, 공시하다
bulletproof : a, 방탄의
bullfight : n, 투우
bullfinch : n, 피리새
bullfrog : n, 식용개구리(북미산)
bullhead : n, 둑중개, 메기, 완고한사람
bullheaded : a, 완고한
bullhorn : n, 전기메가폰
bullion : n, 금덩어리
bullish : a, 황소 같은, 완고한, 우둔한, 강세의, 오름세의, 낙관적인
bullnecked : a, 목이굵은
bullnose : n, 주먹코, (돼지의)만성비염, (벽돌, 타일, 벽의)둥근 면
bullock : n, 불깐소
bullocky : a, n, 불깐 소 같은, 카우보이
bullous : a, 수포성의
bull pen : x, 소의우리, 유치장
bullpen : n, 불독의 새끼
bull pen : n, 소의 우리, 유리창, 구워 투수 연습장
bull ring : x, 투우장
bullring : n, 투우장
bull ring : x, 투우장
bullroarer : n, (호주 원주민의)의식용 악기의 일종, 목소리 큰 연사
bull session : x, 토론, 남자끼리의잡담
bull session : x, (비 공식의)토론, 자유 토론, 남자 끼리의 잡담 (모임)
bullseye : n, 과녁의중심점, 정곡, 둥근창, 둥근창, 볼록 렌즈(를 단 각등)
bullshit : n, 무의미한일
bull terrier : x, 불테리어
bullterrietr : n, 불테리어(불독과 테리어의 잡종)
bull tongue : x, 큰쟁기
bull tongue : x, (목화 재배용의)큰 쟁기
bullwhack : n, vi, vt, 소채찍(으로 때리다)
bully : n, vt, vi, a, 약자를괴롭히는자, 위협하다, 훌륭한, 통조림쇠고기
bullyboy : n, 폭력 조직의 하수인, 정치 깡패
bullyoff : n, 경기 개시
bullyrag : vt, 위협하다, 못살게굴다
bulrush : n, 큰고랭이, 애기부들
bulwark : n, vt, 누벽, 방파제, 뱃전, 방어하다
bum : n, a, vi, vt, 게으름뱅이, 부랑자, 쓸모없는, 빈둥빈둥놀고지내다
bumbailiff : n, 집달리(bailiff)
bumble : vi, vt, 실패하다, 실수하다, 더듬거리며 말하다, 엉망으로 하다, 실수하다, 큰실수, (꿀벌 등이)윙윙거리다
bumblebee : n, 뒝벌
bumbledom : n, 벼슬아치 근성(사회)(Dickens작 Oliver Twist에서)
bumblepuppy : n, 변칙 휘스트(whist), 고무공을 기둥에 매달고 라켓으로 서로 치는 놀이
bumbling : a, 거드름부리는
bumbo : n, 럼주에 단맛, 향기를 가한 술
bumboat : n, (정박중인 배에)식료품, 잡화를 팔러 다니는 작은 배
bumf : n, 화장지, 논문, 신문, 문서
Bumiputra : n, (말레이시아에서, 중국인과 구별하여)본토인, 말레이인
bummer : n, 부랑자, 빈둥 거리는 자, 불쾌한 경험(감각, 일)
bump : vt, vi, ad, n, a, 부딪치다, 털썩떨어뜨리다, 덜거덕거리며나아가다, 때려서생긴멍, 재능, 범퍼, 완충기
bumper : n, a, 부딪는(사람, 것), 범퍼, 완충기, 가득 채운 잔, 초만원의, 풍작의
bumpersticker : n, 자동차 범퍼에 붙인 선전, 광고 스티커
bumpertobumper : a, (자동차가)꼬리를 문, (교통이)정체된
bumpkin : n, 시골뜨기
bumpoff : n, 살인
bumptious : a, 주제넘은
bumpy : a, 울퉁불퉁한, 덜커덕거리는(jolting)
bun : n, 롤빵(건포도를 넣은 단 빵), (롤빵 모양으로)묶은머리(take the~ 일등이 되다, 이기다
Buna : n, 부나(합성 고무의일종, 천연 고무에 흡사함)
bunch : n, vi, vt, (포도 따위)송이
bunchberry : n, 산딸나무
bunchflower : n, 백합과 식물의 일종(미국 원산)
bunchgrass : n, (미국산)벼과의 풀
bunchiness : n, 송이 모양, 융기
bunco : n, 속임수의 내기, 야바위(치다)
buncombe : n, 인기위주의연설, 빈말
bund : n, 바닷가의거리
Bund : n, 친독협회(1936년 미국에서 독일계 미국인이 조직)동맹, 연합
Bundesrat : n, (서독의)상원
Bundestag : n, (서독의)하원
bundle : n, vi, vt, 다발, 꾸러미, 다발지어 묶다, 서둘러 떠나다(~lf nerves 굉장히 신경질적인 사람, ~oneself up 많이 껴입다
bundling : n, 약혼 중인 남녀가 옷을 입은 채 한 침대에서 자는 웨일스나 뉴잉글랜드의 옛 모습
bundobust : n, 준비 협정
bun fight : =TEA PARTY, 
bunfight : n, =TEA PARTY
bung : n, vt, vi, 마개 막다, 상처를 입히다, 쳐부수다
bungaloid : a, 방갈로식의
bungalow : n, 방갈로(식 주택)(베란다 있는 목조 단층 집)
bungee : n, (폭격기 탄창의)보조 조절 장치
bunghole : n, 통주둥이
bungle : n, 통주둥이
bungler : n, 실수하는 사람, 솜씨 없는 사람
bunglesome : a, 서툰, 솜씨없는
bungling : a, 서투른
bunion : n, (엄지발가락 살의)염증
bunk : n, vi, (배, 기차 따위의)침대, 등걸잠자다, 도망
bunk : n, =BUNCOMBE
bunk : n, vi, 도망하다, 뺑소니치다, (do a~ 도망하다)
bunkbed : n, 2단침대
bunker : n, vt, (배의)연료창고(에 쌓아 넣다), 벙커(모래따의 장애 구역), 지하 엄폐호
bunker coal : x, (석탄 수송선의)자항용연료탄
bunker oil : x, 연료유
bunkhouse : n, 산막, 합숙소
bunkie : n, =BUNKMATE
bunkmate : n, 같은 내무반을 쓰는 사람, 이웃 침대 사람
bunko : vt, =BUNCO
bunkum : n, BUNCOMBE
bunkup : n, (오를 때의)밀어 올리기, 받쳐 주기
bunnia : n, (인도에서)채식주의의 상인
bunny : n, 토끼, 다람쥐
Bunny : n, 여자 이름
bunt : vt, vi, n, 받다, 가볍게 치다
buntal : n, 번탈 섬유(모자용)
bunting : n, 멧새의무리, 기 만드는 천, 기
buntline : n, 가로돛 자락을 치켜 올리는 밧줄
Bunyan : n, 영국의목사작가, John(1628-88)
bunyip : n, 땅에 살며 사람을 잡아 먹는다는 야수, 사기꾼
buoy : n, vt, vi, 부표, 띄우다, 지지하다, 뜨다
buoyage : n, 부표 설치(표지), (집합적)부표(buoys), 계선 부표 사용료
buoyancy : n, 부력, 쾌활, 경쾌, 오름세
buoyant : a, 부력이있는, 경쾌한, 오름세의
bur : n, vi, 꾸엉의열매, 가시있는 식물, 성가신 사람=BURR
buran : n, 부란(시베리아 등 초원 지방의 폭풍)
Burberry : n, 바바리코트, 바바리 방수포
burble : vi, n, 부글부글소리나다, 투덜거리다-부글부글 소리내기, 투덜대기
burbot : n, 모캐
burbs : n, 도시 교외, 주택 지역, 베드 타운
burden : n, vt, a, 무거운짐, 부담, 귀찮은일, 무거운짐을 지우다, 귀찮은, 요지
burdensome : a, (견딜 수 없이)부담이 되는, 귀찮은, 성가신, 고된, 어려운
burdock : n, 우엉
bureau : n, 경대붙은옷장, 양소매책상, 사무소, 국, 부
bureaucracy : n, 관료정치
bureaucrat : n, 관료
bureaucratese : n, 관청 용어
bureaucratic : a, 관료 정치의, 관료식의, 번문 욕례의
bureaucratism : n, 관료주의
bureaucratize : vt, 관료 체제로 하다, 관료화 하다
bureaux : n, BUREAU의 복수
buret(te) : n, 뷰렛(눈금이 있는 유리관)
burg : n, 시, 읍
burgage : n, (영국에서 화폐 지대를 물고 봉건 영주에게서 얻은)도시 토지 보유권
burgee : n, (요트 등의)삼각기
burgeon : n, vi, 싹, 싹트다
burger : n, 햄버거스테이크(가 든 빵 hamburger)
burgerdom : n, 햄버거 업계
burgess : n, (borough의)시민
burgh : n, (Sc, )=BOROUGH
burgher : n, (네델란드, 독일의)시민
burglar : n, 밤도둑
burglar alarm : x, 자동도난경보기
burglarious : a, 주거 침입(죄)의, 강도(죄)의, 밤도둑(죄)의
burglarize : vt, vi, (불법으로)침입하다
burglarproof : a, 도난방지의
burglary : n, 밤도둑질
burgle : vt, vi, 밤도둑질하다
burgomaster : n, (네델란드, 독일 등지의)시장, 읍장
burgonet : n, (16-17세기의)가벼운 투구
burgoo : n, 오트밀(porridge), 걸쭉한 수프(스튜)
Burgundian : a, n, BURBUNDY(주민)의, BURGUNDY 주민
Burgundy : n, 부르고뉴에서나는붉은포도주
burhel : n, 히말라야 들양
burial : n, 매장
burial ground(place) : x, 묘지
burial service : x, 매장식
burier : n, 매장자
burin : n, 조각칼
burk : n, 부르카(이슬람 여교도의 장옷)
burke : vt, 질식시켜죽이다, 묵살하다, 휘지비지해버리다
burl : n, (실, 털실의)마디, (나무의)옹이
burladero : n, 부를라데로(투우장의 벽과 평행으로 만든 투우사의 도피 칸막이)
burlap : n, (부대용의)굵은삼베
burlesque : a, n, vt, 익살스러운, 풍자, 해학시, 익살스럽게 흉내내다
burley : n, Kentucky주산의담배
burliness : n, (몸집이)억셈, 크고 튼튼함, 솔직함, 퉁명스러움
burly : a, 강한, 억센, 덜렁대는
Burma : n, 버마
Burman : n, 버마 사람
Burmese : a, n, 버마의, 버마사람
burn : vt, vi, n, 태우다, 그슬리다, 불에데다, 화끈거리다, 흥분하다, 열중하다, 내리 쬐다, 볕에쬐다, 소작하다, 산화시키다, 개울
burn : n, 시내, 개울
burnable : a, 태울(구울, 달굴)수 있는
burnedout : a, 타버린, 못 쓰게 된, 식은
burner : n, 태우는사람, 버너
burnet : n, 오이풀
Burnham scale : x, 공립학교교원봉급기준표
burning : a, 불타는, 격렬한, 긴급한
burning glass : x, 화경
burning mountain : x, 화산
burning point : x, 발화점
burnish : vi, vt, n, 닦다, 광나다-광택, 윤
burnisher : n, 닦는(가는)사람, 연마기
burnoff : n, 화전 만들기
burnoose : n, (아라비아, 무어인의)두건달린망토
burnous : n, 두건 달린 겉 옷(아라미아 사람이 입는 망토)
burnout : n, (로켓의)연소 종료(점), (전기 기기의 합선에 의한)단선, 소모, 고갈, 화마
Burns : n, 번스(1759-96)(스코틀랜드의 시인)
burnsides : n, 구레나룻
burnt : n, burn의과거분사
burntout : a, =BURNEDOUT
burnup : n, 원자로의 연료 소비, 오토바이의 폭주
burny : a, 타(고)있는
burp : n, vt, 트림하다
burp gun : x, 자동권총
burr : vt, n, vi, 깔쭉깔쭉하게깎다, (치과 의사 등의)리머(reamer), 그릉그릉하다, 후음
burrhead : n, 흑인
burro : n, 당나귀
burrow : n, vt, vi, 굴, 굴을파다, 숨다, 탐구하다
burrstone : n, =BUHRSTONE
burry : a, (밤송이 처럼)가시 돋친 껍질이 있는, 따끔따끔 찌르는
bursa : n, 낭
bursar : n, 회계원, 장학생
bursarial : a, 회계과의, 재무담당의, 장학금의
bursary : n, (대학의)회계과, 대학의 장학금
bursectomy : n, 활액낭 절제술
bursiform : a, 주머니 모양을 한
bursitis : n, 활액낭염
burst : vt, vi, n, 파열하다, 터지다, 충만하다, 별안간 나타나다, 폭발, 돌발
burster : n, 작약
burstone : n, =BUHRSTONE
burstproof : a, (문의 자물쇠 등이)강한 충격에 견디는
burstup : n, =BUSTUP
burthen : n, v, =BURDEN
burton : n, 맥주의일종
Burundi : n, 아프리카중앙부의공화국
burweed : n, 가시 돋친 열매를 맺는 잡초
bury : vt, 묻다, 장사지내다, 몰두하게하다
Buryat : n, 부랴트족(시베리아 동부의 몽고족), 부랴트 말
burying : n, 매장(burial)
bus : n, vi, 버스, 여객기, 버스에타고가다
busboy : x, 식당웨이터의조수, 접시닦이
busby : n, 털모자
busgirl : n, BUSBOY의 여성형
bush : n, vi, vt, 관목, 숲, 삼림지, 무성하게자라다
bushcraft : n, 미개지에서 살아가는 지혜
bushed : a, 어찌할 바를 모르는, 지쳐버린(wornout)
bushel : n, vt, vi, 부쉘단위, 미국에서는 1, 95말, 영국에서는 2, 01말)부셀 되
busher : n, BUSH LEAGUE의 선수
bushfighter : n, 유격병, 게릴라
bushfighting : n, 게릴라전
bushhammer : n, 부시해머(돌의 표면을 다듬는 해머)
bushhog : vi, 한구역의 나무, 숲을 없애버리다
bushily : ad, 수풀(덤불)같이, (머리가)텁수룩하게
bushing : n, 굴대받이통(구두 따위 끈 꿰는 구멍의), 고리쇠
bush league : x, MINOR LEAGUE
bushman : n, (오스트레 일리아의)벽지개척자, 부시먼토인, 나무꾼
bushmaster : n, 열대아메리카산의큰독사
bush pilot : x, 미개척지를비행하는비행사
bushranger : n, 산적, 삼림지대에 사는 사람
bush telegragh : x, 밀림에서의정보전달법
bushveld : n, 충림 지대, 남아프리카 저지대
bushwa : n, 시시한 일, 난센스
bush warbler : x, 휘파람새의무리
bush whack : x, 덤불을헤쳐길을내다, 매복하다
bushwhack : vi, vt, 덤불을 베어 헤쳐 길을 재자-매복하다
bushy : a, 덤불같은, 털이많은
busily : ad, 바쁘게
business : n, 실업, 직무, 영업, 사업, 용건, 사건, 몸짓
business agent : x, 업무대리
business card : x, 업무용명함
business center : x, 번화가
business college : x, 실무학교(부기, 속기, 타이프 등을 훈련)
business correspondence : x, 상업통신
business cycle : x, 경기순환
business english : x, 상업영어
business fluctuation : x, 경기변동
business hours : x, 근무(영업)시간
businesslike : a, 사무적인, 민첩한
businessman : n, 사무원, 실업가, 회사원
businesswoman : n, 여자 실업가
busing : n, 버스 수송, (특히 백인과 흑인을 융합하려는)강제 버스 통학
busk : n, (코르셋의)가슴을 버티는 살대(고래뼈 또는 강철로 만듦)
busker : n, 거리의 연예인
buskin : n, 반장화, 비극(고대 그리스, 로마의 비극 뱅가 신은)두꺼운 바닥의 편상화
buskined : a, 반장화를 신은, 비극의(tragic), 고상한(말투 등)
busload : n, 버스한대분
busman : n, 버스승무원
busmans holiday : n, 평상시와 시븟한 일을 하며 보내는 휴일
busqueue : n, 버스를 기다리는 줄
buss : n, vt, 키스(하다), 쌍돛 어선, 짐배
bussbar : n, 모선
busses : n, BUS의 복수(buses)
bussing : n, =BUSING
bus stop : x, 버스 정류소
bust : n, vt, vi, 흉상, 반신상, 상반신, 가슴, 파열, 빠구, 실패, 파산하다, 실패하다
bustard : n, 능에
busted : a, 파멸(파산)한, 좌천(강등)된, 체포된
buster : n, 거대한것(크게 효과적인, 파괴적인)것, 법석, 소란, 젊은 친구, 서늘한 남풍
busthead : n, 값싼 술, 주정꾼
bustle : vi, vt, n, 떠들다, 떠들게 하다, 재촉하다, 서두르다, 야단법석
bustler : n, 수선스러운 사람
bustling : a, 부산스러운, 떠들썩한, 소란한, 붐비는
bustlingly : ad, 떠들썩하게, 번잡하게
bustout : n, vt, vi, 사기 도박에서 톡털림, 파산, 사기 도박에서 톡 털다(털리다)
bustup : n, 파열, 해산, 싸움
busty : a, 버스트가 큰(여성)
busulfan : n, 부설판(골수성 백혈병의 항생제)
busway : n, 버스 전용 도로(차선)
busy : a, vt, 바쁜, 통화중인, 번화한, 참견 잘 하는, 바쁘게 만들다
busybody : n, 참견하기좋아하는사람
busyness : n, 바쁨, 다망, 무의미한 활동(행동), 참견, 좋아함
busywork : n, (학교에서)시간을 보내기 위해서 과하는 학습 활동
but : x, 그러나, 그렇지만, 이외에는, 다만뿐
butadiene : n, 부타디엔(합성고무 제조용)
butane : n, 부탄
butch : n, 사내같은(여자), (동성애의)남성역의 여성, (남자의)상고머리, (여자의)단발
butcher : n, vt, 도살업자, 학살자, 외과의사, (열차, 관람석에서의)판매원, 권투 선수, 도살하다, 학살하다
butcher's : n, 푸줏간, 정육점
butcherbird : n, 때까치
butcherblock : a, 나무 토막을 모아서 만든, 토막 나무 세공의
butcherly : a, 백장같은, 잔인한(cruel), 서투른
butchery : n, 도살장(slaughterhouse), 도살업, 학살
buteo : n, 말똥가리
butler : n, 집사, 하인 우두머리(술 창고, 식기 등을 관리함), 궁내성 주류 관리자
butler : n, 집사, 하인 우두머리 식사 담당원
Butskellism : n, 대립 정당이 같은, 정책을 들고 나오는 상황
butt : n, vt, vi, 큰술통, 과녁, 웃음거리, 받다, 부딪치다, 돌출하다, 나무밑동, 꽁초
butte : n, 외따로선 산, 독메
butt end : x, 굵은쪽의끝, 그루터기, 남은 부분(조각)
butter : n, vt, 버터, 버터를  바르다, 아첨하다(look as if~would not melt in one's mouth 시치미 떼다, 태연하다)
butterball : n, =BUFFLEHEAD, 뚱뚱보
buttercream : n, 버터 크림(케이크 제조용)
buttercup : n, 미나리아재비
buttered : a, 버터를 바른
butterfat : n, 우유의지방(버터 원료)
butterfingered : a, 물건을 잘 떨어뜨리는, 서투른
butterfingers : n, pl, 물건을 잘 떨어뜨리는 사람
butterfish : n, 미끈거리는물고기(미꾸라지 따위)
butterfly : n, 나비, 멋쟁이, 바람둥이
butterflyer : n, 접영 선수
butterfly nut : x, (손으로 죄는)집게나사
butterfly spreader : x, 버터바르는주걱
butterfly stroke : x, 버터플라이수영, 접영
butterine : n, 인조버터
buttering : n, (쌓기 전에)벽돌 수직면에 모르타르를 칠하기, 아첨 말
butteris : n, 말굽 깎는 기구
butter knife : x, 버터나이프(빵에 버터를 바르는)
buttermilk : n, 버터밀크(버터를 뺀 후의 우유)
butternut : n, (북미산의)호두(열매, 재목)
butterscotch : n, 버터스코치(버터가 든 사탕, 버터볼)
butterwort : n, 벌레잡이제비꽃, 벌레오랑캐
buttery : a, n, 버터바른, 버터 비슷한, 저장실, 식료품 저장실
buttinsky : n, 말참견하는 사람
buttock : n, vt, 엉덩이, 고물, 허리치기, 업어치기, 허리(업어)치기로 던지다
buttocks : n, 엉덩이
button : n, vt, vi, 단추, 누름단추- ...에 단추를 달다, 단추를 채우다
buttonball : n, BUTTON TREE
buttonedup : a, 입을 다문, 말을 안 하는, (일 등이)완성된
buttonhole : n, vt, 단추 구멍(에 꽃는 꽃), 단추구멍을 내다, (아무를)붙들고 길게 이야기하다
buttonhole : vt, 단추구멍, 단추구멍을  내다, 붙들고 길게 이야기하다
buttonhook : n, 단추걸이(신 따위의 단추 끼는 고리)
buttonhook : n, 단추걸이
buttonless : a, 단추가 없는
buttonon : a, 단추로채우는단추식의
buttonon tree : x, 단추로 채우는, 단추신의
buttonthrough : a, (위에서아래까지)단추를채우는
buttonwood : n, 단추나무, 플라타너스
buttony : a, 단추같은, 단추가 많이 달린
buttress : n, vt, 버팀벽, 지지하다
buttstock : n, 개머리(총)
butty : n, 동료, (탄광)십장, 감독
butty : n, 버터를 바른 빵한 조각, 샌드위치
butut : n, 부투트(감비아의 화폐 단의)
butyl : n, 부틸(합성고무의일종)
butylene : n, 부틸렌
butyraceous : a, 버터성의, 버터 비슷한, 버터가 들어 있는
butyrate : n, 낙산염
butyric : a, 버터의(에서 뽑은), 낙산의
butyric acid : x, 낙산
Buua : n, 부나고무의일종
buxom : a, (여자가)통통하고 귀여운, 가슴이 풍만한, 건강하고 쾌활한
buxom : a, 토실토실한, 건강하고 쾌활한
buy : vt, vi, n, 사다, 매수하다, 손에 넣다, 한턱내다, (아무의)의견을 받아들이다, 선전에 넘어가다-구입, 물건사기-윙윙 거리다, ...에게 전화를 걸다
buyable : a, 살 수 있는
buyback : a, n, 되사는, 되삼
buyer : n, 사는사람
buyer's market : 구매자시장(공급과잉으로인한), 
buyin : n, 주식의 매입
buyingin : n, 사들임, 구입
buyoff : n, 전권리의 매점
buyou : n, 늪 같은후미, 내포
buzkashi : n, 부즈카시(죽은 염소(송아지)를 말을 타고 빼앗는 아프카니스탄의 국기
buzz : n, vt, vi, 벌레의날개소리, 기계의	   소리, 웅성거림, 속삭임, 윙윙거리다, 확자지껄하다
buzzard : n, 말똥가리, 아메리카독수리, 멍청이
buzzer : n, 윙윙거리는벌레, 버저, 사이렌, 경보
buzzing : a, 윙윙(와글와글)거리는
buzz saw : x, 둥근톱(circularsaw)
buzz session : x, 소그룹으로 나누어 개개인의 의견을 개진하는 과정
buzzwig : n, 머리 숱이 많은 큰 가발, 신분이 높은 사람
buzzword : n, (그럴듯하나)알맹이 없는 전문어, 동업자끼리의 통용어
bwana : n, 주인님, 나리(master, sir)
by : ad, prep, 곁에, 을 지나서, 제쳐놓고, 까지에는, 만큼, 관해서는, 을 경유로
byandby : n, 가까운미래
bybidder : n, 비싼 값을 불러서 경매품의 값을 올리기 위해 고용된 사람
bybidding : n, 경매인과 짜고 경매 가격을 올려 부르기
byblow : n, 싸움꾼 에 있다 쓸데 없이 얻어 맞는 것, 군매, 사생아
bycountry : a, 국별의
bye : pref, 
byeblow : n, =BYBLOW 2
byebye : n, 잠, 코하다
byeffect : n, 부수적(부차적)인 효과, 부작용
byelaw : n, 내규, 부칙, 세칙, (지방 단체의)조례
byelection : n, 보궐선거
Byelorussia : n, 백러시아(소련의 한 공화국)
Byelorussian : a, n, 백러시아의, 백러시아 사람(방언)의, 백러시아 사람, (러시아 말의)백러시아 방언
byelow : ad, int, (자장가에서)조용히(Hush!)
byend : n, 제2(부차적)복적, 사심
byform : n, (단어 등의)부차적인 형식, 이형
bygone : a, n, 과거의, 과거(the past)(Let~s be~s 과거를 묻지 말라
byjob : n, 부업
bylane : n, 골목길, 길
bylaw : n, (지방 자치 단체 등의)조례, 부칙, 세칙, (회사의)내규, (법인의)정관
bylina : n, 러시아의 서사시(민요)
byline : n, (철도의)평행선, (신문, 잡지의)필자명을 적은줄, 부업, 내직(sideline)
byliner : n, 서명기사를 쓰는 기자
byname : n, 성, 별명
bypass : n, vt, 우회로, 보조도로, 축도, (수도의)측관, 측로-우회하다, 회피하다, 무시하다
bypast : a, 과거의, 옛날의, 지나간
bypath : n, 사도, 샛길, 길
byplay : n, 부수적인연극, 본제를벋어난이야기
byplot : n, (소설, 희곡의)부차적인 줄거리
byproduct : n, 부산물
Byrd : n, 버드(1888-1957)(미국의 남극 탐험가)
byre : n, 외양간
byrlaw : n, 지방 관례 법규
byroad : n, 길, 샛길
Byron : n, George Gordon(1788-1824)영국의시인
byssinosis : n, 면폐증
byssus : n, (연체 동물의)족사, (고대 이집트의)아마포
bystander : n, 방관자, 구경꾼, 국외자
bystreet : n, 뒷골목, 뒷거리
bytalk : n, 여담, 잡담
byte : n, 정보단위로서 bit로 됨(바이트)(~mode 바이트 단위 전송 방식, ~storage바이트 기억기)
bytheway : ad, 그건 그렇고, 곁들여서, 그런데
bytime : n, 여가
Bytonic : a, 바이런식의(비장하면서도 낭만적임)
bywalk : n, 사도, 좁은 길, 길
byway : n, 길, 샛길(학문, 연구 따위의)별로 알려지지 않은 방면
byword : n, 우스운것, 웃음꺼리, 속담
bywork : n, 부업, 내직(byline)
byyourleave : n, 허락을 청함
byzant : n, =BEZANT
Byzantian : a, n, 비잔티움(Byzantium)의, 복잡한, 권모술수의, 비잔티움(동로마 제국)사람, 비잔틴파의 건축가, 화가
Byzantine : n, a, 비잔틴(Byzantium), 비잔틴식의, 
Byzantinesque : a, (건축, 예술이)비잔틴식(풍)의
Byzantinism : n, Comstantinople의 옛 이름, 지금의 Istanbul
Byzantinize : vt, (건축 등을)비잔틴식으로 하다
byzantium : n, 지금의이스탄불, constantinople의옛이름
BZ : n, 착란성 독가스의 일종의 기호
BZZ : n, 붕붕(장난감, 꿀벌 등의 소리), 삐삐(버저 소리)
