E : n, 알파벳 다섯번째 문자
E, & O, E : x, errors and omissions excepted오기와 누락은 별도
E, and P, : x, extraordinary and plenipotentiary 특명 전권의
E, B, : x, Encyclop(a)edia Britannica
E, C, : x, East Central(London의 우편구의 하나), Established Church
E, C, U, : x, English Church Union
E, coli : x, (세균)대장균
E, D, : x, Doctor of Engineering, Efficiency Decoration, election district, extra duty
E, D, D, : x, English Dialect Dictionary
E, D, T, : x, Eastern daylight time(미)동부 서머 타임
E, E, : x, errors excepted틀린 것은 별도로 치고, Early English, electrical engineer
E, E, & M, P, : x, Envoy Extraordinary and Minister Plenipotentiary 특명 전권 공사
E, E, T, S, : x, Early English Text Society 초기 영어 텍스트 협회
e, g, : x, (L exempligratia)=for example 예를 들면
E, H, F, : x, extremely high frequency (통신)마이크로파
E, I, : x, East Indies
E, I, S, : x, Educational INstitute of Scotland
E, L, D, O, : x, European Launcher Development Organization유럽 우주 로켓 개발 지구
E, long, : x, east longitude
E, M, U, : x, electromagnetic units
e, o, : x, ex officio직권상
e, o, m, : x, (주로 상)end of (the) month
E, P, : x, electroplate
E, P, B, : x, Economic Planning Board 경제 기획원, (영)Environmental Proection Board
E, P, D, : x, Excess Profits Duty 초과 이득세, Export Promotion Depathment
E, P, N, S, : x, electroplated nickel silver 전기 도금 양은
E, P, T, : x, excess profits tax
E, P, U, : x, European Payment Union 유럽 결제 동맹
E, Q, : x, deicational quotient(심)교육 지수
E, R, : x, East Riding, Eduardus Rex, emergency room
E, R, A, : equal rights amendment 미국 헌법 남져 동권 수정 조향, earned run avearge(투수의)방어율, Emergency relief
E, R, V, : x, English Revised Version
E, S, : x, enginesized
e, s, u, : x, electrostatic unit(s)정전 단위
E, T, U, : x, Electrical Trades Union
E, U, : x, Evangelical Union
E, W, O, : x, Essential Work Order
E/D card : x, 출입국 카드
ea : x, each
EA : x, educational age(교육)교육 연령, enemy aircraft
EAC : x, East Africam Community 동아프리카 공동체
EACE : x, European Atomic Energy Community, East African Economic Community 동아프리카 경제 공동체
each : a, ad, 각각의, 제각기의(each other 서로, 각각에 대해서)
eager : a, 열심인, 열망하여(for, about, ofter, to do)
eager beaver : x, 일벌레, 노력가
eagerly : ad, 열망하여, 열심히, 간절히
eagerness : n, 열심, 열의, 열망
eagle : n, 수리, 수리표, 독수리자리
eagle day : x, (미군속)봉급날
Eagle defense : x, 이글 디펜스(수비 대형의 하나)
eagle eye : x, 날카로운 눈, 눈이 날카로운 사람, 탐정
eagleeyed : a, 눈이 날카로운
eagle freak : x, (미속)(종종 경멸적)자연(환경) 보호주의자, 야생동물 보호주의자, (특히 천연자원 등의)보호론자
eaglehawk : n, (조)수리매(남미산)
eagle owl : x, (조)수리부엉이(유럽산)
eagle ray : n, 매 가오리
eagle scout : x, (미)21개 이상의 공훈 배지를 받은 보이스카우트 단원
eaglet : n, 새끼수리
eagre : n, 해소(특히 영국 Humber, Trent, Severn강 하구의)
EAL : x, Eastern Air Lines(미)동부 항공사
Eames chair : x, (미국의 디자이너 Charles Eames의 이름에서)(합판, 플라스틱제의)몸에 맞게 디자인된 의자
ear : n, 귀, 귓바퀴, 귀꼴의 물건(손잡이 등), 청각, 경청(about one's ears 주위에, be all ears 열심히 듣다)
ear : n, 보리 따위의 이삭, 옥수수 열매(in the ear 이삭이 패어서)
earache : n, 귀앓이
earbash : vt, vi, (오스속)...에게 계속 지껄여 대다, 계속해서 지껄이다
earbender : n, (미구)쉴새없이 지껄이는 사람, 수다쟁이
earcap : n, (영)(방한용)귀덮개
earcatcher : n, 소리로 남의 주의를 끄는 것, 외기 쉬운 곡(가사)
eardeafening : a, 귀청이 떨어질것 같은
eardrop : n, 귀고리
eardrum : n, 고막, 귀청
eared : a, (종종 복합어를 이루어)귀(모양의 것이)있는, 귀가 달린, ...의 귀가 있는
eared : a, (종종 복합어를 이루어)이삭이 팬, ...의 이삭이 있는
earflap : n, 귀덮개
earful : n, (구)허풍, 깜짝 놀랄 만한 소식, 잔소리
earhole : n, 귓구멍, 이도
earing : n, (해)돛의 윗귀를 활대에 잡아매는 가는 밧줄
earl : n, 백작(영국이외의 외국의 count에 해당)
Earl : n, 남자 이름
earlap : n, 귓불
earldom : n, 백작의 신분
earless : a, 귀없는, 이삭없는
earliness : n, 이름, 빠름, 조기
Earl Marshal : x, (영국의)문장원 총재(현재는 Norfolk 공작 집안의 세습직)
earlobe : n, 귓불
early : 이른, 초기의, 일되는, 맏물의, 어릴때의, 가까운 장래의(at an early date 금명ㄹ간에, 머지 않아, keep early hours 일찍자고 일찍 일어나다, 일찍, 이른 때에, 초기에
early bird : x, 일찍 일어나는 사람, 정한 시각보다 일찍 오는 사람
Early Bird : x, 미국의 상업 통신 위성(북미와 유럽간의)
earlybird : a, (구)이른 아침의, 일찍 오는 사람을 위한
early closing : x, 개점 시간 단축(일)
early door : x, 특별 출입구(특별 요금으로 정각보다 빨리 입장시키는 문)
Early English : x, 초기 영어
Early English style : x, 초기 영국의 건축 양식
early leaver : x, (영)(학교의)중도 퇴학자, 낙오자
Early Modern English : x, 초기 근대 영어
earlytobedder : n, 일찍 자는 사람
earlyVictorian : a, n, 빅토리아 왕조 초기의(사람(작가)), 구식의(사람)
early warning : x, (방공 등의)조기 경보
earlywarning radar : x, 핵공격에 대한 조기 경보 레이더
earlywarning system : x, (군)(핵공격에 대한)조기 경보 조직
earmark : n, vt, 소유자를 표시하는 양의 귀표를 하다, 페이지 모서리의 접힘, 자금의 용도를 지정하다
earminded : a, (심)청각형의
earmuffs : n, 귀싸개
earn : vt, 벌다, 일하여 얻다, 손에넣다, 차지하다, 받다, 얻다, 감사 따위를 받을 만하다
earned income : x, 근로 소득
earned run : x, (야구)(투수의)자책점, 언드런
earned run average : x, (야구)(투수의)방어율
earnest : a, n, 성실한, 진지한, 열심인, 중대한, 엄숙한, 성실, 진심, 진지, 정식(in earnest 성실하게, 진심으로)
earnest : n, 보증(pledge)=money 착수금
earnestly : ad, 진지하게, 진정으로
earnest money : x, 계약금, 약조금
earning power : x, (경)수익(능)력
earnings : n, 벌이, 소득, 수입
earnings per share : x, (증권)주당 순익(순이익을 발행된 평균 주소로 나눈것)
earningsrelated : a, 소득에 따른, 소득액 비례 지급 연금
Earnings Related Supplement : x, (영)보험 급부금(영국의 사회보장제도에서 6개월간 실업자(환자)에게 전년도 소득에 따라 지급됨)
earnings yield : x, (증권)이율(주당 순익을 주가로 나눠 얻어지는 이익률)
EAROM : n, (전산)기억되어 있는 데이터를 전기적으로 바꿔 써 넣을 수 있는 롬(ROM)
earphone : n, 이어폰
earpick : n, 귀이개
earpiece : n, =EARPLLONE
earpiercing : a, 귀청이 찢어질 것 같은(비명)
earplug : n, 귀마개
EARREACH : n, =earshot
earring : n, 이어링, 귀고리
ear shell : n, 전복
earshot : n, 들리는 거리
ear specialist : x, 이과 전문의
earsplitting : a, 귀청이 터질듯한
earth : 지구, 이세상, 사파세계, 육지, 지면(come back   to earth 꿈에서현시로 돌아오다, 제정신이 들다), 흙	속에 파묻다, 뿌리  따위에 흙을 덮다..., 을 접지하다
earth art : x, (미)어스 아트 (지형, 경관 등을 소재로 한 공간 예술)
earth bag : x, 모래 주머니
earthborn : a, 땅위에 태어난, 인간적인, 세속의
earthbound : a, 땅에 고착한, 세속적인, 지구로향하는
earthbred : a, 지상에서 자란, 천한
earth closet : x, (영)토사 살포식 변소, 노천 변소(전쟁터에서 사용)
earth current : x, 지전류
Earth Day : x, 지구의 날(환경 보호의날, 4월 22일)
earthday : n, 지구일(다른 천체상의 시간을 환산하는 데에 쓰이는 지구상의 24시간의 하루)
earthen : a, 흙의, 흙으로 만든, 오지로 만든
earthenware : n, 질그릇, 오지그릇
earth god : x, 식물과 비옥의 신
earth goddess : x, 식물과 비옥의 여신
earth house : x, 흙집, 땅 속의 집
earthian : n, a, 지구인, 지구의
earthiness : n, 토질, 토성, 속취, 속악
earthlight : n, (천)=EARTHSHINE
earthliness : n, 지구상의 것으로서의 성질, 현세(세속)적임, 속됨
earthling : n, 안간, 속인
earthlubber : n, 지구 밖으로 나가 본(우주 비행을 한)적이 없는 사람, (우주에서 본)지상 생활자, 우주 비행사가 아닌 사람
earthly : a, 지구의, 세속의
earthlyminded : a, (고)속세적인
earthman : n, 지구의, 지구인, 주민
earthmother : n, 땅의 요정, 관능적인 여자
earthmover : n, 땅차, 토목기계
earthnut : n, 낙화생, 땅콩
earth orbital velocity : x, 지구 궤도 속도
earth pillar : x, (주위의 흙의 침식에 의해 생기는)흙기둥
earthquake : n, 지진, 대변동
earthquake center : x, 진앙, 진원지
earthquake insurancd : x, 지진보험
earthquake intensity : x, 진도
earthquake lights : x, 지진시의 발광 현상(지진 때 하늘이 밝게 빛나는 현상
earthquakeproof : a, 내진의
earthquake sea wave : x, 해일
earthquake shock : x, 지진(의 진동)
earthquake sounds : x, =EARTH SOUNDS
earth resources satellite : x, 지구 자원 탐사 위성
earthrise : n, 지구의 떠오름
earthsatellite : n, 인공위성
earthscape : n, (미)(우주선 등에서 본)지구의 모습(경관)
earth science : x, 지학
earthshaking : a, 세계를 떠들썩하게 하는, 극히 중대한 
earthshine : n, (천)(달의 어두운 부분을 엷게 비추는)지구의 반사광
earthshock : n, 지변, 천재 지변(지진, 화산 폭발, 기상 이변 등)
Earth Shoes : x, 뒷축이 앞축보다 낮은 구두(발이 피로하지 않고 편하다고 함, 상표명)
earth sounds : x, 땅울림
earth station : x, 지상국(위성, 우주 통신용)
earth table : x, (건)근석(건물의 토대중에서 땅 표면으로 나온 부분)
earth time : x, 지구시(간)(천체 현상을 지구상에서 관측하는 데 사용, 지구 자전의 시간이 기준이 됨)
earth tremor : x, 약한 지진
earthward : ad, a, 땅(지구)쪽으로(향한)
earthwards : ad, =EARTHWARD
Earthwatch : n, 지구 감시망(세계적 규모로 환경 오염을 감시하기 위해 만들어진 것)
Earth Week : x, 지구(보호)주간(환경 보호의 주간, 1971년 4월 18-24일에 실시)
earthwork : n, 방어용 흙둑, 토목공사, 대지 예술(흙, 돌, 모래, 얼음 등 자연물을 소재로 함)
earthworm : n, 지렁이
earthy : a, 흙의, 흙같은, 세속의, 야비한, 하치의
earthyear : n, 지구년(1년을 365일 기준으로 한 시간)
ear trumpet : x, 보청기
ear trumpet : x, 나팔꼴 보청기
earwax : n, 귀에지
earwig : n, 집게벌레
earwitness : n, 남이 하는 이야기를 듣는(보고하는)사람, (법)전문 증인
ease : 편안, 안락, 쉬움, 여유, 넉넉함, 편안히, 마음놓고, 안심하다, 불안하여, 마음놓이지 않아, 긴장하 여, 마음을 편히하다, 안심시키다, 덜다, 늦추다
easeful : a, 마음 편한, 안락한
easel : n, 화가
easeless : a, 마음이 편치 않은, 심신이 안정되지 않은, 불안한
easel painting : x, 화가에 얹어서 그리기에 알맞는(크기의)그림
easement : n, 고통 따위의 완화, 지역권(남의 땅을 통행하는 권리 등)
eashsoutheast : n, a, ad, 동남동, 동남동의, 동남동으로, 동남동으로부터
easily : ad, 편안히, 쉽사리, 쉽게
easiness : n, 용이함, 쉬움, 평이(plainness), 평정
east : n, a, ad, 동쪽, 동양, 미국동부의 여러 주(east by north 도미북, in the east of ...의 동부), 동쪽의 동무의, 동족으로에
East Asia : x, 동아시아
East Berlin : x, 동베를린(동독의 수도)
East Bloc : x, 동구 공산권(바르샤바 조약기구)에 가맹한 소련과 동구 여러 나라)
eastbound : a, 동쪽으로가는
East Central : n, (런던시의)중앙 동부 우편구)
East China Sea : n, 동지나해
East End : x, 런던 동족 끝(이전의 빈민가)
easter : n, 동풍, (특히)동쪽에서 불어오는 폭풍(강풍)
Easter : n, 부활절
Easter card : x, 부활절 카드
Easter cycle : x, 부활절 순환기
Easter Day : x, =EASTER SUNDAY
Easter dues : x, =EASTER OFFERINGS
easter egg : x, 부활절의 채색달걀
easter eve : x, 부활절 전야
easter lily : x, 백합
easterling : n, 동쪽 나라의 국민
easterly : a, n, ad, 동쪽에 치우친, 동쪽에서 부는, 동풍
Easter Monday : x, 부활절의 다음날
eastern : a, 동쪽의, 동양의, 동부지방의
Eastern Air Lines : x, 이스턴 항공(미국의 항공회사)
Eastern Church : x, 동방 교회(그리스 정교회)
Easterner : n, (미)동양 사람, 동부지방(제주)의 주민(출신)
Eastern Establishment : x, 동해안 주류파(하버드, 예일, 콜럼비아 대학 등 동해안의 명문교 출신으로 정치, 재계의 중추를 이루는 인맥)
eastern hemisphere : x, 동방교회
Eastern hemisphere : x, 동반구
easternmost : a, 가장 동쪽의
Eastern Orthodox Church : x, 동방 정교회)
Eastern Rite Church : x, 동방 전례 교회(그리스, 시리아 등의 카톨릭 교회, 성직자가 가정을 가질 수 있음)
Eastern Roman Empire : x, 동로마 제국
Eastern Standard time : x, 동부 표준시(캐나다 동부, 미국 동부, 오스트레일리아 동무)
Eastern state : x, (미)동부의 여러 주
Easter offerings : x, 부활절의 헌금
easter sunday : x, 부활주일
Easter Sunday : x, 부활 주일(=EAsterday)
Easter Term : x, (영법)4월 15일 후 약 3주간의 개정기, (영대학)봄학기, 크리스마스부터 부활절까지의 학기
Eastertide : n, 부활절부터 강립절까지의 50일간=EASTERWEER
Easter Week : x, 부활절로 시작되는 1주일
East Germanic : x, (언)동게르만어(군)
East Germany : n, 동독(수도 Berlin)
East India Company : x, 동인도 회사(영국이 1600년에 설립, 1874년 해산)
East Indian : x, 동인도의(토인, 주민)
East Indies : n, 동인도
easting : n, 동항, 편동항행, (천체의)동진, (바람 방향의)동향, 동향, 동방위
Eastman : n, 이스트먼
eastnortheast : n, a, ad, 동북동, 동북동, 동북동으로(에서)
East Pakistan : n, 동파키스탄(1971년말 독립하여 Bangladesh가 됨)
East Side : x, 뉴욕 Manhattan섬 동부의 하층 이민 지구
East Sussex : n, 잉글랜드 남동부의 주
eastward : n, a, ad, 동쪽, 동쪽의
eastward : ad, a, 동쪽으로(의)
eastwards : ad, =EASTWARD
easy : a, ad, n, 쉬운, 안락한, 편안한, 다루기 쉬운, 평이한, 게으른, 부드러운, 관대한 다투기 쉬운, 말을 잘 듣는, 문체가 평이한, 까다롭지 않은
easy chair : x, 안락 의자
easydoesit : a, 마음편한
easygoing : a, 태평한, 단정치 못한, 느린 걸음의
easy make : x, (속)=EASY MARK, 쉽게 몸을 허락하는 여자
easy mark : x, 호인
easy meat : x, (구)쉽게 속는(이용당하는)사람, 손 쉬운것
easy money : x, 수월학 번 돈, 부정 한 돈
easy street : x, (구)유복한 신분, 재정적 독립
easy virtue : x, 몸가짐이 헤픔, 부정
eat : 먹다, 먹어  들어가다, 침식하다, 파괴하다, 식사하다, 먹을 수 있다, 먹이 들어가다, 부식하다, 슬픔에 잠기다
EATA : x, East Asia Travel ASSOCIATION
eatable : a, n, 먹을 수 있는, 식료품
eaten : v, EAT의 과거분사
eater : n, 먹는 사람, 부식물(제), 날로 먹을 수 있는 과일
eatery : n, (구)간이 식당
eatin : (1960년대에)흑인이 인종 차별 식당에 몰려가서  식사를 하는 차별 항의운동, (미구)(1980년대에)검소한 회식을 하고 그 회비의 일부를 좋은 일에 기부하는 운동, (미속)오럴섹스를 하는 난잡한 파티
eating : n, a, 먹기, 식품, 좀먹어 들어가는, 식용의
eating house : x, 식당
Eaton agent : x, (의)이튼 인자
eau : n, 물
eau de Cologne : x, 오드콜론(향수)
eau de Nil : n, (F (나일강의 물)이란 뜻에서), 암녹색
eau de vie : x, 브랜디
eau sucree : n, (F)설탕물
eaveadropping : n, 엿듣기
eaves : n, 처마
eavesdrop : v, 엿듣다
Eb : x, (화)erbium
EB : x, eastbound
ebb : n, vi, 썰물, 간조, 쇠퇴(ebb and flow 썰물), 성쇠, 기울다
ebb tide : x, 썰물, 쇠퇴기
EBCDIC : n, (전산)확장 2진화 10진 코드
Ebenezer : n, 남자이름
EBF : x, Encyclop(a)edia Britannica Film(대영 백과 사전을 기초로 한 교육 영화)
Eblaite : n, a, 에블라어(어)(북시리아에서 발견된 세계 최고의 셈어족 언어), 에블라어의, 에블라 왕국의
Eblan : a, =EBLAITE
EbN : x, east by north 동미북
Eboat : n, 제1차대전때의 독일 쾌속 어뢰정
Ebolavirus : x, 고열과 내출혈을 일으키는 열대 전염병 바이러스, Ebola는 자이르 북부의 강
ebon : n, a, (고, 시)=EBONY
ebonite : n, 에보나이트
ebonize : vt, 흑단 비슷하게 (착색)하다
ebony : n, a, 흑단, 칠흙의
Ebor, : x, Eboracensis(L=of York, Archbishop of York가 서명에 사용, Cantuar)
EBR : x, Experimental Breeder Reactor 실험용 증식로
ebriety : n, =INEBRIETY
EbS : x, east by south 동미남
ebullience : n, (문어)비등, (감정 등의)격발, 격정의 발로
ebullient : a, 팔팔끓는, 넘쳐흐르는, 열광적인
ebullism : n, (의)(급속한 기압강하로 인한 체액 비등
ebullition : n, 비등, 돌발, 격발, 분출
E by N : x, east by north
E by S : x, east by south
ec : n, 경제학
EC, E, C, : x, European Community유럽 공동체
ec- : x, (연결형)(세대, 경제)의 뜻(모음 앞에서는 ec-)
ec- : x, (연결형)(환경, 생태)의 뜻(모음 앞에서는 ec-)
ECA : x, Economic Commission for Africa(국제연합)아프리카 경제 위원회, Economic Cooperation Administration(미)경제 협력국(MSA의 구칭
ecad : n, 어떤형태가 유전이 아니고, 외부환경에 의한 변화형태라고 인정되는것
ECAFE : x, Economic Commission for Asia and Far East
ecarte : n, 에카프테(32장을 가지고 두 사람이 하는 카드놀이)
ecbolic : a, n, 낙태, 유산시키는, 분만을 촉진시키는
ECC : x, Economic Cooperation Committee
eccehomo : n, 가시면류관을 쓴 그리스도의 초상
eccentric : a, n, 편심의, 편심적인, 별난, 괴짜의, 괴짜, 별난사람, 편심론, 편심륜
eccentricity : n, 별남, 괴벽
ecchymosis : n, (병리)(타박에 의한)반상출혈
Eccl(es), : x, Ecclesiastes
eccl, : x, ecclesiastical(ly)
ecclesia : n, 고대 그리스의 국민회의
ecclesiastes : n, 전도서
ecclesiastic : n, a, 목사, 교회의, 성직의
ecclesiastical : a, 교회의, 성직의
ecclesiasticism : n, 기독교회의 주의(관행, 정신, 전통), 교회(중심)주의
Ecclesiasticus : n, 집회의서
ecclesiological : a, 교회학상의, 교회 건축학적인
ecclesiology : n, 교회학, 교회 건축학
Ecclus, : x, Ecclesiasticus
ECCM : x, electronic countercountermeasures(군)대전자 대책(전자 대책(ECM)에 대한 대항 수단의 총칭)
eccrine : a, (생리)외분비(선)의, 누출 분비의
eccrinology : n, (생리)분비선학
ecdysiast : n, (미, 익삭)=STRIPTEASER
ecdysis : n, 탈피, 허물
ecdysone : n, (생화)(곤충 등의)탈피 호르몬
ECE : x, Economic Commission for Europe(국제연합) 유럽 경제 위원회
ECG : x, electrocardiogram
ech, : x, echelon
echelon : n, vi, 사다리꼴편대
echidna : n, 바늘두더지
echin- : x, (연결형)(가시, 섬게)의 뜻(모음 앞에서는 echin-)
echinate : a, 가시가 많은, 유극의
echinoderm : n, 극피동물(섬게, 불가리, 해삼 따위)
echinoid : n, a, (동)섬게(같은)
echinus : n, (동)섬게, (건)만두형(도리아식 건축 양식의 주관을 이루는 아치형)
echo : 메아리, 반향, 흉내내기, 모방, 숲의요정(Narcissus에 대한 사랑을  이루지 못하여 말라주어서 소리만 남았음), 메아리치다, 반향하다, 그대로 되풀이하여 대답하다, 모방하다
ECHO : n, (의)초음파 검사법(체내 장기의 이상을 조사하는 방법, 종양, 돌 검출에 유용)
echocardiogram : n, (의)초음파 심장 진단도
echo cardiography : x, (의)초음파 심장 검진(법)
echo chamber : x, (방송)잔향실(연출상 필요한 에코 효과를 만들어 내는 방)
echo effect : x, 메아리 효과(어떤 일이 뒤늦게 되풀이 되거나, 그 결과가 늦게 나타나는 등의 현상)
echoencephalography : n, (의)초음파 뇌검사(법)
echogram : n, (해)음향 측심 기록도, (의)에코도(오실로스코프의 스크린에 나타나는 환부 조직의)
echoic : a, 반향의, 반향 장치의, (언)의음(의성)의
echolalia : n, (심)반향언어(남의 말을 그대로 흉내내는 행동), (유아기의)음성 모방
echolocate : vt, ...을 음파 탐지하다, 음파 탐지 기능을 갖다
echolocation : n, 반향정위)박쥐등이 초음파를 내어 그 반사로 물체의 위치를 아는 것)
echo machine : x, (전)반향 장치(테이프 리코더 등을 이용하여 인공적으로 반향음을 만들어 내는 장치)
echo sounder : x, 음향 측심기
echo sounding : x, (해)음향 측심
echovirus : n, 에코바이러스(인체의 장내에 번식하며 수막염 등을 일의킴)
ecize : vi, (생태)(특히 이주성 생물이)새로운 환경에 정착, 순응하다
ECLA : x, Economic Commission for Latin America(국제연합)라틴아메리카 경제 위원회
eclair : n, 에클레어(인체의 장내에 번식하며 수막염 등을 일의킴)
eclair : n, 에클레어(가늘고 길쭉한 슈크림)
eclaircissement : n, (F)석명, 해명, 설명
eclampsia : n, (병리)경련, (특히)자간, (어린이의)급간
eclat : n, 대성공, 대갈채
eclectic : a, n, 취사선택적인, 절충주의의
eclecticism : n, 
Eclectic School : x, (철)절충학파, (미)절충화파(16세기말 이탈리아의 볼로냐화파, 또는 19세기초 프랑스화의 일파)
eclipse : n, vt, 식, 실추, 빛의 소멸, 능가하다, ...의 명성을 빼앗다
eclipsis : n, (언)(문장 일부의)생략, (선행어의 영향에 따른)어두 자음의 음성 변화
ecliptic : a, n, 식의, 황도의
ecliptical : a, =ECLIPTIC
eclogue : n, 전원시
eclosion : n, 우화, 부화
ECLSS : x, environmental control and life support system, 환경 제어, 생명 유지 시스템
ECM : x, European Common Market 유럽 공동 시장, electronic countermeasures
ECNR : x, European Council of Nuclear Research
eco- : x, (연결형)=EC
eco- : x, (연결형)=EC
ecoactivist : n, 환경운동가
ecoactivity : n, 생태계 보전 활동, 환경 오염 방지 운동
ecocatastrophe : n, (환경 오염에 의한)생태계의 대변동
ecocidal : a, 
ecocide : n, 환경파괴
ecoclimate : n, (생태)생태기후(생식지의 기후 요인의 총체)
ecodevelopment : n, 환경, 경제의 조화를 유지하는 개발
ecodoom : n, 생태계의 대규모 파괴
ecodoomster : n, ECODOOM을 예언(경고)하는 사람
ecofallow : n, (농)농지 휴한 농법
ecofreak : n, (속, 경멸)열렬한 환경 보호론자, 자연 보호론 신봉자
ecogeographic : a, (생태)생태 지리적인(환경의 생태학적인 면과 지리학적인 면의 양 쪽에 관련되는)
ecol, : x, ecological, ecology
ecole : n, (F)학교, 학파
ecological : a, 생태학의
ecological allergy : x, (의)생태학적 알레르기(화학 물질, 석유 제품 등에 의한)
ecological art : x, 환경 예술, 생태학적 예술(자연의 흙, 모래, 얼음 등을 소재로 한 예술)
ecological efficiency : x, (생태)생태 효력, 생태적 효율(물질, 에너지의 전이 효율)
ecological pyramid : x, (생태)생태적 피라미드
ecological succession : x, (생태)생태 천이
ecologist : n, 생태학자
ecology : n, 생태학, 환경, 사회형태학
ECOM : x, (Electronic Computer Originated Mail)(미)전자 우편 서비스
ecomone : n, (자연계의 균형에 영향을 미치는)생태 호르몬
econ, : x, economic(s), economist, economy
econiche : n, 생태적 지위
econobox : n, 경제차(연료 소비가 적은 상자형 자동차의 별명)
econometrics : n, 계량경제학
economic : a, 경제학상의, 경제상의, 경제적인
economical : a, 절약하는, 검약한, 실용적인
Economic and Social Council : x, =ECOSOC
economic animal : x, 경제 동물(경제 대국으로서의 일본을 야유하는 호칭)
economic blockade : x, 경제 봉쇄
economic botany : x, 실용 식물학
economic crime : x, 경제 범죄(공금 횡령, 수회, 밀수, 부정 축재 등)
Economic Decentralization : x, 경제력 집중 배제법
economic development zone : x, (중공의)경제 개발구
economic growth rate : x, 경제 성장률
economic indicator : x, (경)경제 지표
economic man : x, (경)경제인
economic model : x, (경)경제 모델
Economic Planning Board : x, 경제 기획원(한국)
economic police : x, 경제 경찰
Economic Report : x, (미국 대통령의)경제 보고(연초에 상하 양원에 보냄)
economics : n, 경제학
economic sanctions : x, 경제적 제재(봉쇄)
economic zone : x, 경제 수역
economism : n, 경제주의, 경제지상주의
economist : n, 경제학자, 검약가
economization : n, (금전, 시간, 노력 등의)절약, 경제적 사용
economize : vt, vi, 경제적으로 사용하다, 절약하다
economizer : n, 절약가, 경제가, 검약가, (화력, 연료 등의)절약 장치
economy : n, 경제, 검약, 절약, 유기적 조직, 섭리(practice economy 식물체의 조직)
economy class : x, 이등
economysize : a, 값싸고 편리한(작은)사이즈의, 보통보다 값싸고 큰
econut : n, (속)=ECOFREAK
ecophysiology : n, 환경 생리학
ecopolitics : n, 경제 정치학, 환경 정치(정책)학
ecopornography : n, 환경 문제에 대한 일반의 관심을 이용한 광고
ECOSOC : n, Economic and Social Council
ecospecies : n, (생태)생태종
ecosphere : n, (우주의)생물 생존권, (특히 지구의)생물권, 생태권
ecosystem : n, 생태계
ecotage : n, 환경 오염 반대 파업(특히 환경 오염원에서 일하는 사람들의)
ecotecture : n, 환경 우선 건축 디자인(환경상의 요인을 실용보다 중시하는 디자인)
ecotone : n, (생태)이행대, 추이대(인접하는 생물 군집간의 이행부)
ecotype : n, (생태)생태형
ECOWAS : x, Economic Community of West African States서아프리카 제국 경제 공동체
ECR : x, electronic cash register전자식 금전 등록기
ecru : n, a, (F)베이지(색)(의), 엷은 갈색(의)
ECSC : n, European Col and Steel Community
ecstasize : vt, vi, 황홀하게 하다(해지다), 무아경에 이르게 하다(이르다)
ecstasy : n, 무아경, 황홀, 법열, 의식혼미상태
ecstatic : a, 희열에 넘친, 완전히 마음이 팔린, 황홀한, 무아경의
ECT, : x, electroconvulsive therapy 전기 충격 요법
ect- : x, (연결형)(회(부)의)뜻, (모음 앞에서는 ect-)
ectoblast : n, (생)외배엽
ectocrine : n, (생화)에토크린, 외부 대사 산물, 외분비(물)
ectoderm : n, 외배엽
ectoenzyme : n, (생화)체외 효소, 세포의 효소(체외에 분비된)
ectohormone : n, (생화)외분비(엑토)호르몬
ectomorph : n, (심)외배엽형(마르고 키가 큰 형)의 사람, 허약 체질자
ectomorphic : a, (심)외배엽형의, 허약한
ectomorphy : n, (심)외배엽형
ectomy : x, (연결형)(...절제(술))의 뜻
ectoparasite : n, (동)체외 기생충(진드기 등)
ectopic : a, (병리)정규 장소 밖의
ectoplasm : n, (원생 동물의)외질, 영매체로부터의 발산 물질, 영기
ectype : n, 재생물, 모형복사
ecu : n, Currency Unit 유럽 통화 단위, 에큐
ECU : x, electrical control unit 전력 제어 유닛
Ecua, : x, Ecuador
Ecuador : n, 에콰토르(남아메리카의 공화국)
Ecuadorian : n, a, 에콰도르 사람(의)
ecumenical : a, 전반적인, 전기독교의
ecumenical patriarch : x, 총대주교(동방 교회의)
ecumenism : n, (교과를 초월한)세계 교회주의
ecumenopolis : n, 세계도시
ECWA : x, Economic Commission for Western Asia (유엔)서아시아 경제 위원회
eczema : n, 습진
eczemaed : suf, ...을 한, ...을 가진
Ed : x, 남자 이름
ED : x, effectove dpse.(약의)유효량, environmental disruption 환경 파괴
ed : a, 규칙동사의 과거, 과거동사, ...을 가진, 을 갖춘, 에 걸린
ed, : x, edited, edition, editor, educater
Ed, B : x, Bachelor of Education
ed, cit, : x, the edition cited인용(참조)판
Ed, D, : x, Doctor of Education
Ed, M, : x, Master of Education교육학 석사
edacious : a, (문어, 익살)탐식하는, 대식의
edacity : n, (문어, 익살)왕성한 식욕, 대식
Edam cheese : n, 붉은 공보양의 치즈
edaphic : a, (식)토양의, 토양에 관련된, (기후보다는)토양의 영향을받는, 토착의
EDay : n, (영국의)EC가입 기념일(1973년 1월 1일)
EDB : x, ethylene dibromide 2취화에틸렌(살충제)
edbiz : n, (미속)교육 산업
EDC : x, European Defence Community
Edda : n, 에더(고대 아이슬란드의 신화 시집)
Eddie : n, 남자 이름
Eddington('s) limit : x, (천)에딩턴 한계 광도(일정 질량의 천체가 낼 수 있는 빛의 최대한의 밝기)
eddy : n, vi, 소용돌이
eddy current : x, (전)와상 전류(자장을 변동시킬 때, 도체 안에 생김)
edectroform : vt, ...을 전기 주조하다
edelweiss : n, 에델바이스, 왜솝다리(고산 식물)
edema : n, 부종, 수종
Eden : n, vt, vi, 에덴동산, 낙원
Eden : n, Sir Robert Anthony(1897~)영국의 정치가, 수상(1955~1957)
edentate : a, 이가 없는, (동)(앞니와 송곳니가 없는)빈치류의
EDF : x, European Development Fund
Edgar : n, 남자 이름, 에드거상
edge : 날, 가장자리, 날카로움, 거나하게 취함, 흥분해 있다, 흥을깨다, 날카롭게 하다, 비스듬히 나아가다, 천천히 움직이다
edgebone : n, =AITCHBONE
edged : a, 날이 있는, 통렬한(풍자 등), 가장자리가 있는, 거나하게 취한
edgeless : a, 날이 없는, 무딘, 가장자리(모서리)가 없는
edgeoftheseat : a, 자신도 모르게 좌석에서 몸을 일으킬 정도의 (광경 등)
edger : n, 가를 잘라내는 톱, 가장자리 마무리공
edge tool : x, 칼붙이, 날붙이
edgeways : ad, 날(가장자리, 끝)을 밖으로 대고, (두 물건이)끝과 끝을 맞대고
edging : n, 가선, 가장자리의 장식
edging shears : x, 잔디 가위
edgy : a, 날이 날카로운, (구)초조한, 신랄한, , (그림 등의)윤곽이 뚜렷한
edh, : n, 에드자(고대 영어 자모의 하나)
edibility : n, 식용에 알맞음, 먹을 수 있음
edible : a, 먹을수있는, 식료품
edict : n, 칙령, 법령, 포고
edification : n, 교화
edifice : n, 건물, 조직, 체계
edifice complex : x, 거대 건축 지향(행정계획이나 건축가의 구상 등이)
edify : vt, 교화하다, 개발하다
edifying : a, 교훈이 되는, 유익한
edile : n, =AEDILE
Edin, : x, Edinburgh
Edinburgh : n, 에딘버러(스코틀랜드의 수도)
Edison : n, 미국의발명가
edit : vt, n, 편집하다, 삭제하다, 필름편집, 사설
edit, : x, edited, edition, deitor
Edith : n, 여자 이름
editing terminal : x, (전산)편집 단말 장치(Text편집용 컴퓨터 입출력 장치)
edition : n, 호화판
editionalize : vi, (신문을)판제로 발행하다
edition binding : x, (제본)미장 제본(장식적 체제를 중요시함)
edition de luxe : x, (F)호화판
editio princeps : n, (L)초판
editiorialist : n, (신문의)논설위원
editor : n, 편집자(chief~편집 주간, 주필)
editorial : n, a, 사설, 논설, 편집자의(editorial staff 편집진)
editorial advertising : x, 기사체 광고
editorialization : n, 
editorialize : vt, ...사설로 쓰다
editorially : ad, 사설로
editorial matter : x, (광고)편집 기사면
editorship : , 편집자의 지위
editress : n, EDITOR의 여성형
edly : suf, -ED로 끝나는 단어의 부사 어미
Edm, : x, Edmond, Edmund
Edmond, : n, 남자 이름
Edna : n, 여자 이름
EDP : x, electronic data processing
EDPM : x, electronic data processing machine 전자 데이터 처리 기계
EDPS : x, electronic data processing system전자 데이터 처리 조직
EDR : x, European Depository Receipt유럽 예탁 증권
eds, : x, editors
EDTA : x, ethylenediaminetetra acetic acid(화)에틸렌디아민 사초산(혈액 응고 방지제)
educ, : x, educated, education, educational
educability : n, 교육의 가능성
educable : a, 교육할 수 있는
educate : vt, 교육하다, 양성하다, 훈련하다
educated : a, 교육받은, 교양 있는, (구)지식(경험)에 의한
educatee : n, 학생 피교육자
education : n, 교육, 훈도, 양육
educational : a, 교육상의, 교육적인, educationally, ad
educationalindustrial complex : v, 신학 운동
educational park : x, 학원도시
educational psychology : x, 교육 심리학
educational technology : x, 교육 공학
educational television : x, (미)교육 텔레비젼(프로)
educationese : n, 교육 관계자 용어(어법)
educationist : n, 교육가, 교육학자
education tax : x, =EIPLOMA TAX
educative : a, 교육적인
educator : n, 교육자(가), 교사, (동물을)길들이는 사람
educatory : a, 교육에 도움이 되는, 교육적인, 교육(상)의
educe : vt, 빼어내다, 추론하다, 추출하다
educible : a, 추출(연역)할 수 있는, 이끌어낼 수 있는
educrat : n, (미)교육 행정가, 교육 관료
educt : n, 추출물, (화)유리체
eduction : n, 끌어냄, 계발, 추단, 배출, 추출, 추출물
eduction pipe : x, (기)배기관
eduction valve : x, (기)배기판
eductive : a, 끌어내는, 추론(추단)하는
edulcorate : vt, 신맛(짠맛, 떫은 맛)을 빼다, 우려내다, 달게하다, (화)가용성 물질(혼합물)을 추출하다
Edw, : x, Edward, Edwin
Edward : n, 남자이름
Edwardian : a, n, 화려한 고상함을 뽑낸 영국 에드워드 7세 시대의 사람
Edwards Air Force Base : x, (미)에드워드 공군기지(캘리포니아주 소재, 항공 테스트 센터가 있음)
Edward the Confessor : n, 에드워드 참회왕
Edwin : n, 남자 이름
Edwina : n, 여자 이름
ee : x, (속)YE의 생략형
ee : suf, 행위자를 나타내는 명사 어미의 -or에 대하여 보통 그 작용을 (받는 사람)의 뜻
ee : suf, 지소자  미
EEC : x, European Economic Community(경)유럽 경제 공동체, 유럽 공동 시장
EEG : x, electroencephalogram(의)뇌파도
eegetic : a, 주석상의
eejay : n, =ELECTRONIC JOURNALISM
eek : int, 이크
eel : n, 뱀장어, 빈틈없는사람
eel buck : x, (영)뱀장어 잡는 통발
eelgrass : n, 거머리말
eelpot : n, (미)=EEL BUCK
eelpout : n, 괴또라지
eelspear : n, 뱀장어 작살
eelworm : n, (동)선충(류)
eely : a, 뱀장어 같은, 미끈미끈한, 요리조리 잘 빠져나가는, 붙잡을 수가 없는, 몸을 비비 꼬는
een : ad, (시)=EVEN
eenie meenie minie mie : int, 이니 미니 마이니 모, 누구로 할까(술래잡기에서 술래를 정할 때 등에 쓰는 말)
eensyweensy : a, (소아)조금, 얼마 안 되는
EENT : x, eye, ear, nose and throat
EEOC : x, (미)Equal Employment Opportunity Commission
EER : x, energy efficiency ratio(전)에너지 효율비
eer : ad, (문어)=EVER
eer : suf, (명사 어미, 때로 경멸적), (...관계자, ...취급자)의 뜻, (동사 어미)(...에 종사하다)의 뜻
eerie : a, 무시무시한, 요기있는
eerily : ad, 무시무시하게, 무서워하여, 불가사의하게
eeriness : n, 기분 나쁨, 무시무시함
EEZ : x, exclusive economic zone 전관 경제 수역
ef : n, 알파벳의 F
ef- : pref, =EX
efaculation : n, 절규, 사출, 사정
eff : vt, vi, (속)성교하다, 
eff, : x, efficiency
effable : a, (고)말(설명)할 수 있는
efface : vt, 지우다, 삭제하다, 존재를 희미하게 만들다(efface oneself 눈에 띄지 않게 하다, 표면에서 물러나다)
effacement : n, 말소, 소멸
effect : n, vt, 결과, 영향, 효과, 유효, 느낌, 인상, 빛깔의 배합, 취지, 대의, 외관, 결과를 가져오다, , 다, 목적을 이루다
effecter : n, =EFFECTOR
effectivate : vt, 실시하다
effective : a, n, 유효한, 효과적인, 인상적인, 사실상의, 실제의, 효력있는, 동원가능한, 병력, 눈에 띄는
effective aperture : x, (광)(렌즈의) 유효 구경
effective demand : x, (경)유효 수요
effective exchange rate : x, (금융)실효 환시세(환율)(국제통화기금이 당해국과 다른 주요 20개국 통화의 환시세를 복합시켜 산출하는 지수)
effectively : ad, 유효하게, 실제상
effective money (coin) : x, 경화
effectiveness : n, 유효(성), 효과적임
effective range : x, (공)유효 사거리(사정)
effector : n, 효과기(신경 자극을 바다 작용하는 말초 조직)
effectual : a, 효과적인, 유효한, 유력한
effectuate : a, 유효하게하다, 이루다, 달성하다
effectuation : n, 달성, 수행, (법률 등의)실시
Effel Tower : n, 에펠탑
effeminacy : n, 여자 같음, 나약, 유약, 우유 부단
effeminate : a, 연약한, 여자같은
effendi : n, Sir에 해당하는 터키의 경칭, 그렇게 불리우는 사람(학자, 의사, 관리등)
efferent : a, n, (생리)(신경이)원심성인, (혈관이)수출(도출)성인, 수출관, 원심성 신경, 방죽, 호수 등에서 나오는 물줄기
effervesce : vi, (탄산수 등이)부글부글 거품이 일다, (가스 등이)거품이 되어 나오다, (사람이)흥분하다
effervesce : vi, 거품이일다, 비등하다, 들뜨다, 흥분하다
effervescent : a, 비등성의, 거품이 이는, 흥분한, 활기 있는
effete : a, 노쇠한, 생산력을 잃은, 무력해진
efficacious : a, 유효한
efficacy : n, 효력
efficiency : n, 능률, 능력, 효력, 효율
efficiency apartment : x, 간이 아파트(부엌과 거실 겸 침실로 된)
efficiency engineer : x, 경영 능률 전문화
efficient : a, 효과있는, 유능한, 능률적인
efficient market hypothesis : x, (증권)효율적 시장 가설(새로운 정보의 주가에의 반응은 동시적이란 가설)
Effie : n, 여자 이름, 에피상(미국 마케팅 협회가 매년 선정하는 최우수 광고상)
effigial : a, 초상(인형)의, 초상(인형)을 닮은
effigy : n, 상, 초상(in effigy아무의 인형을 만들어서 화형에 청하다(악인 따위에 대한 저주로))
efflor, : x, efflorescent
effloresce : vi, n, 꽃피다, 번영하다, 풍화하다, 표면에 꽃과 같은 염분이 뿜어나오다
efflorescence : n, 개화기, 풍화, 발진
efflorescent : a, 꽃이 핀, (화)풍화성의
effluence : n, (광선, 전기, 액체 등의)내뿜음, 발산, 방출, 흘러나옴, 유출(방출)
effluent : a, n, 유출하는, 유출물, 유출, 방출
effluvial : a, 악취의
effluvium : n, 발산기, 독기, 악취
efflux : n, 유출, 발산, 시일의 경과, 만기
effort : n, 노력, 수고, 노력의 성과, 역작, 작력, 주로 모금 등의 운동
effortful : a, 노력이 필요한, 억지로 꾸민, 부자연스런, effortfully, ad
effortless : a, 노력하지 않는, 힘들지 않는, 쉬운, effortlessly, ad, effortlessness, n
effrontery : n, 뻔뻔스러움
effulgece : n, 광휘
effulgent : a, 빛나는
effuse : vt, vi, 유출하다, 토로하다
effusion : n, 액체, 향기 따위의 유출, 발산, 감정의 토로, 발로
effusive : n, 넘치는, 넘칠 듯한, 감정을 거창하게 나타내는
eft : n, 영원
EFT(S) : x, electronic funds transfer (system) 전자식 자금 이동(시스템)
EFTA : x, European Free Trade Association 유럽 자유 무역 연합
eftsoon : ad, 다시, 얼마안있어, 가끔
Eg, : x, Egypt, Egyptology
egad : int, (고, 익살)저런, 어머나, 정말, 뭐라고
egalit'e : n, (F)평등
egalitarian : n, a, 평등주의자, 평등주의의
Egbert : n, 남자 이름, 에그버트
egest : vt, (생리)...을(체내로 부터)배설(배출)하다
egg : n, 알, 달걀=EGG CELL, (속)투하 폭탄, 놈, 녀석
egg : vt, 격려하다, 부추기다(urge)
egg alyer : x, 폭격기
eggandspoon race : n, 스푼레이스
egg apple : x, =EGGPLANT
eggar : n, 솔나방
eggbeater : n, 달걀 교반기, 헬리곱터
eggbound : a, (새, 물고기 등이)알을 몸에서 뗄 수 없는 알에 얽매인
egg cell : x, 난세포, 난자
egg container : x, (플라스틱제 등의)달걀 용기, 달걀 판(대소를 불문한 달걀 용기의 총칭)
egg cozy : x, 삶은 달걀 덮개(보온용)
eggcrate : n, 칸막이 달걀 포장 상자, 잘게 구획된 미늘살(전등빛 반사용)
egg cream : x, (미)우유, 향료, 시럽, 소다를 섞은 음료
eggcup : n, 삶은 달걀 컵
egg custard : x, 달걀, 설탕, 우유로 만든 과자
egg dance : x, 달걀 춤(흩어 놓은 달걀 사이에서 눈을 가리고 추는 춤), 매우 어려운 일
egger : x, =EGGAR
egg flip : x, =EGGNOG
egg foo yong : x, (미)중화요리식 오믈렛
egghead : n, 인텔리, 지성인, 대머리
eggheaded : a, (구)EGGHEAD같은, eggheadedness, n
eggnog : n, 에그노그(달걀, 우유, 설탕에 포도주, 브랜디를 탄 음료)
egg plant : n, 가지, 열매
egg roll : x, (요리)(중화요리의)야채, 고기의 달걀말이
egg rolling : x, 부활절에 Easter eggs를 굴리는 놀리(깨지 않고 굴리는 자가 이김)
egg separator : x, 난황 분리기
eggshaped : n, 알(달걀)껍질
eggshell : n, a, 달걀 껍질, 깨지기 쉬운 것, 얇고 부서지기 쉬운
egg slice : x, 오믈렛을 뜨거나 뒤집는 기구
eggs over light : x, (요리)계란 프라이의 한가지(알의 노른자위를 깨지 않고 앞뒤로 뒤집어 익힌 프라이)
egg spoon : x, 삶은 달걀을 먹는 작은 숟가락
eggs sunnyside up : x, (요리)계란 프라이의 한가지(알을 뒤집지 않고, 노른자위가 반숙이 되도록 익힌 프라이)
egg stand : x, 달걀 스탠드
eggsucker : n, (속)아첨해서 성공하려는 사람, 간살쟁이, 아첨꾼
egg timer : x, 달걀 삶는 시간을 재는 약 3분 정도의(모래)시계
egg tooth : x, 난치(새, 파충류의 새끼가 알을 깨고 나올 때에 쓰는 부리의 끝)
egg transfer : x, (의)난자 이식(수술)
egg transfer baby : x, (의)수정란 이식아
egg whisk : x, =EGGBEATER
egg white : x, 요리용의 달걀 흰자위
egis : n, =AEGIS
eglantine : n, 들장미
ego : n, 자아, 자부심
egocentric : a, 자기중심의
ego ideal : x, 자아 이상
egoism : n, 이기주의, 자부
egoist : n, (윤)이기주의자, 자기 본위의 사람, 제멋대로 하는 사람, 자부심이 강한 사람
egoistic : a, 이기주의의, 자기 본위의, 제멋대로의 아욕이 강한, egoistically, ad
egoistic hedonism : x, (윤)개인적 쾌락설(행위 결정의 동기는 주관적 쾌락이라는 설)
egoistism : n, 자기중심벽(회와, 문장중에 I my me연발하는 버릇)
egomania : n, 이상자기중심벽, 병적자부심
egomaniac : n, 병적(극단적)으로 자기 중심적인, 사람, 극단적으로 자존심이 강한 사람
egosphere : n, 자아 영역
egostate : n, (심)자아 상태
egotism : n, 자기 중심벽, 자만, 자부, 이기주의, 자기본위
egotist : n, 자기 중심 주의자, 자존가
egotistic : a, 자기 중심(본위)의, 독선적인, 이기적인
egotize : vi, 제자랑하다, 자기 일만 말하다
ego trip : x, (구)이기적(자기 본위적)행위
egotrip : vi, 제멋대로(자기 중심적으로)행동하다
egregious : a, 터무니없는, 지독한, 엉터리없는
egress : n, 외출, 밖으로 나감, 출구, 배출구
egression : n, 외출, (천)=EMERSION
egret : n, 큰해오라기
Egypt : n, 이집트
Egypt, : x, Egyptian
Egyptian : a, n, 이집트의, 이집트사람
Egyptian cotton : x, (식)이집트목화
Egyptianization : n, 이집트화
Egyptianize : vt, 이집트화하다, 이집트의 국유로 하다
Egyptology : n, 고대이집트학
eh : int, 뭐?, 엣?, 그렇지요?
EHP : x, effective horse power 유효 마력, electrical horse power 전기 마력
EHV : x, extra hogh voltage (전)초고압
EIB(W) : x, Export Import Bank(of Washington)(워싱턴)수출입 은행
eider : n, 아이더 오리
eiderdown : 솜털(아이더 오리의), 
eidetic : a, n, 직관적인, 직관상이 보이는 사람
eidograph : n, 신축 축도기(원화를 임의로 확대, 축소할 수 있음)
eidolon : n, 유령, 허깨비, 환영, 이상(상), 이상화된 인물
eigen- : x, (G)(연결형)(고유의, 독특한)의 뜻
eigenvalue : n, 고유치
eight : n, a, 8, 에이트
eight ball : x, 8이라고 쓴 검은 공, 무지향식구형 마이크, 바보, 어려운 입장에서
eight bit computer : x, (전산)8비트 컴퓨터
eighteen : a, 18(개, 명)의, 18세의
eighteenth : n, a, 18분의1
eighteenwheeler : n, (미속)트레일러 트럭
eighteight : n, (건의 총수가 88개인 데서)(미속)피아노
eightfold : a, ad, 8배의
eightfold way : x, (물)팔도설(소입자 분류법의 하나)
eightfour : a, (미교육)8-4제의(초등 교육 8년, 중등 교육 4년의)
eighth : n, a, 제8의, 8분의 1의
eighth note : x, 8분음표
eighthour : a, 8시간제의
eightieth : a, n, 제80의, 80분의1
eightpence : n, (영국의)8펜스
eightpenny : a, 8펜스의
eight rest : x, (악)8분 쉼표
eights : n, (미속)통화 끝
eightscore : n, 160
eightsome : n, 8사람이 추는 춤, 그 춤을 추는 8인조
eighttrack : n, 8트랙 녹음 테이프
eighty : n, a, 80, 80년대
eightyfold : a, ad, 80배의(로)
eightysix : vt, (미속)(식당, 바 등에서 손님에게)식사, 음료의 제공을 거절하다, 서비스하지 않다, (사람을)배척하다, 무시하다
eikon : n, =ICON
Eileen : n, 여자 이름
Einstein : n, Albert(1879, 1955)상대성 이론을 창설한 독일 태생의 미국 물리학자
Einstein equation : x, (물)아인슈타인 방정식(질량과 에너지와의 방정식)
Einsteinian : a, 아인슈타인(류)의, 상대성 원리의
Einstein theory : x, 아인슐타인의 상대성 원리
einstenium : n, 아인슈타이늄(방사성 원소, 기호 Es)
Eire : n, 에이레(Republic ofIRELANK 딴이름, 구칭)
eirenic : a, 평화를 촉진하는(이바지하는), 중재의, 협조적인
eirenicon : n, 평화(중재)제의(특히 종교상 분쟁에 대한)
eisegesis : n, (특히 성서 원문에 관한)자기 해석(자신의 사상을 개입시킨 해석 등)
Eisenhower : n, Dwight(1890, 1969)미국 제 34대 대통령(1952, 61)에칭 Ike)
eisteddfod : n, 영국 Wales의 예술제
either : a, ad, 어느것인가, 어느것이든지...이든가 또는 ...이든가...도 또한
eitheror : a, 양자택일의
eithteenmo : n, 18절(판)
ejaculate : vt, vi, 갑자기소리지르다, 액체를 사출하다
ejaculator : n, 갑자기 외치는 사람, (해)사출근, 사정근
ejaculatorium : n, (정자 은행의)정자 채취실, 사정실
ejaculatory : a, 
eject : vt, 분출하다, 토해내다, 쫓아내다
ejecta : n, 화산 등의 분출물
ejection : n, 방출, 분출, 배출, 방출물, (법)(토지, 가옥에서의)방축, 퇴거
ejection capsule : x, 로켓의 방출 캡슐
ejection seat : x, 긴급 탈출용 사출 좌석
ejective : a, 방출하는, 방사하는, 몰아내는, (음성)방출음의
ejectment : n, 방출, 추방, 방축, 몰아냄, (법)부동산 점유 회복 소송
ejector : n, eject하는 사람, 배출기관
ejector seat : x, =EJECTION SEAT
eka- : x, (연결형)(화)(미지의 원소명에 사용하여)(주기율표의 동족난에서...의 밑에 와야 할 원소)의 뜻
eke : vt, ad, 보충하다, 꾸려나가다...도 또한, 그리고 또
EKG : x, Electrokardiogramme(G=electrocardiogram)
ekistics : n, 생활도시계획학
Ekman layer : x, (해양)에크만(해류)층(해양의 흐르는 방향이 풍향과 90도를 이루는 층)
el : n, L자, 고가 철도
el, : x, elected, elevation
elaborate : a, vt, 공들인, 면밀한, 힘들인, 애써서 만들어내다, 퇴고하다, 정성들여, 면밀하게
elaborately : ad, 정성들여, 면밀하게
elaboration : n, 면밀한 마무리, 퇴고, 역작
elaborative : a, 공들인
elaborator : n, 고심하여(정성들여)만드는 사람, (문장을)퇴고하는 사람
elaeometer : n, 지방 비중계, 올리브유계
Elaine : n, 여자 이름
EL AL(Israel Airlines) : x, 엘알이스라엘 항공(이스라엘 항공 회사)
Elam : n, 엘람(페르시아만 북쪽의 지역명, 그곳에 있었던 고대 왕국)
Elamite : a, n, 엘람의, 엘람사람(말)의, 엘람 사람, 엘람 말
elan : n, 열의, 예기, 약진
eland : n, 아프리카 큰영양
elan vital : n, (F)(철)생명의 비약, 생의 약동
elapid : a, n, (동)코브라과의(독사)
elapse : vi, 경과하다
elapsed time : x, 경과 시간(타임)(보트나 자동차의 일정 코스의 주행 시간)
elasmobranch : n, a, (어)판새류(의), 연골어류(의)(상어, 가오리 등)
elastic : a, n, 탄력있는, 낭창한, 경쾌한, 밝은, 융통성있는, 고무줄
elastic band : x, (영)고무 밴드
elastic clause : x, (미헌법)신축(탄력)조항(의회의 잠재적 권한을 규정하는 것)
elasticity : n, 탄력, 신축성, (물)탄성, 불행에서 일어서는 힘, 융통성, 순응성, 쾌활함
elasticize : vt, (고무줄 등을 넣어서)...에 탄성(신축성)을 갖게 하다, elasticized, a
elastic limit : x, (물)탄성 한계
elastic modulus : x, (물)탄성률
elastic sides : x, (옛날 고무 장화의)양쪽의(단추나 끈 대신에 단)고무 천, 고무 장화
elastin : n, 엘라스틴, 탄력소(단백질의 일종)
elastohydrodynamics : n, 유체탄성 역학, 가압액체 탄성학
elastomer : n, 탄성물질
elastometer : n, 탄력계
Elastoplast : n, (영)구급용 반창고의 일종(상표명)
elate : vt, 기운을북돋우다, 의기양양하게만들다
elated : a, 의기 양양한(in high spirits)심명이 난
elater : n, (식)(포자를 튀겨 내는)탄사, 방아벌레
elation : n, 의기 양양
E layer : x, E층(지상 80, 150 킬로의 하층 전리층)
Elba : n, 엘바(섬)(이탈리아의 작은 섬)
Elbe : n, 엘베(강)(북해로 흘러드는 독일의 강)
Elbert : n, 남자 이름
Elberta : n, 여자 이름
elbow : n, vt, vi, 팔꿈치, L자모양의 굴곡, 기역자 관, 의복이 팔꿈치가 뚫어져, 가난하여, 몰두하여, 분주하여, 팔꿈치로 찌르다
elbowbender : n, (미구)술을 마시는 사람, 술꾼, (미속)사교적인(쾌활한)사람
elbow bending : x, (구)음주
elbowbending : a, (구)과음하는
elbowboard : n, (팔꿈치를 괼 수 있는)창문 턱
elbow chair : n, 팔걸이의자
elbow grease : , 힘든육체노동
elbowroom : n, 팔꿈치를 자유롭게 놀릴 수 있는 여유, 활동의 여지
el cheapo : a, (미속)하찮은, 값싼
eld : n, (영방)연령, 나이, (고, 시)노년, 옛날
eld, : x, eldest
elder : a, n, 손위의, 연장의, 고참의, 이전의(elder brother 형, 누이), 연장자, 고참, 장로, 원로
elder : n, 양딱총나무
elderberry : n, 양딱총나무의 열매
elderberry wine : x, ELDERBERRY열매로 담근 술
elder brother : x, (영)수로 안내 협회의 간부 회원
eldercare : n, (미)낮은 요금의 노인 의료 계획, 노인 예방 진료 계획(의료 보험 제도의 보완책)
elder hand : x, =ELDEST HAND
elderly : a, 나이 지긋한, 중년의, 초로의
elderly dependency ratio : x, 노령자(피)부양률
eldership : n, 연장의 신분, (장로 교회의)장로식
elder statesman : x, (정계의)원로, 장로, (조직, 집단의)유력자, 중진
eldest : a, 가장나이많은
eldest hand : x, (카드놀이)(패 도르는 사람의 왼쪽에 있는)카드를 첫번째로 받는 사람
EL Dorado : n, 황금의 나라, 보물산
Eldred : n, 남자 이름
eldritch : a, (스코)무시무시한, 소름이 끼치는, 섬뜩한
Eleanor : n, 여자 이름
Eleatic : n, (철)엘레아 학파의(사람)
elec, : x, electric(al), electrician, electricity, electuary
elecampane : n, (식)목향(엉거시과의 식물), 목향 과자(목향나무에서 뽑은 향료로 만듦)
elecpowered : a, 전동의
elect : vt, a, 뽑다, 선거하다, 뽑힌, 당선된(bride elect 약혼자(fiancee), president elect (아직 취임하지 않은)당선 대통령)
electable : a, 선출 될 수 있는, 선출(선택)될 만한
electee : n, 선출(선택)된 사람
electic blue : x, 강청색(밝고 금속적인(차가운)느낌의 청색)
election : n, 선택, 선정, 선거, 선임
election administration committee : x, 선거 관리 위원회
election campaign : x, 선거 운동
Election Day : , 정부통령 선거일(11월 첫째 월요일 다음의 화요일), 선거일
election district : x, 선거구
electioneerer : n, =ELECTIONEER
electioneering : n, a, 선거 운동, 선거 운동의
election law violation : x, 선거법 위반
election returns : x, 선거 개표 보고(서)
elective : a, n, 선거하는, 선거에 의한, 선임의(opp, appointive), (하과가)선택의
elective affinity : x, (화)(선택)친화력
elector : n, 선거인, 유권자, 정부 통령 선거 위원, 선제후
electoral : a, 선거의, 선제후의
electoral college : x, 정부통령선거위원회
electoral roll(register) : x, 선거인 명부
electoral vote : x, 각 주에서 선출된 대통령 선거인단에 의한정부통렬 선거
electorate : n, 유권자, 선거민, 선제후령
electr, : x, electric(al), electrician, electricity
electr- : x, (연결형)(전기의, 전기에 의한)의 뜻(모음 앞에서는 electr-)
Electra : n, Agamemnon과 Clytemnestra의 딸(동생 Orestes의 도움으로 부정한 어머니와 그 정부를 죽였음)
Electra complex : x, 엘렉트라 콤플렉스
electress : n, 여성유권자
electric : a, 전기의, 전기 장치의, 두근거리는
electrical : a, 전기의, 강렬한
electrical engineer : x, 전기(공학)기사, 전기 기술자
electrical engineering : x, 전기 공학
electrically : ad, 전기(작용으)로, 전기학상(으로), 전격적으로
electrical precipitator : x, 전기 집진 장치
electrical scanning : x, (전자)전기적 주사
electrical storm : x, =ELECTRIC STORM
electrical transcription : x, 녹음 방송요(레코드, 테이프), 녹음
electric blanket : x, 전기 담요
electric car : x, 전기 자동차
electric chair : x, 사형용 전기 의자, 전기 사형
electric charge : x, 전화
electric circuit : x, 전기 회로
electric current : x, 전류
electric eel : x, 전기뱀장어
electric eye : x, 광전지, 광전관
electric eye camers : x, 자동 노출 카메라
electric field : x, 전계
electric fire : x, (영)전기 백열 히터
electric furnace : x, 전기로
electric guitar : x, 전기 기타
electric hare : x, 전동식 모형 토끼(개 경주에서 사용)
electric heater : x, 전기 스토브, 전열기
electrician : n, 전기기술자
electricity : n, 전기, 전류, 극도의
electric light : x, 전광, 전등
electric needle : x, 전기침
electric news tape : x, 전광 뉴스
electric organ : x, 전기 오르간, (전기 뱀장어 따위의)발전기
electric potential : x, 전위
electric power : x, 전력
electric ray : x, 시끈가오리
electric rocket : x, (로켓)전기 추진 로켓
electric shaver : x, 전기 면도기
electric shock : x, 감전, 전력
electric shock therapy : x, (정의)전기 쇼크요법
electric steel : x, 전로강
electric storm : x, 뇌우
electric teeth : x, (미속)경찰, 자동차 속도 측정 장치
electric torch : x, 회중전등
electric towel : x, 전기 온풍 건조기(화장실 등에서 젖은 손, 얼굴을 말리기 위한 것)
electric wave : x, 전파
electric wire : x, 전선
electrification : n, 
electrify : vt, 전기를 통하다, 감전 시키다, 전화하다, 놀라게 하다, 감동시키다
electrization : n, =ELECTRIFICATION
electrize : vt, =ELECTRIFY
electro : n, =electrotype, eelectroplate
electro- : x, (연결형), ELECTR-
electroacoustics : n, 전기 음향학
electroacupuncture : n, 전기 침술(용법), 전기 침
electroanalysis : n, 전기분해
electrobath : n, 전조, 전해조, 전액(전기 도금용)
electrocardiogram : n, 심전도
electrocardiograph : n, 심전계
electrocardiography : n, (의)심전도 기록(검사)(법)
electrochemical : a, 전기 화학의, electrochemically, ad
electrochemist : n, 전기 화학자
electrochemistry : n, 전기화학
electrochronograph : n, 전기 기록 시계
electroconvulsive : a, (정의)전기 경련의(에 관한, 을 수반하는)
electroconvulsive therapy : x, =ELECTROSHOCK THERAPY
electrocorticogram : n, 뇌파도
electrocorticography : n, (의)뇌파 측정법(대뇌 피질에 직접 전극을 접촉시키는)
electrocute : vt, 전기사형에 처하다
electrocution : n, 감전사, 전기 상형
electrode : n, 전극
electrodelic : a, 전광에 의해 환각적인 효과를 내는
electrodeposit : vt, n, (화)전착시키다, 전착물
electrodeposition : n, (화)전착, 전해 석출
electrodynamic : a, 전기 역학의
electrodynamics : n, 전기 역학
electrodynamometer : n, 전기동력계
electroencephalogram : n, 뇌파, 뇌파기록장치
electroencephalograph : n, (의)뇌파 전위 기록 장치
electroencephalography : n, (의)뇌파 전위 기록술
electrofishing : n, (수산)전류 어법(직류 전원의 집어 효과를 이용한 것)
electrogasdynamics : n, 전기 유체 역학
electrogenesis : n, 전기 발생(생체의 세포 조직에서의 발전 활동)
electrogram : n, (의)전기 기록도(곡선도)(신체 조직 속에 전극을 넣어 작성하는 활동 전위도)
electrograph : n, 전위기록장치, 전위판, 조각기, 사진전송기
electrographic : a, 
electrographically : ad, 
electrography : n, 전위 기록(전기판 조각, 사진 전송)술
electrohydraulics : n, 전기 수력학
electrojet : n, 고층전류(상층 대기의 이온의 흐름)
electrokinetic : a, (동)전기적인, 동전기상의
electrokinetics : n, 동전기학
electrokymograph : n, (의)(심장)동태기록기(촬영 장치)
electrolier : n, 꽃전등
electroluminescence : n, 전자발광
electrolysis : n, 전해
electrolyte : n, 전해액, 전해질
electrolytic : a, 전해(질)의
electrolyzation : n, (화)전해, 전기 분해, (의)전기 분해법 치료
electrolyzer : n, (물, 화)전해조
electromagnet : n, 전자석
electromagnetic : a, 전자기의
electromagnetic induction : x, (전)전자 유도
electromagnetic interference : x, (전)전자 방해(다른 기기를 방해하는 전자 제품의 잡음)
electromagnetic pulse : x, (전)전자 펄스(핵폭발에 의해 생긴 고농도의 전자 방사)
electromagnetics : n, 전자기학
electromagnetism : n, 전자기학
electrometallurgy : n, 전기 야금학
electrometer : n, 전위계
electromobile : n, 전기 자동차(석유 절약, 무공해의 자동차)
electromoter : n, 발전기
electromotive : n, 전동의, 전기기관차
electromotive force : x, 동전력
electromyogram : n, 근전도
electromyography : n, (의)근전도 검사(기록)법
electron : n, 전자
electron affinity : n, (물)전자 친화력
electronarcosis : n, (의)전기 마취(요)법
electron beam : x, (물)전자 빔(전계, 자계에서 한 방향으로 모아져 흐르는 전자의 흐름)
electron beam melting : x, (금속)전자빔 용해법
electron bomb : x, 일렉트론 소이탄
electronegative : a, 음전기의, 음성의
electron gas : x, (물)전자 기체(가스)
electron gun : , 전자총(브라운관의 잔자류 집중관)
electronic : n, 전자의
electronic art : x, 전자 예술(섬광, 움직이는 라이트 등을 사용한 예술 양식)
electronic banking : x, 전자화된 은행 업무
electronic brain : x, 전자 두뇌(전자 계산기 따위)
electronic caculator : x, 전자 계산기
electronic churchman : x, 텔레비젼, 라디오 등을 이용하여 일반 대중에게 설교하는 성직자
Electronic Computer Originated Mail : x, (미)컴퓨터 발신형 전자 우편
electronic cottage : x, 전자 기기를 완비한 주택
electronic countermeasure : x, (군)(적미사일의)유도 방향 전환 전자 장치)
electronic data processing : x, 전자 정보 처리
electronic engineering : x, 전잘 공학
electronic file : x, 전자 파일(대량의 문서, 자료 등을 전기 신호의 형태로 보관하는 장치)
electronic flash : x, 스트로브(방광 장치)
electronic funds transfer : x, 전자식 자금 이체(이행 결제)
electronic game : x, 전자 게임, 비디오 게임
electronic journalism : x, (특히 미)텔레비젼 보도, (집합적)방송 기자
electronic learning : x, 전자 학습(컴퓨터를 사용한 학습)
electronic mail : x, 전자 우편
electronic media : x, 전자 미디어(전자, 통신 기술을 응용한 정보 전달 매체의 총칭)
electronic meeting : x, 전자 회의
electronic music : x, 전자 음악
electronic office : x, 전자식 사무실(전자 기기에 의해 사무 처리가 자동화된)
electronic organ : x, 전자 오르간
electronic publishing : x, 전자 출판
electronics : n, 전자공학
electronic shopping : x, =TELESHOPPING
electronic smog : x, 전파 스모그(각종 전파, 전기 기기로부터 발생한 대기 중의 전자파)
electronic surveillance : x, 전자 감시(정보 수집)
electronic transfer : x, 전자식 금전 출납
electronic video recorder : x, 전자식 녹화기
electronic warfare : x, 전자전
Electronic Yellow Pages : x, 전자식 직업 전화부(특정 직업별 전화부의 정보를 온라인으로 제공하는 등)
electroniture : n, 전자 기기 사용에 알맞도록 제작된 사무용 집기
electron lens : x, 전자 렌즈
electron microseope : x, 전자 현미경
electronograph : x, 전자 사진
electronography : n, (인)전자 전사법(전자적으로 문자, 화상을 종이에 전사하는), (광)전자 현미경 상
electron optics : x, 전자 공학
electron spin resonance : x, (물)전자 스핀 공명
electron telescope : x, 전자 망원경
electron tube : x, 전자관(X선관 따위)
electron volt : x, 전자 볼트(이온, 소립자 에너지 단위, 생략 EV)
electrooculogram : n, (안과)전기 안구도, 안전도
electrooptic : a, 전기 광학의
electrooptic device : x, (전)전기 광학 소자
electrooptic effect : x, (전)전기 광학 효과
electrooptics : n, 전기 광학
electropaint : n, vt, vi, 전해 도장에 쓰이는 도료, (금속에)전해 도장하다
electropainting : n, 전해(전기)도장(금속 표면에 페인트의 엷은 층을 전해시켜 침적시킴)
electrophone : n, 전기악기, 전자보청기
electrophonic : a, 전기 발성의
electrophorese : vt, (물, 화)...에 전기 영동을 시키다, (하전 물질의 분자를)전기 영동으로 분리하다
electrophoresis : n, 전기이동, 전기영동법
electrophorus : n, 전기쟁반, 기전반
electrophotograph : n, (의)전기 진단 사진
electrophotography : n, 전자 사진술
electrophrenic respiration : x, (의)횡격막 신경 전기(자극)호흡(법)(인공 호흡의 일종)
electroplate : vt, n, 전기도금제품...에 전기도금을 하다
electroplating : n, 전기 도금(법), 전도
electroplexy : n, (영)=ELECTROSHOCK THERAPY
electropop : n, 전자팝(전자음을 사용한 팝뮤직)
electropositive : a, 양전기의, 양성의
electropult : n, 전기캐더펄트(짧은 활주로에서의 발진 장치)
electroretinograph : n, (안과)망막 전기 측정기
electroscope : n, 검전기
electroscopic : a, 검전기의
electrosensitive : a, 전기 감광성의
electrosensitivity : n, (생)(동물의)전기 지각 능력, (생체 일반의)전기 감응력, 전기 반응
electroshock : n, 정신병의 전격 요법
electroshock therapy : x, (정의)전기 쇼크(충격)요법
electrosleep : n, (의)전기 수면(뇌에 저전압 전류를 흘려 잠들게 함)
electrostatic : a, (전)정전(기)의, 정전기학의
electrostatic precipitator : x, 전기집진장치(연기, 먼지, 기름 등에 부유하는 불순물을 채집함)
electrostatics : n, 정전학
electrotechnics : n, 전기공학
electrotechnology : n, 전기 공학, 전자 공학
electrotelyze : vt, 전해하다
electrotherapeutic : a, (의)전기 요법의
electrotherapeutics : n, (의)전기 요법
electrotherapist : n, (의)전기 요법 의사
electrotherapy : n, 전기요법
electrothermal : a, 전열의, 전기와 열의
electrotome : n, 자동 차단기
electrotonus : n, (생리)전기 긴장(전류를 통하였을 때 일어나는 신경, 근육의 생리적 긴장)
electrotype : vt, 전기관으로 만들다, 올 뜨다
electrotyper : n, 전기 제판공
electrotypy : n, 전기판 제작법, 전기 제판술
electrovalence : n, 이온원자가, 전자이동
electrum : n, 호박금(금, 은의 합금, 고대 그리스 화페로 사용 했음)
electuary : n, (시럽, 꿀과 함께 개어 만든)연약, 핥아먹는 약
eledoisin : n, (약)엘레도이신(낙지의 타액선에서 채취한 혈관 확장, 강압제)
eledtioneer : vi, n, 선거 운동을 하다, 선거 운동원
eleemosynary : a, n, 베푸는, 자선의, 자선을 받는
elegance : n, 우미, 우아, 단아, 고상함, 과학적인 정밀성, 우아한 말씨
elegant : a, 우아한, 품위있는, 훌륭한, 근사한
elegantly : ad, 
elegiac : a, n, 만가의, 애가조의, 슬픈, 만가형식의 시가
elegiac couplet : x, 애가조 연구
elegiac stanza : x, (시학)애가조의 연
elegist : n, 애가(만가)시인
elegize : vt, vi, 애가를짓다, 애가로 애도하다
elegy : n, 만가, 애가, 엘레지
elem, : x, element(s), elementary
element : n, 요소, 성분, 분자, 원소, 자연력, 풍우, 고유의 환경, 소부대, 기본, 초보, 빵과 포도주, (strife of the elements 폭풍우)
element 104 : x, (화)104번 원소(12번째의 초우란 원소, 인공 방사성 원소)
element 105 : x, (화)105번 원소(인공 원소의 하나)
element 106 : x, (화)106번 원소(초우란 원소의 14번째의 것, 인공 방사성 원소)
element 107 : x, (화)107번 원소(주기표 번호 107의 초우란 방사성 원소의 15번째의 것, 인공 방사성 원소)
element 126 : x, (화)126번 원소(자연 속에 존재한다고 믿어지는 미발견의 무거운 원소)
elemental : a, 원소의, 본질적인, 원리의, 사대의, 근원적인
elemental area : x, 화소(텔레비젼 화면의 직사각형 구역)
elemental diet : x, (의)기본식, 성분 영양
elementarily : ad, 
elementary : a, 기본의, 초보의, 본질의, 원소의
elementary particles : x, 소립자
elementary school : x, 국민 학교
elemi : n, 엘레미(열대산의 방향수지), 고약, 니스 등에 쓰임
Elena : n, 여자 이름
elenchus : n, (논)반대 논증, 논파, (일반적으로)논란, 논박
elenctic : a, 논박의, (논)반대 논증적인, 궤변의
elephant : n, 코끼리(미국 만화에서는 공와당을 표시함), 쌍을 보다, 구경하다
elephant'sear : n, =BEGONIA, =TARO
elephanta : n, 인도의 맬라바르 연안에서 부는 강풍
elephant bird : x, (조)융조
elephant ears : x, (구)미사일 겉면의 두꺼운 금속판(공중 마찰로 인한 열의 분산을 도모)
elephantiasis : n, 상피병
elephantine : a, 코끼리의, 거대한, 볼품없는, 느린
elephant seal : x, (동)해상, 해마
Eleusinian : a, n, ELEUSIS시의 (시민)
Eleusinian mysteries : x, 엘레우시스 제전
Eleusis : n, 엘레우시스(고대 그리스 Attica국의 도시)
elev, : x, elevation
elevate : vt, 올리다, 승진시키다, 기운을 북돋아주다, 향상시키다, 앙양하다, 기분을 들뜨게하다
elevated : n, a, 높은, 고상한, 쾌활한, 거나한
elevated railroad (railway) : x, (미)고가 철도
elevation : n, 올리는일, 승진, 향상, 입면, 기품, 고상
elevation : n, 공중의 순간 정지
elevator : n, 승강기, 곡물창고
elevator shaft : x, 승강기 통로
elevator shoe : x, 키가 크게 보이려고 두꺼운 안창을 깐 구두
elevatory : a, 올리는, 높이는
eleven : n, a, 열하나, 축구팀, 열한사람의
elevenfold : a, ad, 11배의(로)
eleven o'clock : x, (영방)(11시경에 먹는)간단한 식사
elevenplus : n, 진학자격인정시험
elevenses : n, 가벼운점심
eleventh : a, n, 제11의, 제 11
eleventh hour : x, 마지막 기회, 최후의 순간, 막판, 마감이 임박한 시간
elevon : n, (공)엘리본(승강타와 보조 날개의 역할을 하는)
elf : n, 꼬마요정, 난쟁이 꼬마, 개구장이
ELF : x, extremely low frdquency 초저주파
ELF : x, Eritrean Liberation Front
elf arrow bolt : n, 돌화살촉
elf child : x, 바꿔친 아이
elf fire : x, 도깨비 불
elfin : n, a, 꼬마요정
elfish : a, 꼬마 요정 같은, 장난 잘하는, elfishly, ad, elfishness, n
elfland : n, 요정의 나라
elflock : n, 엉킨머리
Elgin marbles : x, 대영박물관에 있는 고대 그리스의 대리석 조각
El Giza : n, =GIZA
El Greco : n, (1541, 1614)그레코(스페인의 화가, 조각가)
elhi : a, 국민 학교에서 고등 학교까지의, 초, 중고의
Elia : n, Charles Lamb의 필명
Elias : n, 남자 이름, =ELIJAH
elicit : vt, 끌어내다
elicitation : n, 이끌어 냄, 유도해 냄
elide : vt, 모음, 음절을 생략하다
eligibility : n, 적임, 적격
eligible : a, n, 택해도 좋은, 뽑힐 자격 있는, 적임의, 적격자, 바람직한
Elihu : n, 남자 이름, (성)엘리후(고민하는 욥에게 하느님의 거룩하심을 깨우치려 하던 젊은이)
Elijah : n, 엘리야(히브의 예언자)
eliminable : a, 제거할수있는
eliminant : n, (수)소거식
eliminate : vt, 제거하다, 삭제하다, 생략하다, 배설하다
elimination : n, 제거, 배출, 예선, 소거
eliminative : a, 제거할 수 있는, (수)소거할 수 있는, (생리)배출(배설)(작용)의
eliminator : n, 제거하는 물건, 일리미네이터(교류에서 직류를 얻는 장치)
eliminatory : a, 제거(삭제, 배출, 배설)의
Elinor : n, 여자 이름
ELINT : n, 전자 정보
Eliot : n, George(1819, 80)(Nary Ann Evans의 필명)영국의 여류 소설가, Thomas Stearns(1888, 1965)영국의 시인, 비평가
Elisabeth : n, =ELIZABETH
Elise : n, 여자 이름
Elisha : n, 옐리샤(히브리의 예언자, Elijah의 후계자)
elision : n, 모음생략
elite : n, 엘리트(the elite of society 명사들)
Elite Guard : x, (나치스의)친위대, 정예 부대
elitism : n, 엘리트주의, 엘리트에 의한 지배, 엘리트 의식(자존심)
elitist : n, a, 엘리트주의자, 엘리트(자처자), 엘리트주의의
elixir : n, 연금술의 영액, 불로 장수의 영약, 만병 통치약
Eliz, : x, Elizabeth, Elizabethan
Eliza : n, 여자 이름
Elizabeth : n, 엘리자베스1세
Elizabethan : a, n, 엘리자베스1세시대의
elizabethan sonnet : , 엘리자베스조풍의 소네트(Shakespearian sonnet라고도 함, 압운 형식은 abab cacd efef gg)
elk : n, 큰사슴
elkhound : n, (노르웨이 원산의)사슴 사냥개
ell : n, 엘(45인치에 상당하는 옛날의 영국 척도)(Give him an inch and he'll take an ell 봉당을 빌려 주니 안방까지 달란다)
ell : n, L형의 물건, L혀, 증축
Ella : n, 여자 이름
Ellen : n, 여자 이름
ellipse : n, 타원, 장원형
ellipsis : n, 생략, 생략부호
ellipsograph : n, 타원컴퍼스, 타원자
ellipsoid : n, a, 타원면
ellipsoidal : a, 타원체(모양)의
ellipt, : x, elliptical, elliptically
elliptic : a, 타원의, 생략의
ellipticity : n, 타원 모양, 타원율, (특히)지구 타원율
Ellis : n, 남자 이름
Ellis Island : n, 엘리스섬(뉴욕항의 작은 섬, 전에 이민 검역소가 있었음)
elm : n, 느릅나무
Elmer : n, 남자 이름
Elmo : n, 남자 이름
elmy : a, 느릅 나무가 많은
El Nino : n, 엘니뇨(남아메리카 북서부 연안을 남하하는 난류)
elocution : n, 웅변술, 학술, 낭독법
elocutionary : a, 발성법상의, 연설법(웅변술)상의
elocutionist : n, 웅변가
eloge : n, 찬사, (특히 프랑스 학사원 회원의)추도 연설, 추도사
Elohim : n, 예로힘(여호와의 별칭)
Elohist : n, 엘로히스트(구약성서 첫 6편에서 하느님을 Elohim이라 부른 저자)
Eloise : n, 여자 이름
elongate : a, vt, 길게하다, 길어지다, 연장하다, 길어진, 가늘고긴
elongated : a, =ELONGATE
elongation : n, 연장, 신장
elope : vi, 눈맞아달아나다
elopement : n, 애인과 함께 달아나기, 가출, 도망
eloper : n, 눈이 맞아 달아나는 사람, 도망꾼
eloquence : n, 웅변
eloquent : a, 웅변의, 표정이 풍부한, ...을 잘 나타내는
El Paso : n, 엘패소
El Pasoan : n, 엘패소 태생의 사람, 엘패소 주민
Elsa : n, 여자 이름
El Salvador : n, 엘살바도르(중앙 아메리카의 공화국)
Elsan : n, 탈취등에 화학 약품이 쓰이는 휴대 변기
else : ad, 달리, 그밖에, 그렇지않으면
elsewhere : ad, 어딘가딴곳에
elsewhither : ad, =ELSEWHERE
Elsie : n, 여자 이름
ELT : x, English Language Teaching, European letter telegram
EL Tor : x, (시나이 반도에 있는 이집트의 검역소 이름에서)(세균)엘토르형 콜레라균
elucidate : vt, 밝히다, 설명하다
elucidation : n, (문어)설명, 해명
elucidative : a, 설명적인, 해명적인
elucidator : n, 설명(해명)하는 사람
elucidatory : a, 밝히는, 설명적인
elude : vt, (살짝 몸을 돌려)피하다, 벗어나다(evad)
elusion : n, 회피, 도피
elusive : a, 포착하기어려운, 용하게 빠져나가다, 알기어려운
elusory : a, 붙잡기 어려운, 잘 피하는
elutriate : vt, 씻어서 깨끗이 하다, 세광하다, 현탁 분리하다
eluvium : n, (지질)풍화 잔류물, 잔류 퇴적물(층), 잔적층
elvan : n, 맥반암, 화강반암
elver : n, 새끼 뱀장어(바다에서 강물로 올라온)
elves : n, elf의복수
Elvira : n, 여자 이름
elvish : a, =ELFISH
Ely : n, 일리(일글랜드 동부의 Isle of Ely 지방의 도시, 유명한 아름다운 Cathedral이 있음)
Elysee : n, 엘리제궁(프랑스 대통령 관저)
Elysian : a, ELYSIUM의(같은), 지복의
Elysian fields : x, =ELYSIUM 1 a
Elysium : n, a, 극락, 낙토, 이상향
elytron : n, 겉날개, 시초
Elzevi(e)r : n, 엘제비어 활자체
em : n, M자, (인)전각(M자 크기의 4각형)
em : pron, (구)=THEM
Em : n, 여자 이름
Em : x, (화)emanation
EM : x, electron micrsscope전자 현미경, electronic mail전자 우편, (미)enlisted man(men), (군)education manual
em- : pref, =EN-
EMA : x, European Monetary Agreement(경)유럽 통화 협정
emaciate : vt, 쇠약케하다
emaciated : a, 수척한, 여윈, 쇠약한
emaciation : n, 
emanate : vi, (빛, 열, 소리 따위가)발산하다
emanation : n, 발산물, 방사물, 에마나티온(방사성 기체)
emanative : a, 발산(방사)하는(시키는), 발산성 있는, 방사성의
emancipate : vt, 해방하다
emancipated : a, 해방된, 전통에 얽매이지 않는, 자주적인, 자유인의
emancipation : n, 해방
emancipationist : n, 노예 해방론자
Emancipation Proclamation : x, (미사)노예 해방령(해방 선언)
emancipative : a, =EMANCIPATORY
emancipator : n, 해방자
emancipatory : a, 해방의, 석방의
Emanuel : n, 남자 이름
emarginate : a, (식)가장자리가 톱니모양으로 갈라진, 오목하게 들어간 형의
emasculate : vt, a, 불까다, 거세하다, 유약하게하다, 불깐, 거세된, 유약한, 연약한
emasculation : n, 거세, 요긴한 데를 빼어 버림, 얼버무림, 무력화, 유약
emasculative : a, 거세하는, 무력화하는
emasculator : n, 거세하는 사람(도구), 무력화하는 사람(사물)
emasculatory : a, =EMASCULATIVE
embalm : vt, 시체에)향유를 발라서 보존하다:(이름을)길이 기억에 남기다, 향기를 풍기다, 향료를 치다
embalmment : n, (시체의)방부 보존, 미이라로 만듦, 방부 보존제
embank : vt, 둑으로 두르다, 둑을  다
embankment : n, 제방, 둑, 축제
embarcation : n, =EMBARKATION
embargo : n, vt, 항내출입금지, 통상금지, 금지하다, 몰수하다
embark : vi, vt, 배를타다, 출범하다, 배에 태우다, 투자하다
embarkation : n, 승선, 탑승, 적재, (새 사업 등에의)착수
embarkation card : x, 출국 카드
embarkment : n, =ENBARKATION
embarras de richesse : n, 처리 곤란할 정도로 재산이 많음, 지나친 풍요
embarrass : vt, 곤란케하다, 당혹케하다, 분규케하다, 행동을 방해하다
embarrassed : a, 어리둥절한, 당혹한, 창피한, 무안한, 난처한, (금전적으로)궁색한, 쪼들리는
embarrassedly : ad, 곤란(난처)한 듯이, 멋적은 듯이, 창피한 듯이
embarrassing : a, 쩔쩔매게 하는, 당황(창피, 무안)케 하는, 난처한, 곤란한, embarrassingly, ad
embarrassment : n, 난처함, 당혹, 곤란, 방해, 장애
embassador : n, =AMBASSADOR
embassy : n, 대사관, 사절단, 대사의 임무
embattle : vt, 진을치다, 포진하다, 성에 총안 달린 흉장을 갖추다
embattled : 전투 태세를 갖춘, 포진한, (건)총안 흉장이 있는, (구획선이)총안 모양으로 들쭉날쭉한, 적(군)에게 포위 당한, (사람이 늘)괴롭혀지는, 지겨운
embattlement : n, =EMBATTLED 1의 상태, BATTLENENT
embay : (배를)만 안에 넣다, (바람이 배를)만 안에 들여 보내다, (선대를)만처럼 둘러싸서 지키다, 가두어 넣다, 포위하다, 만 모양으로 하다
embayment : n, 만 형성, 만, 만 모양의것
embed : vt, 매장하다, 묻다, 깊이 간직하다
embellish : vt, 장식하다
embellishment : n, 장식
ember : n, 타다남은것, 여신
ember : n, 단식과 기도의 계재
Ember days : x, 사계재일
Ember week : x, (천주교)사계 재일주간
embezzle : vt, 위탁금 따위를 써버리다
embezzlement : n, 위탁금 따위의 유용, 착용
embezzler : n, (위탁금 등을)써버리는 사람, 횡령(착복)자
embitter : vt, 쓰게하다, 고되게하다, 심하게하다
embitterment : n, (괴로움 등의)심각화, (원한 등의)격화, 격분
emblazon : vt, 방패를 문장으로 장식하다, 화려하게 장식하다, 찬양하다
emblazonment : n, 문장 장식
emblazonry : n, 문장 화법, 문장, 장식
emblem : n, vt, 상징
emblematic : a, 상징의..., 을 상징하는
emblematist : n, 표장 제작자, 기장(표장)고안자, 우의화 화가
emblematize : vt, 상징적으로 나타내다, 상징하다
emblements : n, (법)인공 경작물, 근로 과실, (차지인의)농작물 수득권
embodier : n, 
embody : vt, 형체를 부여하다, 형체 있는 것으로 만들다, 구체화하다, 구체적으로 표현하다, 일체화하다, 통합하다, 포함하다
embog : vt, 수렁에 빠뜨리다, 궁지에 빠져 꼼짝 못하게 하다
embolden : vt, 용기를주다, 대담하게하다
embolic : a, (병리)색전(증)의, 색전증에 의한, (발생)함입(기)의, 함입에 의한
embolism : n, 색전증
embolismic : a, (유태력으로)윤년
embolus : n, 색전물
embonpoint : n, 여인의 비만
embosom : vt, 품에안다, 둘러싸다
emboss : vt, 돋을새김하다, 도드라지게 하다(embossed printing 우표, 구급 명함, 초대장 등을 인쇄)
embossed : a, 부조 세공을 한, 양각으로 무늬를 넣은, 양각으로 새긴, 돋을새김의, 눌러서 도드라지게 한
embossment : n, 부조로 함, 도드라지게 함, 부조 세공, 양각 무늬(장식)
embouchure : n, 하구, 골짜기의 어귀, 위주악기의 주둥이
embourgeoisement : n, (F)중산 계급(부르주아)화
embourgeoisification : n, 중산 계급(부르주아)화
embowel : vt, =EISEMBOWEL
embower : vt, vi, 나뭇잎으로가리다, 숨기다, 나무그늘에서쉬다
embrace : vt, vi, n, 포옹하다, 껴안다, 매수하다, 포함하다, 깨닫다, 채용하다, 서로 껴안다, 포옹
embracement : n, 포옹, (기꺼이)받아들임, 수락
embraceor : n, (법)(법관, 배심원 등을)매수하는 사람
embracer : n, 포옹하는 사람, 받아들이는 사람, EMBRACEOR
embracery : n, 미수
embracive : a, 포괄적인, 포옹을 좋아하는
embranchment : n, (골짜기, 산계, 하천 등의)분기, 분류
embrangle : vt, 혼란(분규)시키다
embrasure : n, (건)나팔꽃처럼 안쪽을 바깥쪽보다 넓게 낸 문이나 창구멍, (축성)(나팔꽃 모양의)총안
embrittle : vt, vi, 부서지기 쉽게 하다(되다), 무르게 하다(되다)
embrocate : vt, ...에 약을 바르다..., 에 찜질하다
embrocation : n, (문어)도포, (약용)도포액, 습포
embroglio : n, =IMBROGLIO
embroider : vt, 자수하다, 수놓다, 과장하다
embroiderer : n, 자수업자, 수놓는 사람
embroidery : n, 자수, 수놓기, 자수품, 윤색
embroil : vt, 분규시키다, 휩쓸어넣다
embroilment : n, 분규
embrown : vt, 갈색으로 물들이다, (빛깔을)어둡게 하다
embrue : vt, =IMBRUE
embrute : v, =IMBRUTE
embry- : x, (연결형)EMBRYO의 뜻(모음 앞에서는 embry-)
embryo : n, a, 배, 태아, 움, 싹, 배의, 태아의, 초기의
embryo freezing : x, 수정란의 동결 보존(액체 질소로 냉동 보존)
embryoid : n, (생)(동식물의) 부정배, 배양체, (배의 구조와 기능을 가진 식물(동물))
embryol, : x, embryology
embryologic : a, 발생(태생)학(상)의
embryologist : n, 발생(태생)학자
embryology : n, 발생학
embryonic : a, 배의, 태아의, 미발달의
embryo sac : x, (식)배낭
embryo transfer : x, (의)배이식(자궁 내의 태아를 외과적 수단으로 다른 자궁으로 옮기는 것)
embus : vt, vi, (군)버스(트럭)에 태우다(타다)
embusque : n, 정부의 일을 하며 병역을 기피하는자
emcee : n, vi, vt, 사회자, 사회하다
EMCF : x, European Monetary Cooperation Fund(금융)유럽 통화 협력 기금
emeer : n, =EMIR
emend : vt, 문서 따위를 교정하다(correct)
emendable : a, 수정(정정)할 수 있는
emendate : vt, =EMEND
emendation : n, 교정
emendator : n, 교정(수정)자
emendatory : a, 교정(수정)의
emer, : x, emeritus
emerage : vi, 나타나다, 일어나다, 빠져나오다
emerald : n, a, 녹음 에메랄드, 선녹색의
Emerald Isle : x, 에머랄드 섬(아일랜드의 속칭)
Emerald Lile : x, 아일랜드의 미칭
emergence : n, 출현, 탈출
emergency : n, 비상사태, 긴급한, 위급사태
emergency brake : x, 열차 따위의 비상 브레이크
emergency call : x, 비상 소집
emergency case : x, 구급 산자
emergency door : x, 비상구
emergency landing : x, (공)긴급(불시)착륙
emergency measures : x, 응급 조처
emergency power : x, 전시, 재해시의 비상 지휘권
emergency staircase : x, 비상 계단
emergent : a, 불시에나타나는, 뜻밖의, 긴급한
emergicenter : n, (미)응급 진료소, 응급실(예약 없이 간단한 구급 처치를 싼값으로 받을 수 있는)
emerging : a, 최근 생겨난, 최근에 만들어진
emeritus : a, 명예퇴직의
emersed : a, (물 속 등에서)나온, 나타난
emersion : n, =EMERGENCE 식 또는 엄폐후 일월의 재현
Emerson : n, 미국의시인
Emersonian : a, n, 에머슨의(같은), 에머슨 풍의, 에머슨 숭배자
Emersonism : n, 에머슨주의, (에머슨 풍의)초절주의
emery : n, 금강사
Emery : n, 남자 이름
emery bag : x, 금강사 주머니(바늘 연마용)
emery board : x, 손톱줄
emery cloth : x, 사포, 속새(연마용)
emery paper : x, 금강사로 만들 사지, 속새
emery wheel : x, 금강사로 만든 회전 숫돌
Emeter : n, 피부의 전기 저항 변화를 측정하는 전위계(거짓말 탐지기와 비슷한 장치)
emetic : a, n, 토하게하는
emeu : n, =EMU
emeute : n, (F)폭동, 반란
emf : x, electromotive force(전)기전력, 전동력
EMF : x, European Monetary Fund유럽 통화 기급
EMG : x, electromyograph(의)근전 기록 장치
emia : x, (연결형)(...한 혈액을 가진 상태, 혈액 중에 ...을 가진 상태)의 뜻
emic : a, (언)이미크적인(언어, 문화 현상 등의 분석, 기술에 있어서 기능면을 중시하는 관점에 관해서 말함)
emigrant : a, n, 이주하는, 이민
emigrate : vi, vt, 이주하다
emigration : n, 이주
emigration tax : x, =EXIT TAX
emigratory : a, 이주의, 이주에 관한, (조류가)이주성의
emigre : n, 이민, 망명한 왕당원
Emil : n, 남자 이름
Emilia : n, 여자 이름
eminence : n, 높은곳, 언덕, 고귀, 탁월, 저명, 전하
eminence grise : n, (F=gray cardinal), 심복 앞잡이, 숨은 실력자, 배후 인물
eminency : n, =EMINENCE
eminent : a, 우수한, 유명한, 현저한
eminent domain : x, (법)토지 수용권
emiocytosis : n, (생)(세포의)배출 작용, 배출 과정의 하나
emir : n, 아라비아의 대공, 족장, Mohammed의 자손을 부르는 칭효, 터키의 고관 칭호
emirate : n, EMIR의 관할 구역(권한), 수장국
emissary : n, 밀사, 사자, 간첩
emission : n, 방사, 발산, 발행
emissive : a, 방사성의, 방출적인, 방사(방출)된
emissivity : n, (물, 화)방사율, 복사능
emit : vt, 내다, 발하다, 발행하다
emitter : n, 방사체, (법령 등의)발포자, (지폐 등의)발행인, (전자)이미터(트랜지스터의 전극의하나)
Emma : n, 여자 이름
Emmanuel : n, 남자 이름
Emmeline : n, 여자 이름
emmenagogue : n, (약)월경 촉진약, 통경제
Emment(h)aler : n, 에멘탈(치즈)
emmet : n, (고, 방)개미
emmetropia : n, (안과)정시안
Emmy : n, 에미상(미국의 TV예술상)
Emmy Award : x, 에미상(미국의 텔레비젼 우수 프로, 우수 연기자, 기술자 등에게 매년 1회 수여되는 상)
EmnE, : x, Early Modern English
emollient : a, n, 부드럽게하는, 완화하는, 연화제
emolument : n, 급료, 보수
emote : vi, 과장된행동을하다, 정서를 보이다, 감정을 내다
emotion : n, 감동, 정서
emotional : a, 감정의, 감정적인, 정에 무른
emotionalism : n, 감격성, 감정에 호소함, 감정 노출 경향
emotionalist : n, 감정적인 사람, 감정가, 정에 무른 사람, 감격성의 사람, 감정에 호소하는 작가, 주정주의자
emotionalistic : a, 
emotionality : n, 감격성, 감동성, 정서성
emotionalize : 정서적으로 하다, 감정적으로 취급하다, 감정에  강하게 호소하다, 몹시 감동시키다, 감정적(비이성적)인 언동을 하다
emotionally : ad, 정서적으로
emotionless : a, 무표정한, 무감동의, 감정이 담기지 않은, 감정을 나타내지 않는
emotive : a, 감정의(에 관한), (어구 등이)감정을 나타내는, 감정 표출의, 감정에 호소하는, 감동적인, emotively, ad
emotivity : n, 감동성
EMP : x, electromagnetic pulse 전자 펄스
Emp, : x, Emperor, Empress
empale : vt, =IMPALE
empanada : n, (요리)(중남미의)스페인식 파이 요리(고기, 생선, 야채 등을 재료로 사용)
empanel : v, =IMPANEL
empaquetage : n, 패키지 (예술)작품(캔버스 등으로 물건을 싸고 묶어서 만들어 내는 개념예술의 한 수법)
empathic : a, 감정 이입의(에 입각한), empathically, ad
empathize : vt, vi, 감정 이입하다, 마음으로부터 공감하다
empathy : n, 감정이입(상대방의 감정의 완전한 이해)
empennage : n, (F)(공)(비행기, 비행선의)미부, 미익
emperor : n, 황제
emperor moth : x, 산누에나방
emperor penguin : x, (조)엠퍼러(황제)펭귄(가장 큰 종류)
empery : n, (시, 문어)황제의 영토(통치권), 광대한 영토(권력)
emphasis : n, 강조, 강세, 어세, 문세
emphasize : vt, 강조하다
emphatic : a, 어세가강한, 강조한, 단호한, 절대적인, 두드러진
emphatically : ad, 강하게
emphysema : n, 기종
empire : n, 제국, 절대 지배권
empire builder : x, (영토 확장을 꾀하는)제국주의자, 자기의 세력 확대에 주력하는 사람
Empire City : x, 뉴욕시
Empire Day : x, =COMMONWEALTH DAY
Empire State : x, New York주의 속칭
Empire State Building : x, 엠파이어 스테이트 빌딩(뉴욕시에 있는, 지상102층의 고층 건물, 텔레비젼 탑을 포함한 높이는약 449미터)
empiric : n, 경험주의자, 돌팔이 의사, 경험의, 경험적인, 돌팔이 의사 같은
empirical : a, 경험적인, 경험(실험)상의, (화)실험식, 경험주의의(의사 등), empirically경험적으로, ad
empiricism : n, 경험주의
empiricist : n, 경험주의자, (철학상의)경험론자, EMPIRIC
emplace : vt, (포상을)설치하다
emplacement : n, 설치, 고정, 위치
emplane : vi, vt, 비행기에타다
employ : vt, 고용하다, 쓰다, 소비하다, ...에 종사하다, 고용, 사용, ...에 고용되어, 실직하다
employability : n, 
employable : a, (사람이)고용하기에 적합한
employe : n, (F)=EMPLOYEE
employed : a, 취직(취업)하고 있는, 고용자들, 노동자(보통 한 나라, 한지역의 취업자 전체를 말함)
employee : n, 고용인, 종업원
employer : n, 고용주
employment : n, 고용직
employment agency : x, (민간의)직업 소개소(안내소)
employment bureau : x, (미)직업 안정소
employment exchange(office) : x, (영)공공 직업 안정소
Employment Service Agency : x, (영)직업 안정국, 고용 서비스청, 지업 소개소
empoison : vt, (고, 문어)독을 넣다, 독살하다, 악독한 마음(앙심)을 품게 하다, 격앙(격분)시키다, 부패(타락)시키다
empolder : vt, 간척하다, 매립하다
emporium : n, (문어)(중앙)시장, 상업 중심지, (미)백화점, 큰 상점
empower : vt, , , 에게권한을주다
empress : n, 황후, 여제
empress dowager : x, 황태후, 대비
empressement : n, (F)(환영 등의)열의, 열성, 친절, 온정
emprise : n, (고, 시)옹도, 모험, 담대한 용기
emptily : ad, 멍하게, 공허하게
emptiness : n, 공, (속이)빔, (마음, 사상, 내용 등의)텅 빔, 공허, 덧없음, 무지, 무의미, 빈 곳, 공복
empty : a, 빈, 비어있는, 공허한, 무의미한, 배고픈, 비우다, 비다
empty calorie : x, 단백질, 비타민 등을 포함하지 않은 식물의 칼로리
emptyhanded fake : x, 쿼터백이 빈 손으로 공을 던지는 시늉을 하는 것
emptyheaded : a, 머리가 텅빈, 무식한
empty nester : x, (구)자식이 없는 사람(부부), 자식들과 따로 사는 외로운 부부
empty nest  syndrome : (정의)성장한 자식들이  다 떠나버린 노년  부부에게 흔히 나타나는  증후군(정신적 불안정과  우울증을 수반하는 허탈감)
empty set : x, (수)공집합
empurple : vt, 자주빛으로 하다(물들이다)
empyema : n, 축농증
empyreal : a, 최고천의, 하늘의, 정화로 이루어진
empyrean : n, 화천, 천문학의 오천중의 최고, 천공
EMR : x, educable mentally retarede 교육 가능한 저능아
EMS : x, European Monetary System
EMT : x, emergency medical technician
emtyhanded : a, 빈손의, 맨손으로
emu : n, 에뮤(타조 비슷한 큰 새, 날지 못함
EMU : x, extravehicular mobility unit우주선밖활동용 우주복
emulate : vt, ...와 우열을 다투다(strive to equal or excel)
emulation : n, 
emulative : a, 경쟁의, 지지않으려는, emulatively, ad
emulator : n, 경쟁자
emulgent : a, n, 착출성의, 신 혈관의, 신장 정맥의, (해)신혈관, 신장 정맥, 이뇨제
emulous : a, 경쟁심이강한, 열망하는
emulsification : n, 유제화
emulsify : vt, 젖같이만들다
emulsion : n, 유제
emulsion chamber : x, (원자물리)원자핵 건판을 연판 사이에 끼워 조립한 하전입자 비적 측정기
emulsive : a, 유체성의, 유상화성이 있는, 유제화할 수 잇는
emunctory : n, a, (생리)배출기(관)(피부, 신장, 폐 등), 배출의, 배출기(관)의
en : n, N자, (인)반각(전각)
en : pref, (F)...에(있어서), 으로, 으로서
en- : pref, 동사를 만듦
enable : vt, ...할수있게하다
enabling : a, (법률이)(특별한)권능을 부여하는, 합법화하는
enabling act (statute) : x, (법)권능 부여법, 수권법
enact : vt, 법률화하다, 제정하다, 역을 하다
enacting clause : x, (법)제정 조항(법률안 또는 제정법의 서두 문구)
enaction : n, =ENACTMENT
enactive : a, 법률 제정의, 제정권(입법권)을 가지는
enactment : n, 제정, 설정, 법령
enactor : n, 
enamel : n, vt, 에나멜, 유약, 법랑
enameled : a, 에나멜(도료)를 입힌, 법랑을 칠한
enamelware : n, 법랑 철기
enamine : n, (화)에나민(이중결합 탄소를 가진 아민)
enamor : vt, 매혹하다(be enamored fl ...에 매혹되다(반사하다))
enamored : a, 매혹된, 홀딱 반한, 사랑에 빠진
enantiomorph : n, 경상체
enarchist : n, (프랑스의)국립 행정 학원(ENA)출신의 고급 공무원
enarthrosis : n, (해)구와관절
en attendant : ad, 기다리고 있는 사이에, 기다리면서, 그 사이에
en bloc : ad, 일괄하여, 총괄적으로
enbodiment : n, 구체화, 구현, 화신
enc, : x, enclosure
encaenia : n, 창립기념제, 옥스퍼드 대하가 창립 기념제
encage : vt, 새장에넣다, 가두다
encamp : vt, vi, 진을치다
encampment : n, 야영(함), 야영지, 진지, (집합적)야영자
encapsidate : vt, (생화)(세포내에서)(바이러스 입자를)단백질막으로 싸다
encapsidation : n, 
encapsulate : vt, 캡슐에 넣다(싸다), (사실, 정보 등을)요약하다, 캡슐에 들어가다(싸이다)
encapsulation : n, 
encase : vt, 넣다, 싸다, 둘러싸다
encash : vt, 현금화하다, 현금으로 받다
encaustic : a, n, 납화, 낙화
enceinte : a, 임신하여
encephal- : x, (연결형)(뇌)의 뜻(모음 앞에서는 encephal-)
encephalalgia : n, (의)두통
encephalic : a, 뇌수의(에 관계가 있는)
encephalitic : a, 뇌염의
encephalitis : n, 뇌염
encephalitis lethargica : x, (병리)기면성 뇌염
encephalitogen : n, (의)뇌염 유발 물질
encephalization : n, (생)대뇌화(피질 중추로부터 피질에의 기능의 이동)
encephalization quotient : x, (생)대뇌화 지수(체중과 뇌중량과의 관계 지수)
encephalo- : x, (연결형)=ENCEPHAL-
encephalogram : n, 뇌조영도
encephalography : n, (의)뇌 엑스레이 촬영법
encephalomyelitis : n, 뇌척수염
encephalomyocarditis : n, (의)뇌척수 심근염
encephalon : n, 뇌, 대뇌
enchain : vt, 속박하다, 사슬로매다, 강하게 끌다
enchainement : n, (F)(발레)앙셴망
enchant : vt, 마술을걸다, 매혹하다
enchanter : n, 매력있는 사람, 매혹하는 사람, 마법사, 요술쟁이
enchanting : a, 매혹적인
enchantment : n, 매혹
enchantress : n, 여자 요술쟁이, 마녀, 매혹적인 여자
enchase : vt, 새기다, 박아넣다, 상감하다
enchilada : n, 얇은 옥수수 빵에 기계로 저민 고기를 끼워 기름에 튀겨 chili소스를 친 멕시코 요리
enchiridion : n, 편람, 교본 안내서
encina : n, (식)(미국 남서부산의)떡갈나무의 일종
encipher : vt, 암호로 바꾸다
encircle : vt, 둘러싸다, 일주하다
encirclement : vt, 일주, 포위, 고립화(적성 국가군에 의한 포위)
en clair : ad, (F)(암호가 아닌)보통 말로
enclasp : vt, 움켜쥐다, 잡다 껴안다
enclave : n, 고립된영토
enclitic : a, n, 전접어, 전접
enclose : vt, 에워싸다, 두르다, 넣다, 동봉하다
enclosure : n, 울, 담, 울타리, 울안, 구내, (15, 18세기에 대지주가 교환 분합에 의하여 한 곳에 모은)종획지
Enclosure Acts : x, (영)공유지의 사유지화 법령(공유지를 사유지로 울막는 데 관한 법령)
enclothe : vt, =CLOTHE
encloud : vt, 구름으로 싸다(덮다)
encode : vt, vi, 암호화하다
encoder : n, 부호기(컴퓨터)
encomiast : n, 예찬가
encomiastic : a, 찬미의, 칭찬의, 아부하는, 추종적인
encomium : n, 찬사, 찬미
encompass : vt, 포함하다, 둘러 싸다
encore : int, n, vt, 앙코르하다
encounter : n, vi, vt, 우연히만남, 회전
encourage : vt, 기운을북돋아주다, 격려하다, 조장하다
encouragement : n, 격려함
encouraging : a, 격려(장려)의, 힘을 북돋아 주는, 유망한
encowment insurance : x, 양로 보험
encrimson : vt, 새빨, 게 물들이다
encrinite : n, (동)갯나리, 갯나리의 화석
encroach : vt, 침입하다
encroacher : n, 침입(침해)자
encroachment : n, 잠식, 침략, 침해, 침식지, 침략지
encrust : vt, 껍질로 덮다
encrypt : vt, vi, =ENCODE
encryption : n, 
enculturation : n, (사회)문화화, 문화 적응
encumber : vt, 방해하다...으로 막다, 번거롭게 하다, 빚을지게 하다
encumbrance : n, 방해, 장애, 골칫거리
ency : suf, (성질, 상태를 나타내는 명사 어미)
encyc : x, encyclopaedia
encyclic : a, n, 회람의, 로마 교황의 회장
encyclopaedia : n, 백과사전(프랑스의Diderot, d'Alembert등이 공동 편집한)백과 전서
Encyclopaedia britannica : x, 대영 백과 사전
encyclopedic : a, 백과 사전적인, (사람, 지식이)해박한, 박학의
encyclopedist : n, 백과 사전 편집자
encyst : vt, (생)포낭에 싸다
encystation : n, (생)포낭 형성
encystment : n, (생)포낭 형성
end : n, vt, vi, 끝, 마지막, 종말, 목적, 결과, 조각, 전위, 빈둥빈둥, 미해결로, 어찌할 바를 모르고, 무직으로, 산란하여, 끝마치다, 그만두다, 죽이다
END : x, European Nuclear Disarmament
end- : x, (연결형)(내부, 흡수)의 뜻
endall : n, 종결, 대단원, 만사의 결말
endamage : vt, =DAMAGE
endameba : n, 엔드아메바(아메바 적리의 병원균)
endanger : vt, 위태롭게하다
endangered : a, (동식물이)멸종될 지경에 이른
endangered species : x, 멸종 위기에 처한 동식물의 종
end around : x, (미)엔드 어라운드(볼을 받은 공격팀의 end가 라인 반대측으로 우회하여 전진하는 트릭 플레이)
endblown : a, (관악기 등)입을 대고 부는 주둥이가 달려 세로로 부는
end consumer : x, 최종 소비자
endear : vt, 사랑스럽게여기게 하다, 그리워지겔 하다
endearing : a, 사랑스러운
endearment : n, 친애, (행위, 말에 의한)애정의 표시, 애무
endeavor : n, vi, vt, 노력하다
endemic : a, n, 풍토병의, 풍토병
endemical : a, =ENDEMIC
endemism : n, 한 지방의 특유성, 고유성, 풍토성
endermic : a, (의)피부에 침투하여 작용하는, 피부에 바르는, 피내의, endermically, ad
en deshabille : ad, (F)평복으로, 약식 복장으로
end game : x, (체스, 시합의)최종회, 막판
endgate : n, (트럭의)적재함의 뒷닫이문
ending : n, 결말, 종결, 말미, 어미
endistance : vt, (연극 등이 관객에게)거리감을 가지게 하다, 관객을 이화하다
endive : n, 꽃상추(샐러드용)
endleaf : n, =ENDPAPER
endless : a, 끝없는, 무한한, 영원한, 순환의
endlessly : ad, 끝(한)없이, 가이없이, 영구히
end line : x, 끝(한계, 경계)을 나타내는 선, (테니스, 농구, 미식 축구 등의)엔드 라인
endlong : ad, (고)세로로, 똑바로 서서
end man : x, 열 끝의 사람, 쇼의 무대 양끝에 있는 흑인 광대
end matter : x, (인)책의 부록(주석, 참고 문헌 목록, 색인 등)
endmost : a, 말단의
endnote : n, (책의)권말에 있는 주
endo- : x, (연결형)=END-
endobiotic : a, 생물체내에 사는(숙주에 기생하는)
endoblast : n, (생)내배엽
endocardial : a, (해)심장내의, 심장 내막의
endocarditis : n, (병리)심장 내막염
endocardium : n, (해)심장 내막
endocarp : n, 내과피
endocast : n, 두개강 등의 내형을 나타내는 형(인상)
endocentric : a, (언)내심적인
endocrine : a, n, 내분비의, 내분비물, 호르몬, 내분비선
endocrine gland : x, (생리)내분비선
endocrinic : a, =ENDOCRINE
endocrinology : n, (의)내분비학
endocrinous : a, =ENDOCRINE
endocytose : vt, (생)(세포가 이물을)흡수하다
endocytosis : n, (생)세포 이물 흡수
endoderm : n, (생)내배엽
endodermis : n, (식)내피
endofday glass : x, 혼색 유리잔
endoftape marker : x, (전자)테이프의 끝 표시물(자기 테이프의 끝을 나타내는 표시)
endogamic : a, 동족 결혼의
endogamous : a, (사회)동족 결혼에 의한(에 관한)
endogamy : n, 동족결혼
endogen : n, (식)단자엽 식물
endogenic : a, =ENDOGENOUS 1, (지질)내인성의
endogenous : a, 내부로부터 발생하는, 내생의, 내인성의
endogeny : n, (생)내인성 발육
endolymph : n, (해)(내이의)미로 임파, 내임파(액)
endometritis : n, 자궁 내막염
endomitosis : n, (생)핵내 유사 분열
endomorph : n, (심)내배엽형의 사람(비만형의), (다른 광물 안에 든)내포 광물
endomorphic : a, (심)내배엽형의(비만형의), 내포 광물의
endomorphism : n, (관입 화성암 중에서 생기는)혼성작용, (수)자기준동형
endomorphy : n, (심)내배엽형
endoparasite : n, (동)내부 기생체(충)(촌충 등)
endoperoxide : n, (생화)엔도페록시드
endophilic : a, (생태)인간(환경)과 관계가 있는
endoplasm : n, 내질
endoplasmic : a, 
end organ : x, (생리)(신경의)종말 기관, 단말기
endorheic : a, (지)(바다로 직접 통하는 하류가 없는)내부 유역의
endorse : vt, 배서하다, 보증하다
endorsee : n, 피배서인, 양수인
endorsement : n, 배서, 보증, 시인, (상품 등의)추천
endorser : n, 배서(양도)인
endosarc : n, (생)내질, 내부 원형질
endoscope : n, 내사경(직장, 요도등의)
endoscopy : n, (의)내시경 검사(법)
endoskeleton : n, (해)내 골격
endosmosis : n, (생, 화)(내)침투, 침입
endosperm : n, 배유
endosteum : n, (해)골내막
endothelium : n, (해, 동)내피, (세포의)내복 조직, (식)내종피
endotherm : n, 온혈동물
endothermal : a, 흡열성의, 흡열반응의
endotoxin : n, (생화)(균체)내독소
endotoxoid : n, a, (균체)내독소에서 얻을 수 있는 변성 독소(의)
endow : vt, 기금을기부하다, 자질, 능력 따위를 부여하다
endowment : n, 기부
endowment assurance : x, (영)=ENDOWMENT INSURANCE
endpaper : n, 색의 면지
end point : x, 종료점, 종점, (화)(적정의)종점, =ENDPOINT
endpoint : n, (수)단점, 종점(선분이나 광선의 끝을 나타내는 점)
end product : x, 연속 변화의 최종결과, 최종 생성물
end rhyme : x, (운)각운
endrin : n, (화)엔드린(살충제)
end run : x, 엔드런(공을 가진 선수가 아군 방어진의 측면을 돌아 후방으로 나가는 플레이)교묘한 회피
endrun : vt, vi, (미구)잘 피해서 가다, 잘 빠져 나가다
end stop : x, 문미 기호
endstopped : a, 행말 종지의
Endsville : a, n, (미속)최고의(것)
end table : x, (소파, 의자 곁에 놓는)작은 테이블
endtoend : a, 한쪽 끝과 다른 한쪽 끝을 잇는, (회과)(장 등의)절단한 면과 다른 한끝을 봉합하는
endue : vt, 부여하다
endurable : a, 참을 수 있는, 견딜 수 있는, endurably, ad
endurance : n, 인내, 내구성
endure : vt, vi, 견디다, 참다, 겪다, 받다, 인내하다, 지탱하다
enduring : a, 참는, 영속적인
enduro : n, 자동차등의 내구 레이스
end use : x, 최종 용도
end user : x, 최종 수요자, 실수요자
end ways : ad, 끝을 위로하고, 세로
Endymion : x, (그신)엔디미온(달의 여신 Selene에게 사랑 받은 미소년)
end zone : x, 엔드 존(골라인과 엔드라인 사이의 구역)
ENE : x, eastnortheast
ene : suf, (화)(불포화 탄소화합물)의 뜻, (...에 태어난(사는)사람)의 뜻
enema : n, 관장기
enemies list : x, 적대 인물 일람표
enemy : n, 적, 원수, 적군적함
energetic : a, 정력적인, 원기왕성한
energetics : n, (물)에너지론(학)
energism : n, (윤)활동주의
energize : vt, 활기띠게하다
energizer : n, 정력(활력)을 주는 사람(물건), (의)항울제, 정신 활성 부여제
energumen : n, 귀신들린사람, 광신자
energy : n, 정력, 활기, 원기, 에너지
energy audit : x, (시설의 에너지 절감을 위한)에너지 감사(진단), energy auditor, n
energy budget : x, (생태계의)에너지 수지
energy bush : x, (연료, 전력이 되는)에너지림
energy crisis : x, 에너지 위기
energy flow : x, (생태계의)에너지 흐름
energy industry : x, 에너지 산업(석탄, 석유, 전기, 가스 산업 등)
energyintensive : a, 많은 에너지를 소비하는, 에너지 집약적인
energy park : x, (미)에너지 단지, 에너지 자원 공동 이용지
energysaving : a, 에너지를 절약하는
enervate : vt, 약하게하다
enervated : a, 활력을 잃은, 무기력한
enervation : n, 원기(기력)상실, 쇠약, 나약
enface : vt, (어음, 증권 등의)표면에 기입(인쇄, 날인)하다, enfacement, n
en famille : ad, (F=in the family)가족이 다함께, 흉허물없이, 비공식으로
enfant cheri : n, (F=cherished infant)귀염둥이, 소중한 것, 애지중지하는 것
enfant gate : n, (F=spoilt child)버릇없는 아이
enfant terrible : x, 어른 뺨질 깜찍한 아이
enfeeble : vt, 약하게하다, enfeeblement쇠약n
enfeoff : vt, 영지(봉토)를 주다, (고)(몸을)맡기다
enfeoffment : n, 봉토 하사, 봉토 하사장(증서), 봉토
en fete : x, (F=in festival)축제 기분으로 떠들썩하여, 성장하여
enfetter : vt, 차꼬를 채우다, 속박하다
enfilade : n, vt, 종사하다
enfold : vt, 싸다, 안다, 포옹하다, 접다, 주름잡다
enforce : vt, 실시하다, 강요하다
enforceability : n, 
enforceable : n, 실시, 강요
enforced : a, 강제된, 강제적인
enforcedly : ad, 
enforcement : n, (법률의)시행, 집행, (복종 등의)강제, (의견 등의)강조
enforcement officer : x, (미)(법률 등의)시행관, 경관
enforcer : n, (법)(법률 등의)집행자(재판소 등), (아이스하키)상대 팀이 겁을 먹도록 거친 플레이를 하는 선수
enframe : vt, 그림 등을 액자에 끼우다
enfranchise : vt, 해방하다, 석방하다, 공민권을 부여하다
enfranchisement : n, 해방, 석방
eng, : x, engine, engineer(ing), engraved, engraver, engraving
Eng, : x, England, English
Eng, D, : x, Doctor of Engineering
engage : vt, vi, 종사시키다, 당기다, 속박하다, 예약하다, 교전시키다, 걸다, 보증하다, 고용하다, 약속하다, 교전하다, 걸리다
engage : a, 관계된, 정치에 관계된
engaged : vt, 약속된, 약혼중인, 용무중인, 바쁜, 고용된, 통화중인, 교전중인
engagement : n, 약혼, 약속, 고용, 초빙, 용무
engagement ring : x, 약혼 반지
engager tone : x, (전화)통화중 신호음
engaging : a, 마음 끄는, 매력 있는
en garcon : ad, (F)독신자로서
engarland : vt, 화환으로 장식하다
Engel : n, 독일의 통계학자
Engel's law : x, 엥겔의 법칙
Engels : n, Friedrich(1820, 95)독일의 사회주의자, Marx의 협력자
engels coefficient : x, 엥겔계수
engender : vt, vi, 야기하다, 발생하다
engild : vt, (고)도금하다, 닦다
engin, : x, engineer, engineering
engine : n, 기관, 엔진, 기관차, 기계, 기구, 병기
engine bay : x, (공)(동체 하부의)엔진 격납실
engine company : x, 소방서
engine department : x, (선박의)기관실
engine driver : x, 철도의 기관사
engineer : 공학가, 기술자, 기사, (기계	따위의)설계자, 철도의 기관사, 육군의  공병, 해군의 기관  장교, 설계하다, 능란하게 처리하다
Engineer Corps : x, (미)공병단
engineered food : x, 강화(보존)식품
engineerese : n, 기술 용어, 전문 용어
engineering : n, 공학, 기술, 기관술, 공사
engineer officer : x, (공군)공병 장교, (해군)기관 장교
engine house : x, 차고
engineman : n, =ENGINE DRIVER
engine room : x, 기관실
enginery : n, 기관, 기계류, 병기 계략
engine shed : x, 기관 차고
engine turning : x, 로젯 무늬(시계 뒤덮개, 증권 등에 기계로 새겨 넣은 줄무늬)
engird : vt, 띠로 감다, 둘러싸다
engirdle : vt, =GIRDLE
England : n, 잉글랜드
englander : n, =LITTLE ENGLANDER, 잉글랜드 사람, 영국인
English : a, n, vt, 영어, 영국의, 영국사람, 풀이하다
English Canadian : x, 영국계 캐나다 사람, 영어를 사용하는 캐나다 사람
English Channel : x, 영국 해협
English daisy : x, (식)데이지
English disease : x, 영국병(노동자의 태업에 의한 생산 저하 등의 사회적 병폐), (고)구루병, 기관지염
English English : x, 영국 영어
Englisher : n, 영국 국민, 외국어를 영어로 번역하는 사람
English flute : x, (악)=RECORDER 3
English horn : x, 잉글리시 호른(oboe류의 목관 악기)
Englishism : n, 영국식 어법, 영국풍(식), 영국주의
English ivy : x, (식)서양 담쟁이 덩굴
Englishize : vi, 영국식 풍으로 하다
Englishman : n, 잉글랜드 사람, 영국인(남자), 영국선
Englishment : n, (외국 저작물의)영어역, 영역판
English muffin : x, 영국식 머핀(이스트를 넣은 머핀)
Englishness : n, 영국(사람)다움, 영국(사람)식
English Revolution : x, (영사)영국 혁명, 명예(무혈)혁명
Englishry : n, (태생이)영국사람임, 영국풍, (집합적)(아일랜드의)잉글랜드계 주민
English setter : x, 영국종 사냥개
English sickness : x, =ENGLISH DISEASE
English sonnet : x, 영국풍 14행시
English sparrow : x, (조)집참새
Englishspeaking : a, 영어를 말하는
English walnut : x, (식)서양호도나무, 그 열매
Englishwoman : n, 영국여자
engorge : vt, 게걸스레먹다
engr, : x, engineer, engineering, engraved, engraver, engraving
engraft : vt, 접목하다, 주입하다
engrail : vt, 깔쭉깔쭉하게 하다, 가장 자리를 톱니 모양으로 하다
engrain : vt, a, =INGRAIN
engrained : a, =INGRAINED
engram : n, (심)기억 심상, (생)기억의 흔적(세포내에 형성된다고 여겨지는)
en grande tenue : ad, (F=in full dress)정장으로
engrave : vt, 새기다, 조각하다
engraver : n, 조각사, 조판공
engraving : n, 조각, 조판, 판화
engross : vt, 큰글자로쓰다, 정식으로 쓰다, 빼앗다, 몰두시키다
engrossing : a, 마음을 사로잡는, 마음을 쏠리게 한는, 전렴(몰두)하게 하는, engrossingly, ad
engrossment : n, 전렴, 몰두, 정식 자체로 크게 씀, 정서, 정서한 것, 독점, 매점
engrs, : x, engineers
engulf : vt, (심연, 소용돌이 등에)빨아들이다, 던져 넣다, 삼키다, 들이키다, engulfment, n
enhance : vt, 높이다, 늘리다, 강화하다
enhanced : a, 중대한, 높인, 강화한
enhanced radiation : x, (군)강화 방사선
enhanced radiation weapon : x, (군)강화 방사선 무기
enhanced recovery : x, =TERTIARY RECOVERY
enhancement : n, (가격, 매력, 가치 등의)상승, 등귀, 향상, 증대
enharmonic : a, 사분음의(평균율에서는)이명 동음의(올림 라음과 내림 마음 따위)a
enhearten : vt, 용기를 돋우다
ENI : x, Ente Nazionale Idrocarburi
eniac : x, 에니액(미국에서 만들어진 본격적 컴퓨터, 상표명)
Enid : n, 여자 이름
enigma : n, 수수께끼, 수수께끼의 인물, 불가해안 사물
enigmatic : a, 수수께끼의(같은), 알기 어려운, (인물이)정체 모를, 불가사의한, enigmatically, ad
enigmatize : vt, vi, 수수께끼로 만들다, 이해할 수 없게 하다
enisle : vt, (시)섬으로 만들다, 고도에 두다, 고립시키다
Eniwetok : n, 에니웨록 환초(미국의 원폭 실험지)
enjambment : n, (시)구걸치기(시의 1행의 뜻, 구문이 다음 행에 걸쳐서 이어지는 일)
enjoin : vt, 명령하다, 과하다
enjoy : vt, 즐기다, 누리다, 향유하다, 건강, 재산 따위를 가지고 있다(enjoy oneself 즐기다, 즐겁게 지내다(시간을 보내다)
enjoyable : a, 향유할 수있는, 즐거운
enjoyment : n, 향락
enkephalin : n, (생화)엔케팔린(진통제)
enkindle : vt, 불, 감정을 타오르게하다
enl, : x, enlisted, enlarge(d)
enlace : vt, 레이스로 장식하다, 단단히 동이다(감다), 에워싸다, 얽히게 하다
enlarge : vt, vi, 확대하다, 넓어지다, 퍼지다, 부연하다
enlargement : n, 확대
enlarger : n, (사)확대기
enlighten : vt, 교화하다, 계몽하다, 명백하게 하다
enlightened : a, 계몽된, 개화된, 문명의, 밝은, 훤히 통달한
enlightening : a, 계몽적인, 밝혀주는, 깨우치는
enlightenment : n, 계몽
enlink : vt, 연결하다
enlist : vt, vi, 병적에넣다, 입대하다, 협력하다
enlisted man : x, 사병, 지원병
enlistee : n, 지원병, 사병
enlister : n, 징병관, 모병관, 협력자, 지지자
enlistment : n, 병력 편입, 입대, 징모, 응모
enliven : vt, 활기를띠게하다
en masse : ad, 함계, 한꺼번에, 통틀어서
enmesh : vt, 빠뜨리다, 얽히게 하다
enmity : n, 적의, 증오
ennead : n, 아홉개로 이루어진 한 벌, (서적, 논문, 시 등의)아홉 편 한 묶음
enneagon : n, 9각형, 9변형
enneahedron : n, (수)9면체
ennoble : vt, 고귀하게하다, 귀족으로 만들다
ennui : n, 권태
ennuye : a, n, (F=wearied)권태를 느끼고 있는(사람), 싫증난(사람)
Enoch : n, 남자 이름
enology : n, =OENOLOGY
enormity : n, 극악, 범죄 행위
enormous : a, 거대한, 막대한, 흉악한, enormousness, n
enormously : ad, 막대하게, 엄청나게, 터무니없이
Enos : n, 남자 이름, (성)에노스
enosis : n, 병합, 동맹, 에노시스(키프로스에 있어서의 그리스에의 복귀 운동)
enough : a, n, ad, 충분한, 족한, 충분히, 많이 참으로, 친절하게도 ...하다, 아무리 ...하여도 부족하다
enounce : vt, 성명(선언)하다, 언명하다, (의견 등을)표명하다, 발음하다, enouncement, n
enow : a, ad, (고, 시)=ENOUGH
en pantoufles : ad, (F=in slippers)슬리퍼를 신고, 마음 편히
en passant : ad, ...하는 김에
en pension : ad, a, (F=in lodging)식사가 따르는 숙박 조건으로(된)
enplane : vi, 비행기에타다
en poste : a, (F=in an official position)(외교관이)부임(주재)하여
enquete : n, (F=inquiry)앙케트, 여론조사
enquire : vt, inquire
enquiry : n, =INQUIRY
enrage : vt, 격노하게하다
enrapport : ad, 동정하여
enrapt : a, 도취된, 황홀해진
enrapture : vt, 미칠듯이기쁘게하다, 황홀케하다
enraptured : a, 황홀한, 신나는
enravish : vt, =ENRAPTURE
enregiment : vt, 연대로 편성하다, 훈련시키다
en regle : ad, a, (F=in order)정식대로(의), 규칙대로(의)
enrich : vt, 풍부하게하다, 짙게하다, 농축하다, 영양가를 높이다
enriched food : x, 강화 식품(인공적으로 영양가를 높인)
enriched uranium : x, 농축 우라늄
enrobe : vt, 의복을 입히다
enroll : vt, 등록하다, 입회시키다
enrollee : n, 입회자
enrollment : n, 등록
enroute : ad, (F=on (the) route)도중에
ens : n, (L=being)(철)존재물, 실재물, (추상적)존재
Ens, : x, ensign
ENSA : n, Entertainment National Service Association)(영)위문 봉사회(군대를 위문하는)
ensample : n, (고)=EXAMPLE
ensanguine : vt, 피로 물들이다, 피투성이가 되게 하다
ensanguined : a, (문어)피투성이가 된
ensconce : vt, 몸을편히앉히다, 안치하다, 숨기다
en secondes noces : ad, 재혼하여(으로)
ensemble : n, 총체, 전체적효과, 합창단, 앙상블, 공연자
ensemble acting (playing) : x, 앙상블 연출(스타 중심이 아닌 전체 배우의 종합적 효과를 노리는)
enshrine : vt, ...을 사당에 모시다, 간직하다
enshroud : vt, 수의를 입히다, 덮어가리다
ensiform : a, (생)칼모양의
ensign : n, 군기, 국기, 기수, 해군소위(national ensign 국기, red ensign 영국 상인, whete ensign 영국 군함기
ensigncy : n, 기수의 역할(지위)
ensilage : vt, n, 저장하다
ensile : vt, 생목초를 사일로에 저장하다
enslave : vt, 노예로만들다
enslaver : n, 매혹시키는 사람(것), 남자의 마음을 사로잡는 여자, 요녀
ensnare : vt, 올가미에 걸어 넣다
ensorcell : vt, ...에게 요술을 걸다, 매혹시키다
ensoul : vt, 혼을 불어넣다, 마음에 담아두다
ensphere : vt, (둥글게)싸다, 둘러싸다, 구형으로 하다
ensue : vi, 계속해서일어나다
ensuing : a, (문어)다음의, 뒤이은, 뒤이어 일어나는, 결과로서 따르는
ensuite : ad, (F=in sequence)연달아
ensure : vt, 책임지다, 확보하다, 보증하다, 안전하게하다
enswathe : vt, 싸다, 붕대를 감다, enswathement, n
ENT : x, ear, nose, and throat이비인후(과)
ent : suf, 행위자를 나타내는 명사 어미, 성질, 상태를 나타내는 형용사 어미
ent, Sta, Hall : x, Entered at Stationers' Hall 판권 등록필
entablature : n, 돌림띠(처마에서 기둥머리까지의 부분으로 cornice, frieze, architrave의 세층)
entablement : n, (건)=ENTABLATURE, 상대(기둥뿌리 위에서 입상을 받치는 대)
entail : vt, n, 남기다, 수반하다, 상속권을 한정하다, 필요로하다, 한정상속
entangle : vt, 얽히게하다, 혼란시키다, 곤란케하다
entanglement : n, 얽히게 함, 얽힘, (사태의)분규, (군)녹채, 울짱의 장애물
entasia : n, (생리)긴장성(강직성)
entasis : n, 엔타시스(원주의 불룩함), 흘림
ENT doctor : x, (미속)이비인후과 의사
entellus (monkey) : x, (동)긴꼬리원숭이(동부 인도산)
entente : n, 협상국
entente cordiale : x, 협정, 현상
enter : vt, vi, , , 에들어가다...에들다, 참가하다, 시작하다, 들다
enteric : n, 장의, =ENTERIC FEVER
enteric fever : x, 장티푸스
enteritis : n, 장염, 장카타르
enterocrinin : n, 엔테로크리닌(소화 촉깆 호르몬)
enterogastrone : n, 엔테로가스트론(위분비억제 호르몬)
enterokinase : n, 엔테로키나아제(장내 효소의 일종)
enteron : n, 소화관
enteropathogenic : a, 장의 병을 일으키는
enteropathy : n, (병리)장질환
enterotomy : x, (외과)장절개(술)
enterotoxin : n, 엔데로톡신, 장독소
enterovirus : n, (세균)장균
enterprise : n, 사업, 기업, 기획, 모험심
enterpriser : n, 기업가, 사업가
enterprise zone : x, (행정)사업 지역, 기업지구, 기획 사업 지대
enterprising : a, 기업심이왕성한, 모험적인
entertain : vt, 즐겁게하다, 대접하다, 품다
entertainer : n, 대접하는사람
entertaining : a, 유쾌한, 재미있는
entertainingly : ad, 재미있게, 유쾌하게
entertainment : n, 대접, 연회, 여녜, 여응, 오락, 마음에 품음
entertainment computer : x, 오락용 컴퓨터
entertainment tax : x, (영)흥행세
enthalpimetry : n, (화)엔탈피 계측(법)
enthalpy : n, (물)엔탈피(열역학 특성 함수의 하나)
enthral : vt, 매혹하다, 노예로만들다
enthrallment : n, 노예화, 노예 상태, 마음을 사로잡음, 매혹
enthrone : vt, 왕위에앉히다
enthronement : n, 즉위(식), 주교 추대(취임식, 착좌식), 존경
enthronization : n, =ENTHRONEMENT
enthuse : vi, vt, (미구)열중(열광, 감격)하다(시키다)
enthusiasm : n, 열심, 열중, 열광, 열의
enthusiast : n, a, 열성적인 사람, 열광자, ...팬, ...광, (고)광식적인
enthusiastic : a, 열광의
enthusiastically : ad, 열광적으로
enthymeme : n, (논)생략 삼단 논법, 생략 추리법
entice : vt, 유혹하다, 꾀다, 유혹, 미끼
enticement : n, 유혹, 꾐, 유혹하는 것, 미끼, 매력
enticing : a, 마음을 끄는(끌만한), 유혹적인, enticingly, ad
entire : a, 전체의, 완전한, 온전한
entirely : ad, 완전히
entirety : n, (문어)완전, 온전함(한 상태), 전체, 전액
Entisol : n, (지질)엔티솔(층위가 거의 없거나 전연 볼 수 없는 토양)
entitle : vt, 칭호를 주다, 제목을 붙이다, 권리를 주다(be entitled to...에 대한 권리가 있다)
entity : n, 실재, 실체, 본체
entoderm : n, =ENDODERM
entomb : vt, 매장하다
entombment : n, 매장
entomic : a, 곤충의(에 관한)
entomological : a, 곤충학적인(상의)
entomologically : ad, 곤충학적으로, 곤충학상
entomologist : n, 곤충학자
entomologize : vi, 곤충학을 연구하다, 곤충을 채집하다
entomology : n, 곤충학
entomology : n, 곤충학
entomophilous : a, 충매의
entourage : n, 환경, 주의, 측근
entoutcas : n, (F=in any case)청우 겸용 우산, 전천후용 테니스 코트
entozoa : n, 체내 기생충
entracte : n, 막간의 연기, 연주
entrails : n, 내장, 내부
entrain : vt, 잡아 당기다, 운반해 가다
entrain : vt, vi, 기차에 태우다(타다
entrain : vt, vi, 열의, 활기
entrainment : n, (생)생물학적 사이클의 전환(변경)
entrammel : vt, 그물로 잡다, 속박하다, 방해하다
entrance : n, vt, 들어감, 입장, 등장, 입학, 입구, 취업(entrance exmination 입학 시험, entrance fee 입장료, 입학금, n
entrance examination : x, 입학(입사)시험
entrance fee : x, 입장료, 입회(입학)금
entrancement : n, 실신 상태, 무아경, 황홀의 경지, 기뻐 어쩔 줄 모름, 광희, 황홀하게 하는 것
entranceway : n, =ENTRYWAY
entrancing : a, 황홀케하는
entrant : n, 신입자
entrap : vt, 덫에 걸리게 한, 함정에 빠뜨리다, 덫으로 잡다, (사람을)(곤란, 위험 등에)빠뜨리다, 모함하다, ...을 속이다, 속여서...시키다
entreat : vt, 간절히부탁하다, 탄원하다
entreating : a, 간청의 탄원의
entreatingly : ad, 애원하다시피, 간청하듯이, 간절히
entreaty : n, 간원
entrechat : n, (F)(발레)앙트르샤(뛰어오른 동안에 발뒤축을 여러번 교차시키는 동작)
entrecote : n, (F=between rib)(요리)갈빗대 사이의 스테이크용 고기
entree : 입장(허가), 입장권, (요리)앙트레(생선과 고기사이에 나오는 요리), (미)(구운 고기 이외의)주요 요리, (악)(행진곡, 무도곡의)서주곡
entremets : n, (F=between dish)(요리)앙트르메(주요 요리 사이에 나오는 간단한 요리, 곁들이는 요리)
entrench : vt, vi, 참호를두르다, 견고하게지키다, 침해하다
entrenchment : n, 참오 구축 작업, 참호로 굳힌 보루, (권리의)침해
entre nous : x, 우리끼리만의 애깁니다만(between ourselves)
entrepot : n, (F=interpose)창고, (항구가 있는)화물 집산지, 화물 통과항
entrepreneur : n, (F=enterprise)기업가, (특히)가극의 흥행주, 중개업자
entresol : n, (F=between floor)(건)1층과 2층 사이의 낮은 중간층
entropy : n, 엔트로피
entrust : vt, 맡기다, 위임하다
entry : n, 들어감, 입장, 참가, 입구, 기입, 점거
entrylevel : a, 초보적인, 견습적인
entry permit : x, 입국 허가
entry visa : x, 입국 사증
entryway : n, 입구의 통로
entry word : x, =HEADWORD
entwine : vi, vt, 휘감기다
entwist : vt, 꼬다, 꼬아 합치다
enucleate : vt, 명백히 하다, (외과)적출하다, (생)...에서 세포핵을 빼내다
enucleation : n, (생)핵의 제거, (외과)적출, 설명, 해명
enumerate : vt, 일일이헤아리다, 열거하다, 세다
enumeration : n, (하나하나)셈, 계산, 열거, 목록, 일람표
enumerative : a, 열거하는, 계산(계수)상의
enumerator : n, (통계 등의)계산자, 계수자, 열거자
enunciate : vt, (이론, 주의 등을)선언하다, 발표하다, (단어를)똑똑히 발음하다
enunciation : n, 발음(하는 투, 방식), 언명, 선언
enunciative : a, 언명(선언)적인, 발음(상)의, enunciatively, ad
enunciator : n, 선언자, 발음자
enunciatory : a, =ENUNCIATIVE
enure : v, =INURE
enuresis : n, 유뇨증
env, : x, envelope
Env, Extr, : x, Envoy Extraordinary
envelop : vt, 싸다, 봉하다, 포위하다
envelope : n, 봉투, 포장재료
envelopment : n, 쌈, 봉해 넣음, 포위, 덮개, 포장지
envenom : vt, 독을넣다, 악의를갖게하다
envenomate : vt, (물거나 하여)독물(독액)을 주입하다
envenomation : n, 독물(독액)주입
envenomization : n, (뱀 등이)물어서 생기는 중독
enviable : a, 부러운, 바람직한
envious : a, 부러워하는, 시기하는
environ : vt, 둘러싸다
environment : n, 환경, 주위, 둘레
environmental : a, 환경의, 주위의, 환경예술의(environmental pollution 환경 오염)
environmental art : x, 환경 예술(관객을 포함하는 종합 예술)
environmental assessment : x, 환경 사전 조사
environmental biology : x, 환경 생물학, 생태학
environmental disruption : x, 환경 파괴
environmental engineer : x, 환경 공학자(환경 보전의 전문 기술자)
environmental engineering : x, 환경 공학
environmental impact statement : x, 환경 영향 평가보고서
environmentalism : n, 환경 결정론(인간 형성에 있어서 유전보다 환경을 중하게 봄)
environmentalist : n, 환경 보호론자
environmental pollution : x, 환경 오염
Environmental Protection Agency : x, (미)환경 보호국
environmental psychology : x, 환경 심리학
environmental science : x, 환경 과학
environmental warfart : x, 환경전(환경을 바꾸거나 파괴하는 전략)
environmentology : n, 환경학
environpolitics : n, 환경 보호(보전)정책
environs : n, 부근, 근교
envisage : vt, 상상하다...을 마음속에 그리다, 착상하다, 꾀하다
envision : vt, (장래의 일 등을)마음에 그리다, 상상하다, 계획하다
envoy : n, 결구, 사절, 전권공사
envy : vt, n, 시기하다, 부러워하다, 부러움, 질투, 신망
enweave : vt, =INWEAVE
enwind : vt, ...에 얽히다, 감겨 들다
enwomb : vt, 태 내에 배다, 싸다, 깊숙히 묻다(감추다)
enwrap : vt, 휩싸다
enwreathe : vt, (문어)화환으로(처럼)휘감다, (화환처럼)두르다, 얽다, 엮다
enxounter group : x, (정의)집단 감수성 훈련 그룹
enxounter grouper : x, 인카운터 그룹 참가자
Enzed : n, =NEW ZEALAND
enzootic : a, n, (동물의 병이)지방(풍토)성의, (동물의)지방(풍토)병
enzymatic : a, 효소의(에 의한), enzymatically, ad
enzyme : n, 효소
enzyme detergent : x, 효소 세제
enzyme engineering : x, 효소 공학(효소(작용)의 농공업에의 응용)
enzymologist : n, 효소학자
enzymology : n, 효소학
EO : x, Education Officer, Engineering Office 토목국, Executive Order
Eocene : n, a, (지질)(제3기의)시신세(의)
EOD : x, explosive ordnance disposal 폭발물 처리
eohippus : n, 에오히푸스(미국 서부에서 발굴된 시신세 전기의 화석마
Eolian : a, =AEOLIAN
Eolic : a, n, =AEOLIC
eolith : n, (고고)원시 석기
Eolithic : a, (고고)원시 석기 시대의
eon : n, =AEON
eonian : a, =AEONIAN
eonism : n, 남자의여성모방벽
eonsold : a, 아주 먼 옛날부터의, 머나먼 옛날의
Eos : n, (그신)에오스(여명의 여신, 로마 신화의 aurora에 해당)
eosin : n, (화)에오신(선명한 붉은색의 산성 색소, 세포질의 염색 등에 쓰임)
eosinophile : n, (해)호산구
eous : suf, ...와 같은, ...비슷한)의 뜻
Eozoic : n, a, (지질)=PRECAMBRIAN, RPOTEROZOIC
EP : n, (레코드)이피판(매분 45회전의 레코드)
EP : x, European Plan
Ep, : x, Epistle
ep- : pref, (위, 더하여, 외)의 뜻(모음 앞에서는 ep-)
EPA : x, Environmental Protection Agency(미)환경 보호청
epact : n, 태양력의 1년이 태음력보다 초과하는 날짜 수(약 11일), 1월1일의 월령
Epaminondas : n, 에파미논다스(그리스 Thebes의 정치가, 군인)
eparch : n, (옛 그리스의)주지사, (근대 그리스의)군수, (희랍 정교의)대주교, 주교
eparchy : n, (옛 그리스의)주, (근대 그리스의)군, (희랍 정교의)주교구, 대교구
epaulet : n, 견장
Epcot Center : x, (미)디즈니 미래도시
epee : n, (F칼끝에서)의 뜻에서, (펜싱)에페(끝이 뾰족한 시합용 칼)
epeeist : n, (F)(펜싱)에페 경기자
Epeirus : n, =EPIRUS
epenthesis : n, (언, 음성)삽입 문자, 삽입음
epergne : n, 식탁 중앙에 놓는 장식용 스탠드(과일, 꽃 등을 얹어 둠)
epexegesis : n, (수)설명적 보족(어)
Eph, : x, Ephesians
eph- : prdf, =EP, ephemeral
ephah, : n, 에파(고대 히브리의 건량 단위)
ephedrine : n, (화)에페드린(감기, 천식 치료제)
ephememron : n, =EPHEMERA
ephemera : n, 하루살이
ephemeral : a, 하루밖에못사는, 단명한, 멋없는
ephemerality : n, 단명, 덧없음, 덧없는 일(것)
ephemeralization : n, 단기 소모 상품 제조, 상품의 단명화
ephemerid : n, 하루살이
ephemeris : n, (천)(천체의)추산 위치표, 천문력, (고)달력, 일지
Ephes, : x, (성)Ephesians
Ephesian : a, EPHESUS의
Ephesus : n, 에베소(소아시아 서부의 옛 도시)
ephod : n, 유대 제사장의 제의
ephor : n, (예 그리스)민선 장관, (특히)공공 사업 감독관
Ephraim : n, 남자 이름, (성)에브라임, 에브라임족(이스라엘 부족의 하나), 북왕국 이스라엘
epi- : pref, =EP
epiblast : n, (생)낭배의 외피(외배엽이 됨)
epic : n, a, 서사시(의)
epical : a, =EPIC
epicalyx : n, (식)악상총포
epicanthic fold : x, (해)내안각췌피
epicanthus : n, =EPICANTHIC FOLD
epicardium : n, (해)외심막
epicarp : n, (식)외과피
epic drama : x, 에픽 드라마(관객의 비판적 사고를 촉구하는 서사극)
epicedium : n, 장송가, 애가
epicene : a, n, (라틴, 그리스 문법)통성의, 남녀 양성을 함께 가진, 남녀추니, 통성어
epicenter : n, 진앙
epicentral : a, (지진)진앙의
epicentrum : n, (영)=EPICENTER
epiclesis : n, (그리스정교)에피클레시스(성령 강림을 희원하는 기도)
epicotyl : n, (식)상배축
epicritic : a, (생리)(피부 감각 등이)(정밀)식별(판별)성의
Epictetus : n, 에픽테토스(그리스의 스토아학파 철학자)
epicure : n, 미식가, 쾌락주의자
epicurean : a, n, 향락주의의(사람), 식도락의사람
Epicureanism : n, 향락주의, =EPICURISM
epicurism : n, 향략주의, 미식주의, 식도락
Epicurus : n, 에피쿠로스(쾌락을인생의최고선으로여긴그리스의철인)
epicycle : n, (천, 수)주전원
epicyclic : a, 주전원의
epicycloid : n, 외사이클로이드
epicycloidal : a, 
epidemic : n, a, 유행병, (질병, 사상의)유행, 유행성의
epidemical : a, =EPIDEMIC
epidemic pleurodynia : x, (병리)전염성 흉통증(바이러스 등에 의한)
epidemiology : n, 유행(전염)병학
epidermal : a, 상피(표피)의
epidermin : n, (생)에피더민(동식물 표피의 주 구성 요소인 섬유상 단백질)
epidermis : n, (몸의)표피
epidermoid : a, 표피 비슷한, 표피 모양의
epidiascope : n, 실물환등기(투명체, 불투명체양용의)
epigastric : a, 상복부의
epigastrium : n, 상복부(위의 안쪽)
epigene : a, (지질)(암석이)표면에서 생성된, 외력적인, 표성의
epigenesis : n, (생)후성설(생물의 발생은 점차적 분화에 의한다는 설), (지질)후생
epigenous : a, (식)표면에 생기는, 잎의 표면에 발생하는
epiglottis : n, 회염(연골)
epigone : n, (조상보다 못한)자손, (문예)(일류 예술가, 사상가 등의)모방(추종)자, 아류
epigonic : a, 
epigonism : n, 열등 모방
epigram : n, 경구, 경구적표현, (짤막한)풍자시
epigrammatic : a, 경구의, 풍자적인
epigrammatist : n, 경구가, 풍자 시인
epigrammatize : vi, vt, 경구로 만들다
epigraph : n, 제명, 제사, 비문
epigrapher : n, =EPIGRAPHIST
epigraphic : a, EPIGRAPH의, EPIGRAPHY의
epigraphist : n, 비명학자, 금석학자
epigraphy : n, 비문연구
epigynous : a, (식)(꽃이)자방 하위의
epil, : x, epilepsy, epileptic, epilog(ue)
epilepsy : n, 지랄병, 간질
epileptic : a, n, 간질병의 환자
epilog(ue) : n, (책의)발문, 맺음말, 후기, 발시, 끝맺음말
epilogist : n, EPILOG(UE)의 작자(낭독자)
epinephrine : n, =ADRENALINE
Epiph, : x, Epiphany
Epiphany : n, 주현절(1월 6일)
epiphenominon : n, 부수 현상
epiphyte : n, 착생식물(이끼따위)
epiphytology : n, 식물 기생병학
Epirus : n, 에피루스(그리스 북서부의 지방, 그 지역과 현재의 알바니아 남부의 고대국가)
Epis(c), : x, Episcopal, Episcopalian
Epis, : x, (성)Epistle
episcopacy : n, (교회의)감독제도
episcopal : a, 감독의
Episcopal Church : x, 영국 성공회
Episcopalian : a, n, 감독과의 사람)
episcopally : ad, 주교(감독)로서, 주교에 의하여
episcope : n, 반사 투영기(불투명체의 화상을 스크린에 영사하는 환등장치)
episememe : n, 문법 의미소
episode : n, 삽화, 에피소드
episodic : a, 에피소드풍의, 삽화적인, 삽화로 이루어진, 일시적인
episome : n, 유전자부체
epispastic : a, n, (의)피부 자극성의, 발포성의, 발포제, 피부자극제
epistaxis : n, (의)코피
episteme : n, 지식, 인식
epistemic : a, 지식(인식)의(에 관한)
epistemological : a, 인식론(상)의
epistemology : n, 인식론
epistemophilia : n, 호학, 학문에 대한 비상한 흥미
epistle : n, 서간
epistler : n, (특히 신약 성서 중의)서간의 팔자, (성찬식의)사도 서간의 낭독자
epistle side : x, (제단의)남쪽, (제단을 향해)오른쪽
epistolary : a, 서간체의
epistolary novel : x, 서간체 소설
epistoler : n, =EPISTLER 2
epistrophe : n, (수)결구, 반복, 첩구
epistyle : n, (건)=ARCHITRAVE
episxopate : n, 주교(감독)의 지위(계급, 임기), 감독(주교, 사교)단
epitaph : n, (묘)비명
epitazial layer : x, (전자)에 피택셜 층
epithalamion : n, =EPITHALAMIUM
epithalamium : n, 결혼축하시, 결혼축하의 노래
epithelioid : a, 상피(조직)모양의
epithelium : n, 상피, (식)신피, 피막 조직, 상피
epithet : n, 별명, 형용사, 통칭
epithetic : a, 형용하는, 형용사적인
epitome : n, 발췌, 대요, 대표적인 것
epitomist : n, 요약자
epitomize : vt, ...의 전형이다, ...의 발췌(개요)를 만들다, 요약하다
epitope : n, (생화)에피토프(항원 결정기)
epizoon : n, 체외기생충
epizootic : n, 가축 유행병(의)
epluribus unum : , 다수로 이루어진 아하(one out of many)(미국의 모토)
EPN : x, ethyl paranitrophenyl 살충제의 일종
EPNdB : x, effective perceived noise decibels 감각 소음 효과 데시벨
epoch : n, 신기원, 신시대, (중대사건이 있던)시대
epochal : a, 새로운 기원의, 획기적인
epoche : n, (철)판단 중지
epochmaking : a, 획기적인
epode : n, 길고짧은행이번갈아있는서정시
eponym : n, 이름의시조(인종, 토지, 시대따위의이름의유래가된인물)
eponymous : a, 이름의 시조가 된
epopee : n, 서사시, 사시
epos : n, (구전에 의한)원시적 서사시, 서사시
epoxy : n, vt, (화)에폭시 수지, 에폭시 수지로 접착하다
Epping Forest : x, 에핑 포레스트
Eprime : n, be동사를 쓰지 않는 영어(미국에서 창안)
epris : a, (F=in love)...에 반한
EPROM : n, (전산)소거 프로그램 가능 ROM
epsilon : n, 그리어 알파벳의 다섯째 글자(E 영어의 short'e'에 해당)
Epsom : n, 잉글랜드 Surry주의 도시
Epsom salts : x, 사리염
EpsteinBarr virus : x, 엡스타인 바 바이러스
ept : a, 유능한, 솜씨있는, 효율적인
eptitude : n, 능력, 솜씨
eq, : x, equal, equation, equivalent
equability : n, (온도, 기후 등의)한결같음, 균등성, (기분, 마음의)평안, 침착
equable : a, 한결같은, 균등한, 평정한
equal : 같은, 한결같은, 필적하는, ~에 지지 않는, ~에 견디어  낼 수 있는, 평정한, 대등한 물건, 필적자, 같은 또래, ~에 필적하다, ~과 똑같다
equal(s) sign : x, 이퀄 기호
equalarea : a, (지도가)등적의, 정적의
equalitarian : n, a, \EGALIARLAN
equality : n, 동등, 평등, 대등
Equality State : x, 미국 Wyoming주의 속칭
equalization : n, 동등화, 평등화, 균등화
equalize : vt, vi, 똑같게하다, 평등하게 하다, 같아지다, 평등해지다, (경기에서)동점이 되다
equalizer : n, 등화기, 평형 장치, 균압선
equally : ad, 똑같게, 평등하게, 균일하게, (접속사적)그와 동시에, 그럼에도 불구하고
equal opportunity : x, (채용시의)기회 균등
Equal Rights Amendment : x, (미)남녀 평등 헌법 수정안
equal time : x, (정견 발표에서)평등한 방송시간 할당, 평등한 발언 기회
equanimity : n, (마음의)평정, 침착, 냉정
equate : vt, 방정식을세우다, (다른 수치와)같다고 표시하다
equation : n, 같게함, 균분법, 방정식
equational : a, 균등한, 방정식의, (생)2차 세포 분열의, (문법)등식 관계의, 주어와 보어로 이루어진
equator : n, 적도
equatorial : a, n, 적도(부근)의, 적도의
Equatorial Guinea : x, 적도 기니(적도 아프리카 서단의 공화국)
equerry : n, 왕가, 귀족의 말 광ㄴ리인, 주마관, 영국 왕실의 시종 무관
equestrian : a, n, 기마의, 말 탄, 승마자
equestrianism : n, 마술, 곡마술, 승마 연습
equestrienne : n, 여자마술가, 여자 곡마사
equi- : x, (연결형)(같은)의 뜻
equiangular : a, 등각의
equidistance : n, 등거리
equidistant : a, 같은거리의
equidistant diplomacy : x, 등거리 외교
equigravisphere : n, (지구와 달 사이 또는 두 천체간의)중력 평형권
equilateral : a, n, 등변의, 등변형
equilibrant : n, (물)평형력
equilibrate : vi, vt, 평형되다, 평형시키다
equilibration : n, 평형, 균형, 평균(상태)
equilibrator : n, 균형을 유지시키는 것, 평형 장치, (공)안정 장치
equilibrist : n, 줄타는 사람, 곡예사
equilibrium : n, 평형, 균형, (마음의)평정
equimultiple : n, 등배수, 등배량
equine : n, a, 말, 말의, 말과같은
equinoctial : a, n, 주야평분의, 춘분, 추분의, 주야평분선
equinoctial circle (line) : x, (천)주야 평분선
equinoctial point : x, (천)분점, 주야 평분점
equinoctial year : x, (천)분점년
equinox : n, 주야평분시, 낮과 밤이 똑같은 때
equip : vt, 갖추다, 준비하다, 꾸미다, 장비하다
equip, : x, equipment
equipage : n, 마차, 마부따위의한갖춤, 마차 장비 일체, 용구일습
equipe : n, 스포츠의 팀과 장비
equipment : n, 채비, 준비, 설비(선박의 의장품), (알에 필요한)능력, 기술
equipoise : n, 균형, 평형(상태)
equipollence : n, 힘의 균등, 균세, 등치
equipollent : a, n, 힘(세력, 효력, 중량)이 같은 (것), 효과(결과, 뜻)가 같은(것), equipollently, ad
equiponderance : n, 무게(세력, 권력)의 균형, 평형
equiponderant : a, 무게(세력, 권력)가 평균(평형)된
equiponderate : vt, (무게 등을)평균(평형)시키다
equipotential : a, n, 등압선의, 등전위의, 등압선, 등전위
equiprobable : a, (논)같은 정도의 개연성(확률)이 있는
equisetum : n, 속새류
equitable : a, 공평한, 공정한, 형평법상의
equitably : ad, 공정(정당)하게
equitation : n, 마술, 승마
equites : n, (고대 로마의)기사 계급
equitime point : x, 행동한계점, 진출 한계점
equity : n, 공평, 공정, 형평법
equity capital : x, (경)자기 자본, 투입 자본
equiv, : x, equivalent
equivalence : n, (가치, 힘 양이)같음, 등가, 동량, (화)(원자의)등가, 등량, (말, 표현의)등가성, 동의성
equivalent : a, n, 동등의, ~에 상당하는, 동등한 가치의, 등량의, 동의의, 동등한 물건, 대등한 물건, 동의어
equivocal : a, 모호한, 두가지 뜻으로 해석될 수 있는, 의심스러운, 명백하지 않은
equivocality : n, 다의성, 모호, 미심스러움, =EQUIVOQUE
equivocate : vi, 모호한말을쓰다, 이렇게도 저렇게도 해석될 수 있는 말을 쓰다, 속이다
equivocation : n, 모호한 말(을 쓰기), 얼버무림
equivocator : n, 모호한 말을 쓰는 사람, 얼버무리는 사람
equivoque : n, 모호한 말투(어구), 재담
er : int, 에에, 저어(망설이거나 말이 막혔을 때 내는 소리)
Er : x, (화)erbium
ER : x, (야)earned run, enroute
er : suf, (동사와 명사에서 동작자)명사를 만듬, ...하는 것, 반복을 표시하는 동사를 만듦
era : n, 기원, 연대, 시대, 대, 기
ERA : x, earned run average(야구)(투수의)방어율, Educational Research Administration, Emergency Relief Administration긴급 구제국
eradiate : vt, (빛, 열을)방사하다
eradiation : n, 방사
eradicable : a, 근절할수있는
eradicant : n, (기생 생물)근절제
eradicate : vt, 근절하다
eradication : n, 근절, 박멸
eradicative : a, 근절(근치)시키는
eradicator : n, 제초기, 얼룩빼는 약, 잉크 지우개
erasable : a, 지울 수 있는
erasable bond : x, 이레이저블 본드지(쉽게 지울 수 있게 한 코딩지)
erase : vt, 지워버리다, 말살하다, 삭제하다
eraser : n, 칠판 지우개, 고무 지우개, 잉크 지우개
Erasian : a, n, 유라시아의, 유라시아 혼혈아
erasion : n, 삭제, 말소, (외과)(태아의)소파, 제거
Erasmian : a, ERASMUS유파의, 에라스무스 학도
Erasmus : n, 에라스무스
Erastian : n, ERASTUS유파의, 에라스투스설의 신봉자
Erastianism : n, 에라스투스설(종교는 국가에 종속하여야 한다는 설)
Erastus : n, 남자 이름, 에라스투스
erasure : n, 지워 없앰, 말소, 삭제 부분(어구), 지운 자국
Erato : n, (그신)에라토
erbium : n, (화)에르븀(희토류 원소)
ERDA : x, Energy Research and Development Administration (미)에너지 연구 개발국
ere : prep, conj, ~의전에, ~이전에, ~보다 차라리
Erebus : n, (그신)에레보스
erect : a, vt, 꼿꼿이선, 꼿꼿이 세우다, 건립하다
erectile : a, 꼿꼿이설수있는, 발기할 수 있는
erection : n, 건립, 직립, 설립, 건물, 발기
erective : a, 직립력이 있는
erectly : ad, 직립하여, 수직으로
erectness : n, 직립(력), 수직성
erector : n, 건설자, 창설(설립)자
erelong : ad, 머지않아
eremite : n, 은자
eremitic : a, 은자적인
eremitism : n, 은자(은둔)생활
erethism : n, (병리)신경 과민, 신경성 흥분
erewhile : ad, 조금전에
erg : n, 에르그
erg- : x, (연결형)(일)의 뜻
ergate : n, 일개미
ergatocracy : n, 노동자 정치
ergo : ad, (익살)그런고로
ergograph : n, 작업 기록기(근육의 작업 능력, 피로도 등의)
ergolatry : n, 노동숭배
ergometer : n, 측력계, 에르그 측정기
ergon : n, 열의 작용으로 이루어지는 일의양
ergonomic : a, 인간 환경 공학의
ergonomics : n, 작업능률(효과)연구, 인간공학
ergonomist : n, 인간 공학 연구자
ergosphere : n, (천)작용권(블랙홀을 둘러 싼 가상의 대)
ergosterol : n, 에르고스테롤(자외선 조사로 비타민 D로 변환함)
ergot : n, (호밀의)맥각병, 맥각(지혈제, 자궁수축제)
ergotism : n, (의)맥각 중독
Eric : n, 남자 이름
Erica : n, 여자 이름
ericaceous : a, (식)철쭉과의
Ericsson method : x, 에릭슨 법(인공 수정법의 하나)
Erie : n, 미국북동부의오대호의하나
Erin : n, Ireland
Erinyes : n, (그신)=FURIES
Eris : n, 다툼과불화의여신
eristic : a, n, 논쟁상의, 논쟁적인, 논쟁자, 논쟁술
Eritrea : n, 에리트레아(아프리카 북동부, 홍해에 임한 에티오피아 자치령)
erk : n, 신병, 지상근무원, 얼간이
erlking : n, (폭풍우를일으키고, 또어린이를해치는)마왕
ermine : n, 흰담비, 흰담비의 모피로 안을 댄법복, 법관의 지위, 흰 바탕에 검은 점박이 무늬(카드의 kin의 깃에 볼 수 있음)
ermined : a, 어미의 털로 덮인(장식한), 어민 모피를 입은
ern : suf, (...쪽의)의 뜻
erne : n, (조)흰꼬리수리
Ernest : n, 남자 이름
Ernestine : n, 여자 이름
Ernie : n, 상금부 채권의 당선 번호를 추첨하는 장치
erode : vt, 부식하다, 침식하다
erodible : a, 침식 가능한
erogenous : a, (의)성욕을 자극하는, 성적으로 민감한
Eros : n, 에로스(사랑의신, 로마신화의Cupid에해당함)
erose : a, 고르지 않은, 울퉁불퉁한, (식)(잎등의 가장자리가)톱니 모양으로 째진
erosion : n, 부식, 침식
erosive : a, 부침식성의
erotic : a, 성애의, 애욕의
erotica : n, 성애를다룬문학
eroticism : 색정적 경향, 호색, 성적, 
eroticist : n, 성욕이 강한 사람, 에로 작가(배우)
erotism : n, (의)=EROTICISM
erotogenic : a, =EROGENOUS
erotological : a, 
erotology : n, 호색문학(예술)
erotomania : n, 색정광
erotophobic : a, 성적 표현을 겁내는, 성적 행위를 혐오하는
ERP : x, European Recovery Program 유럽 부흥 계획
err : vi, 잘못하다, 그르치다, 죄를 범하다
errable : a, 
errancy : n, (판단 등의)잘못, 상규를 벗어남, 실수하기 쉬움, 경솔, 변덕
errand : n, 심부름(다니기), 볼일, 사명
errand boy : x, 심부름꾼소년, 볼일, 사명(go errands 심부름다니다, go on an errand 심부름 가다)
errant : a, (모험을찾아)편력하는, 잘못된
errantry : n, 무예수련, 편력, 방랑
errata : n, erratum의 복수
erratic : a, 변덕스러운, 일정치 않은, 불규칙한, 별난, 상궤를 벗어난
erratical : a, =ERRATIC
erratum : n, 오자, 오식, 잘못
erroneous : a, 잘못된, 틀린
error : n, 잘못, 틀림, 잘못생각, 과실, 실책, 에러, 죄, 오차, 오심
error catastrophe : x, (생화)에러 카타스트로피(노화 현상 이론의 하나)
error message : x, (전산)에러 메시지(프로그램에 잘못이 있을 때 출력되는 메시지)
ersatz : n, 대용의, 대용품
Erse : n, a, 어스말(스코틀랜드의 게일말, 또는 아일랜드의 켈트어)
erst : ad, 이전에, 옛날에
erstwhile : ad, a, 이전에, 이전의, 옛날의
ERTS : x, 어츠(지구 자원 탐사 위성 제1호, 뒤에 Landsat으로 개칭)
erubescence : n, (피부가)붉어짐, 붉은 빛을 띰, 홍조
erubescent : a, (피부가)붉은 빛을 띤, 붉어지는
eruct : vi, vt, 트림하다, 분출하다
eructation : n, 트림, (화산의)분출(물)
eructative : a, 트림이 나는, (화산)분출의(에 관한)
erudite : a, n, 박식한(사람)
erudition : n, 박식, 해박
Eruoradio : n, 유로라디오(서유럽 국가 공동 경영의 라디오 방송국)
erupt : vi, vt, 분출하다, 분출시키다, 분화하다, 발진하다
eruption : n, 폭발, 분출, 분화, 돌발, 발진
eruptional : a, 분화의, 폭발의
eruptive : a, 폭발(돌발)적인, 발진성의
ERW : x, enhanced radiation weapon
Erwin : n, 남자 이름
ery : x, (성질, 행색, 습관)의 뜻, (...상, ...업, ...술)의 뜻
erysipelas : n, 단독
erythema : n, (병리)홍진, 홍반
erythorbate : n, (화, 약)에리소르빈산염(식품의 산화 방지제)
erythr- : x, (연결형)(적, 적혈구)의 뜻
erythrocyte : n, 적혈구
erythroid : a, 적혈구의(를 만드는)
erythroleukemia : n, (의)적백혈병
erythromycin : n, 에리스로마이신(항생 물질)
erythron : n, (생리)에리트론(골수 안의 적혈구와 그 전신)
erythrophobia : n, (정의)적면, 공포증, 적색 공포증
erythropoiesis : n, (생리)(골수에서의)적혈구 생성
erythropoietin : n, (생리)에리스로포이에틴(적혈구 생성 촉진 인자)
Es : x, (화)einsteinium
es : x, 명사의 복수 어미, 동사의 제 3인칭 단수, 현재형의 어미
es- : pref, =EX
ESA : x, European Space Agency
Esau : n, 에서(이삭의큰아들)
ESB : x, electrical stimulation of the brain뇌의 전기 자극
esbat : n, 마녀의 집회
Esc : x, escueo(s)
ESC : x, Economic and Social Council, escape(전산)확장
escadrille : n, 비행대, 소함대
escalade : vt, n, 사닥다리로오르다, 사닥다리로 오름, 성벽을 기어오름(기어오르다)
escalate : vt, vi, (군사행동따위를)단계적으로확대하다, 단계적으로 강화하다, 점증하다
escalation : n, (가격, 임금, 운임등의)에스칼레이터식수정
escalator : n, a, 에스컬레이터, 자동계단, 에스컬레이터식의
escalator clause : , 런던 해군 조약(1930)의 신축 조항, 임금계약의 에스컬레이터 조항(물가 변동에 따라 임금을 증감한즌 규정)
escalator scale : x, 에스컬레이터 조항에 의한 임금 체계
escalatory : a, (특히 전쟁의)규모 확대에 연계되는
escallop : n, =SCALLOP
ESCAP : x, Economic and Social Commission of Asia and Pacific (유엔)아시아 태평양 경제 사회 위원
escapable : a, 도망칠 수 있는, 피할 수 있는
escapade : n, 멋대로구는짓, 엉뚱한 짓, 장난, 도피, 탈출
escape : vi, vt, n, a, 달아나다, 탈출하다, 면하다, (기억에)남지않다, (가스따위가)새다, 도망, 도피
escape artist : x, 동아줄, 통을 빠져 나가는 곡예사, 탈옥의 명수
escape clause : x, 면제조항, 면책조항
escaped : a, 탈주한, 도망한
escapee : n, 도피자, 탈옥자
escape hatch : x, (비행기따위의)피난용비상구, (어려운 사태 등에서의)도피구
escape literature : x, 도피문학
escape mechanism : x, (심)도피 기제
escapement : n, 도파구, 시계 톱니바퀴의 탈진 장치
escape pipe : x, (escape valve에서 배출되는 액체, 증기의)배출관
escape ramp : x, 피난도로
escape valve : x, 배기밸브
escape velocity : x, (로켓의)탈출속도
escape wheel : x, (시계 톱니바퀴의)방탈 장치
escapism : n, 현실도피(주의)
escapist : n, a, 도피주의자, 현실 도피(주의)의
escapologist : n, 동아줄(바구니)을 빠져 나가는 곡예사
escapology : n, 동아줄(바구니)을 빠져 나가는 곡예(기술), 탈주법, 탈출술
escargot : n, 식용달팽이
escarole : n, 꽃상추의일종
escarp : n, vt, ESCARP
escarpment : n, 급사면, 벼랑
esce : suf, (...하기 시작하다, ...으로 되다, 화하다)의 뜻
escence : suf, (...하는 작용, 경과, 과정, 변화, ...상태)의 뜻
escent : suf, (...기의, ...성의)의 뜻
eschalot : n, (식)=SHALLOT
eschatological : a, (신학)종말론의
eschatology : n, (세계)종말론, 내세관
escheat : vi, vt, n, (토지따위가국왕, 영주에게)귀속하다, 귀속시키다, 몰수하다, 토지의 복귀, 토지의 몰수, 몰수지
escheatage : n, (법)(부동산)복귀권
escheator : n, (법)몰수(복귀)지 관리자
Escherichia coli : n, 대장균
eschew : vt, 피하다
eschscholtzia : n, (식)금영화
Escorial : n, 에스코리알
escort : n, vt, 호위자, 호위, 호송, 호위하다, 호송하다
escort agency : x, 사교장 등에 동반할 남녀를 소개하는 알선소
escort carrier : x, 호위용 소형 항공 모함
escort figher : x, (폭격기의)호위 전투기
escribe : vt, (수)방접원을 그리다
escritoire : n, (서랍달린)책상
escrow : n, (법)조건부 날인 증서
escudo : n, 포르투갈의화폐단위, 에스쿠도 금(은)화
esculent : a, n, 식용에알맞은, 식용품, (특히)야채
escutcheon : n, 방패모양의물건, 방패 모양의 문장 바탕
Esd, : x, (성)Esdras
Esdras : n, 경외 성서의 처음 두 권 중 어느 하나
ESE : x, eastsoutheast
ese : x, (지명에 붙여서)(...의, ...말(의)), (작가, 단체 이름에 붙여서)(...풍의, ...에 특유한)의 뜻
Esk, : x, Eskimo
Eskimo : n, 에스키모
Eskimoan : a, 에스키모 사람(만)의
Eskimo dog : x, 에스키모 개(썰매 개)
Eskimo roll : x, 에스키모식 전도복원
Esky : n, (오스)에스키(찬 음료를 담는 휴대 용기, 상표명)
ESL : x, English as a second language
ESOL : x, (미, 캐나다)English for Speakers of Other Languages
ESOP : n, 종업원 지주 제도
esophageal : a, 식도의
esophageal : a, 식도(esophageal cancer 식도암)
esophagus : n, 식도
esoteric : a, 소수의학자에게만전수되는, 비전의, 비교의, 비밀의
ESP : x, extrasensory perception, (심)초감각적감지, 영감
espadrille : n, 에스파드리유(끈을 발목에 감고 신는 캔버스화)
espalier : n, 과수(나무)를받치는시렁
Espana : n, 스페인
esparto : x, (식)아프리카 수염새
especial : a, 특별한, 각별한
especially : ad, 특히, 유달리, 유별나게
Esperantist : n, 에스페란토어 학자
Esperanto : n, 에스페란토
espial : n, 정찰, 감시
espiegle : a, (F)장난꾸러기의
espionage : n, 탐색, 간첩행위, 간첩을 씀
esplanade : n, (특히바닷가, 호숫가따위의)산책길, (요새와 시내 민가 사이를 격리하는)공터
espousal : n, 약혼, 혼례, 채용, 지지, 옹호
espouse : vt, ~와결혼하다, 시집보내다, 채용하다, (의견, 학설 등을)지지하다
espresso : n, 에스프레소 커피(분말에 스팀을 통과시켜 만듦), 에스프레소 커피점
espress wagon : x, 지급 수용용 왜건
esprit : n, 정신, 에스프리, 재치
esprit d'escalier : x, =wit on the staircase 사후의 명안
esprit de corps : x, 단체 정신, 단결심(애교심 따위)
esprit fort : n, (F)의지가 강한 사람, 자유 사상가
espy : vt, 찾아내다, 발견하다, 알아채다
Esq, : x, Esquire
esque : suf, (...식의, ...모양의)의 뜻
Esquimau : n, =ESKIMO
esquire : n, 님, 귀하
esquisse : n, (F)(미)에스키스, 화고, (설계도의)초벌 그림
ESR : x, electron spin resonance
ESRO : x, European Space Research Organization 유럽 우주 연구 기구
ess : n, S자
ess : suf, 여성 명사를 만듦
Ess, : x, Essex
ESSA : , Environmental Science Services Administration
essay : n, vt, vi, 수필, 소론, 시론, 평론, 시도, 시도하다, 시험하다
essayette : n, 짧은수필
essay examination : x, 논문(논술)시험
essayist : n, 수필가, 평론가
essayistic : a, 수필(가)의, 수필조의, 설명적인, 개인 색체가 짙은
esse : n, (철)존재, 실재
essence : n, 본질, 정수, 실체, 에센스, 엑스, 정, 향수
Essene : n, 에세네파(고대 유대의 금욕, 신비주의의 한 파)의 신도
essential : a, n, 본질적인, 실질의, 필수의, 정수의, 에센스의, 기본의, 본질, 요점, 요소
essential amino acid : x, (화)필수 아미노산
essentialism : n, (미)(교육)본질주의, (철)실재론, 본질주의
essentiality : n, 본성, 본질, 요점, 골자
essentially : ad, 본질적으로
essential oil : x, (식물성)정유, 방향유(향수의 원료)
essentic : a, 감정을 밖으로 나타내는
Essex : n, 영국남동부의주
Essie : n, 여자 이름
Esst African Community : x, 동아프리카 공동체
est : x, 심신 통일 훈련(집단 감수성 훈련의 하나)
EST : x, Eastern standard time(미)동부 표준시, electroshock therapy
est : suf, 형용사, 부사의 최상급 어미
est, : x, established, estate, estimated, estuary
establish : 설립하다, 확립하다, 제정하다, (사람의)기반을 잡게하다, (지위에)앉히다, 개업시키다, 안정된  지위에 놓이게 하다, 정하다, 인정하다, 입증하다, 확증하다
established : a, 확립된, 확정된, 만성의
Established Church : x, 영국 국교회
establishmentarian : n, a, 영국국교회(의), 그 신봉자(의), 체제주의자(의), 체제파(의)
estaminet : n, 작은 술집, 작은 카페
estate : 재산, 유산, 소유권, 재산권, 토지, 소유지, 살림살이, 처지, 사회적  지위, 사회적 신분, (정치, 사회적)계급(personal  estate 동산, the 
estate agent : x, 부동산관리인, 중개업자
estate car : x, =STATION WAGON
estated : a, 재산이 있는
Estates General : x, =STATES GENERAL
estate tax : x, 상속세
estavlishment : n, 설립, 설정, 설치, 확립, 설립물, 시설, 세대, 조직, 제도, 회사, 점포, 고정 수입
esteem : vt, n, 존경하다, 존중하다, 귀중히 여기다, ~이라고 생각하다, 간주하다, 존경, 존중(hold in esteem 존경하다)
ester : n, 에스테르
Esth, : x, (성)Esther, Esthonia
Esther : n, 여자이름, 에스더서
esthesia : n, 감각, 지각, 감수성
esthesiophysiology : n, 감각 생리학
esthete : n, =AESTHETE
esthetic : n, =AESTHETICS
Esthonia(n) : n, a, =ESTONIA(N)
estimable : a, 존경할만한, 평가할 수 있는, 어림할 수 있는
estimate : vt, vi, n, 평가하다, 어림하다, 견적서를 작성하다, 개산하다, 견적하다, 평가, 견적서, 개산, 판단
estimated : a, 견적의, 추측의
estimation : n, 판단, 의견, 평가, 존중, 견적, 개산
estimative : a, 평가할 수 있는, 평가의, 견적의
estimator : n, 평가자, 견적인
Estonia : n, 에스토니아(발트해에 면한 소비에트 연방의 한 공화국)
Estonian : a, n, 에스토니아(사람, 말)의, 에스토니아 사람, 에스토니아 말
estop : vt, (법)금반언으로 금지하다
estoppage : n, (법)금반언에 의한 저지
estoppel : n, (법)금반언, 에스토펠(먼저 한 주장에 반대되는 진술을 뒤에 하는 것을 금지함)
estovers : n, (법)필요물, 별거 수당
estrade : n, 교단, 단
estrange : vt, 소원하게하다, 멀리하다
estranged : a, 소원해진, 사이가 틀어진
estrangement : n, 소원, 이간, 불화
estray : n, (법)(주인을 알 수 없는)길 잃은 가축(말, 양 등)
estreat : n, vt, (영법)(벌금, 고료 선고 등의)재판 기록의 부본(초본), (벌금 등을)징수하다
estriol : n, 에스트리올(여성호르몬의일종)
estrogen : n, 발정호르몬
estrogenic : a, (생화)발정을 촉진하는, 발정성의
Estron : n, 에스트론(초산 섬유소 에스테르로 만드는 반합성 섬유, 상표명)
estrone : n, 에스트론(여성호르몬의 일종)
estrous : a, (동)발정(기)의
estrous cycle : x, (동)발정기
estrus : n, 발정기(estrus cycle 성주기)
estuarine : a, 강어귀(지역)의, 하구에 형성된, 하구(지역)에 알맞은
estuary : n, 강어귀, 내포
esurience : n, 굶주림, 게걸, 탐욕
esurient : a, (고)게걸스러운, 탐욕스러운
ESV : x, experimental safety vehicle 안전 실험차
Et : x, (화)ethyl
ET : x, Eastern Time, Ester term, extraterrestrial
et : suf, 주로 프랑스어계의 지소 어미
eta : n, 그리스어알파벳의일곱째글자
ETA : x, estimated time of arrival 도착 예정 시각
et al, : x, dt alibi
eta meson : x, (물)에타 중간자
etc, : x, =ET CETERA
et cetera : x, and the rest 따위
etceteras : n, 기타 여러가지(사람), 기타 등등
etch : vt, vi, ...에 에칭하다..., 을식각하다, 식각법을 행하다
etcher : n, (에칭에 의한)동판 화공, 에칭(동판)화가
etching : n, 식각법, 에칭, 부식 동판
etching needle (point) : x, 에칭용 조각침
etch pit : x, (천)에치 피트(화성 표면에 보이는 조그마한 구덩이)
ETD : x, estimatec time of departure 출발 예정 시각
Eteocles : n, (그신)에테오클레스
eternal : a, 영원한, 영구한, 불멸의, 끝없는, 변함없는, 평상시의, 예의
Eternal City : x, 불멸의 도읍(로마)
eternalize : vt, =ETERNIZE
eternally : ad, 영원히, 끝없이, 끊임없이
eternal recurrence : x, (철)(니체 철학의)영겁 회귀
eternal triangle : x, (남녀의)삼각 관계
eternity : n, 영원, 영구, 내세
eternity ring : x, 이터니티링(보석을 돌아가며 틈 없이 박은 반지, 영원을 상징)
eternization : n, 
eternize : vt, 불멸하게하다, 영원히 전하다
etesian : a, (지중해 동부의 바람이)해마다의, 계절적으로 부는
Etesian winds : x, 계절풍
eth : n, =EDH
eth : suf, 동사의 제3인칭
eth, : x, ethical, ethics
Eth, : x, Ethiopia
ethacrynic acid : x, (약)에타크린산
ethambutol : n, (약)에탐부톨(합성 항결핵약)
ethane : n, 에탄(석유에서나는가스)
ethanol : n, 에탄올(알코올을 말함)
Ethel : n, 여자 이름
Ethelbert : n, 남자 이름
ethene : n, =ETHYLENE
ethephon : n, 에테폰(식물 생장 조절제)
ether : n, 에테르, 정기, 하늘
ethereal : a, 공기와같은, 가벼운, 영기의, 영묘한, 천상의, 상공의, 에테르같은
ethereality : n, 에테르 같은 성질, 영묘한 것, 영성
etherealization : n, 에테르화, 기화, 영화
etherealize : vt, 영화하다, 에테르화하다
ethereal oil : x, 정유, 휘발유
etherial : a, =ETHEREAL
etherification : n, 
etherify : vt, (알코올 등을)에테르화하다
etherization : n, (의)에테르 마취(법(상태))
etherize : vt, 에테르마취를시행하다, 에테르화하다
ethic : a, n, =ETHICAL, =ETHICS
ethical : a, 도덕상의, 윤리적인(ethical drug 처방약(의사의 처방전 없이는 시판을 허용치 않는 약제)
ethical dative : x, (문법)심성적 여격
ethically : ad, 윤리(학)적으로, (문장 전체를 수식하여)윤리적으로는, 윤리적으로 말하면
ethicist : n, 윤리학자, 도학자, 도덕가
ethicize : vt, 윤리적이 되게 하다, ...에 윤리성을 부여하다
ethics : n, 윤리학, 도덕
Ethiop : n, a, (고)=ETHIOPIAN
Ethiopia : n, 에티오피아
Ethiopian : a, n, (고대)에티오피아의, (고대)에티오피아 사람의, (고대)에티오피아 사람
Ethiopic : a, n, (고대)에티오피아의, (고대)에티오피아말
ethmoid : n, a, 사골(의)
ethn, : x, ethnology
ethnarch : n, (사)(비잔틴제국 등 한 지방(민족)의)행정 장관
ethnarchy : n, ethnarch의 통치(지위, 직권)
ethnic : a, 인종의, 민족의, 인종학의, 이교의(edthnic group 인종, 민족)
ethnical : =ETHNIC 1, 2, 
ethnically : ad, 민족(학)적으로, (문장 전체를 수식하여)민족(학)적으로는(으로 말하면)
ethnic group : x, (사회)인종 집단
ethnicism : n, 민족성 중시주의, 민족 분리주의
ethnicon : n, 종족(부족, 인종, 민족, 국민)의 명칭
ethnic purity : x, (지역, 집단 내의 소수 민족의)민족적 순수성
ethnics : n, =ETHNOLOGY
ethno- : x, (연결형)(인종, 민족)
ethnocentric : a, 자민족중심주의의
ethnocentrism : n, (사회)자기 민족 중심 주의
ethnocide : n, (문화적 동화 정책으로서)특정 민족 집단의 문화 파괴(말살)
ethnogeny : n, dl인종 기원학, 민족 발생학
ethnographer : a, 민족지적인, 민족지학상의
ethnographic : a, 
ethnography : n, 민족지, (특히 기술적)민족지학
ethnol, : x, ethnologic(al), ethnology
ethnolinguistics : n, 민족 언어학
ethnologic : a, 민족학의, 인종학적인
ethnology : n, 인종학
ethnologyical : a, 
ethnomusicology : n, 민족 음악학, 음악 인류학
ethnopsychology : n, 민족 심리학
ethnos : n, =ETHNIC GROUP
ethnoscience : n, 민족 과학, 민족지학
ethology : n, 인성학, 동물행동학
ethos : n, (시대, 민족, 사회, 종교단체따위의, 독특한)기풍, 민족정신, (예술작품의)기품
ethyl : n, 에틸
ethyl alcohol : x, 에틸알코올, 주정
ethylate : n, vt, vi, (화)에틸레이트(에틸알코올의 금속 유도체), 에틸화하다
ethylation : n, (화)에틸화
ethylene : n, 에틸렌
ethylene glycol : x, (화)에틸렌 글리콜(부동액으로 쓰임)
etic : a, 에틱한
etier : n, (F)에트리에(등반용 짧은 줄사다리)
etiogical : a, 원인을 밝히는, 인과 관계학의, 병인학의
etiolate : vt, (식물 등을)(일광을 차단하여)연푸르게 하다, 누렇게 뜨게 하다
etiolation : n, (식)(광선 부족에 의한)황화, (피부 등이)창백해지기
etiology : n, 병인학, 원인학
etiopathogenesis : n, (의)원인 병리론
etiquette : n, 에티켓, 예의, 예법, 관례(medical etiquette 의사들의 불문율)
Etna : n, Sicily섬의화산, 알코올로 물 끓이는 기구
ETO : x, European Theater of Operations
Eton : n, 런던 서쪽의 도시
Eton blue : x, 밝은 청록색
Eton collar : x, (웃옷의 깃에 다는)폭넓은 칼라
Eton College : x, 이튼교
Eton crop : x, (여자 머리의)치켜 깎은 단발
Etonian : a, n, Eton의 Eton 교 학생)
Eton jacket (coat) : x, 이튼교(식)의 짧은 웃옷
Etrog : n, 이트로그상
Etruria : n, 이탈리아 서부에 있던 옛 나라
Etruscan : a, n, Etruria의 , Etruria 사람
ETS : x, (미)Educational Testing Service
ETS : x, (미군속)만기 제대하다
et seq, : x, ...이하 참조
et seqq, : x, et sequentes
Etta : n, 여자 이름
ette : suf, 지소어미, 여성형 명사 어미, (상)(모조..., ...대용품)의 뜻
etude : n, (회화, 조각따위의)습작, 연습곡, 에튀드
etui, : n, 방물 상자, 손그릇
ETV : x, educational television
ety, : x, etymology
etym, : x, etymological, etymology
etymological : a, 어원의, 어원(학)상의
etymologist : n, 어원학자, 어원 연구가
etymologize : vt, vi, ...의 어원을 조사하다, 어원(학)을 연구하다, 어원적으로 정의하다
etymology : n, 어원학
etymon : n, 어근, 말의원형
Eu : x, (화)europium
eu- : x, (연결형)(좋은...)의 뜻
eucaine : n, (화)오이카인(국부마취제)
eucalyptus : n, 유칼리나무(높이 90m, 오스트레일리다 원산)
eucalyptus oil : x, 유칼리 기름(의약, 향수용)
eucaryote : n, (생)유핵세포, 진핵생물
Eucharist : n, 성체성사, 성체용의, 빵과 포도주
Eucharistic : a, 성만찬의, 성체의
euchlorine : n, (화)유클로린(염소와 이산화염소의 폭발성 혼합기체)
euchre : n, vt, 유커(카드놀이의일종, 유커에서 지게 하다, 책략으로 이기다, 앞지르다
euchromatin : n, (생)진정염색질
Euclid : n, 그리스의 수학자, 유클리드 기하학
Euclidean : a, 유클리드의, (유클리드)기하학의
Euclidean geometry : x, 유클리드 기하학
eudaemonia : n, 행복, 복리
eudaemonics : n, 행복론, =EUDAEMONISM
eudaemonism : n, (철, 윤)행복주의, 행복설
eudiometer : n, 유디오미터(주로공기중의산소량을측정함)
Eugene : n, 남자 이름
eugenic : a, 우생학적인
eugenicist : n, 우생학자
eugenics : n, (좋은 태생의)의 뜻에서, 우생학, 인종 개량법
euglena : n, (동)유글레나, 연두벌레
euglenoid : a, n, (생)유글레나 무리의(각종 편모층)
eulogist : n, 찬사를 올리는 사람, 찬미자, 예찬자, 칭찬자
eulogistic : a, 찬미의, 찬양하는, eulogistically, ad
eulogium : n, =EULOGY
eulogize : vt, 칭찬하다
eulogy : n, 칭찬, 찬양, 찬사
Eumenides : n, (그신)=FURIES
Eunice : n, 여자 이름
eunuch : n, 거세된 남자, 환관, 내시, 독신자
eupepsia : n, 소화양호
eupeptic : a, 소화양호의, 소화를 돕는
euphem, : x, euphemism, duphemistic(ally)
Euphemia : n, 여자 이름
euphemism : n, 완곡어법
euphemist : n, 완곡한 말을 (잘)쓰는 사람
euphemistic : a, 완곡 어법의, 완곡한, euphemistically, ad
euphemize : vt, vi, 완곡하게 표현하다(말하다, 쓰다)
euphenics : n, 인간 개조학
euphobia : n, (익살)길보(낭보)공포증(뒤따라 흉보가 온다고 해서)
euphonic : a, 음편의, 발음 편의상의=EUPHONIOU
euphonical : a, (고)=EUPHONIC
euphonious : a, 음조가좋은, 듣기 좋은
euphonium : n, 유포늄(튜바 비슷한 놋쇠 악기)
euphonize : vt, 음조(어조)를 좋게 하다
euphony : n, 듣기좋은음조, 어조가 좋음, 음편
euphorbia : n, 등대풀(의무리)
euphoria : n, 행복감, 건강, (마약에 의한)도취감
euphoriant : a, n, 다행중의, 행복감을 주는, (약)도취약
euphorigenic : a, 행복감(도취감)을 일으키는
euphory : n, =EUPHORIA
euphrasy : n, (식)좁쌀풀
Euphrates : n, Mesopotamia지방의강
Euphrosyne : n, 기쁨의여신
euphuism : n, 과식체, 미문체
euphuistic : a, 미사 여구를 좋아하는, 과식체의, euphuistically, ad
eupn(o)ea : n, (병리)정상 호흡
Eur, : x, Europe, European
Eur- : x, (연결형)(유럽의, 유럽과...의)의 뜻, (유럽 금융 시장의)의 뜻, (유럽 경제 공동체의)의 뜻
Eurafrican : a, 유라프리카(혼혈)의
Eurailpass : n, 유럽철도주유권
Euramerican : a, 구미(공통)의
Eurasia : n, 유라시아, 구아
Euratom : n, 유럽 원자력 공동체, 유라톰
EURCO : x, European Composite Unit 유럽 계산 단위
eureka : int, (익살)알았다, 됐다, 미국 California주의 표어
eureka : int, n, 알았다!, 발견의 기쁨의 소리
eurhythmics : n, 리듬체조
Euripides : n, 그리스의비극시인
Euro- : x, (연결형)=EUR-
EuroAmerican : a, =EURAMERICAN
Eurobank : n, 유로뱅크(유로 시장에서 거래하는 유럽의 국제 은행)
Eurobond : n, 유로채
Eurocentric : a, 유럽(인)중심의
Eurocheque : n, (영)유로체크(유럽에서 통용되는 크레디트 카드)
Euroclear : n, 유럽 시장의 어음 교환소
Eurocommunism : n, 유로코뮤니즘(서유럽 공산당의 자주, 자유, 민주 노선)
Eurocracy : n, (집합적)유럽 공동 시장 행정관
Eurocrat : n, 유럽공동체의행정관
Eurocredit : n, 유로크레디트(유로뱅크에 의한 대출)
Eurocurrency : n, 유로머니(유럽시장에서 쓰이는 각국의 통화)
Eurocurrency market : x, 유로머니 시장
Eurodollars : n, 유로달러(유럽에서 국제 결제에 쓰이는 US dollar)
Eurogroup : n, 유로그룹(프랑스와 아이슬란드를 제외한 NATO 국방 장관 그룹)
Euromarket : n, =Aommon Market
Euromoney : n, (경)=EUROCURRENCY
Euronet : n, 유로네트
Europa : n, 유로파(Phoenicia의왕녀)
Europabus : n, 유로파버스(유럽 도시간의 장거리 버스)
europe : n, 유럽(주)
european : a, n, 유럽의, 유럽사람(의)
european common market : x, 유럽공동시장
european community : x, 유럽공동체
european defense community : x, 유럽방위공동체
european economic community : x, 유럽경제공동체
european free trade association : x, 유럽자유무역연합
Europeanism : n, 유럽 주의, 유럽 정신, (풍습 등의)유럽풍, 유럽 공동시장주의
Europeanization : n, 
Europeanize : vt, 유럽풍으로 하다
European Monetary System : x, 유럽 통화 제도
European Parliament : x, 유럽 의회(EC각국 국민이 직접 선출한 의원으로 구성)
European plan : x, 유럽식(호텔에서 방값과 식사 대금을 따로 곗산하는 것)
european political community : x, 유럽정치공동체
European Recovery Program : x, 미국 국무장관 Marshall제안의 유럽 부흥 계획
European roliticsal Community : x, 유럽 정치 공동체
europium : n, 유로퓸(희토류원소)
Europlug : n, (전)유로플러그(유럽 각국의 각종 소켓에 통용되는 플러그)
Europocentric : a, 유럽(인) 중심(주의)의
Europort : n, 유로포트(유럽 공동체의 수출입항)
eurosat : n, 유러샛(유럽통신위성회사)
eurospace : n, 유러스페이스(유럽우주산업연합회)
Eurovision : n, 유러비젼(서유럽 우주 산업 연합회)
Eurydice : n, (그신)에우리디케
eurythmic : a, (음악, 무용이)경쾌한 리듬의, 율동적인
eurythmics : n, 율동 체조
eurythmy : n, 율동적인 운동, 조화된(균형 잡힌)동작
eusol : n, (약)(표백분과 붕산을 섞은 외상 소독액)
Eustace : n, 남자 이름
Eustachian tube : n, 유스타키관, 구씨관
eutectic : a, (합금, 용액이)낮은 온도에서 융해하는, 공용의
Euterpe : n, 음악의여신
euthanasia : n, (불치의 병고로 부터 구원하는)안락사
euthanize : vt, 안락사시키다
euthenics : n, 환경우생학, 생활개선학
eutrophic : a, (생태)(호소, 하천이)부영양의
eutrophicate : vi, (생태)(호수 등이)부영양화되다, (처리 폐수 등으로)영양 오염되다
eutrophication : n, (호수의)부영양화, 영양 오염, 부영양수
eutrophy : n, 영양양호, (하천 등의)부영양
eV : x, electron volt(s)
Eva : n, 여자 이름
EVA : x, extravehicular activity
evac, : x, evacuation
evacuant : a, n, (의)배설을 촉진하는, 배설 촉진제, 하제
evacuate : vt, vi, 비우다, 배설하다, 명도하다, 철퇴하다, 철병하다, 퇴거시키다
evacuation : n, 명도, 비움, 소개, 피난, 배설, 배출, (군)철수
evacuee : n, 피난자, 소개자
evade : vt, ~을면하다, ~으로부터 교묘하게 빠져 나가다, 둘러대어 모면하다
evaluate : vt, 평가하다, ~의 값을 구하다
evaluation : n, 평가, 사정, (수)값을구함
evanesce : vi, (점차로)사라지다
evanescence : n, (문어)소실, 덧없음
evanescent : a, (문어)(점점)사라져 가는, 순간의, 덧없는, 지극히 미미한, (식)곧 시들어 떨어지는, (수)무한소의
evangel : n, 복음, (성서의)복음서
evangelic : a, n, 복음의, 전도의, 복음주의자
evangelical : a, n, 복음(서)의, 복음 전도의, 복음주의의, =EVANGELISTIC2, 복음주의자, 복음파의 사람
Evangelicalism : n, 복음주의
Evangeline : n, 여자 이름
evangelism : n, 복음전도(주의)
evangelist : n, 복음전도자, 신약 복음서의 저자
evangelistic : a, 복음서저자의, 복음 전도자의
evangelization : n, 복음 전도
evangelize : vt, vi, 복음을전하다, 전도하다
evanish : vi, (문어, 시)소실(소멸)하다
evaporable : a, 증발하기 쉬운
evaporate : vi, vt, 증발하다, 김을 내다, 사라져 없어지다, 증발시키다
evaporated milk : x, 무가당 연유
evaporating dish (basin) : x, (화)증발 접시
evaporation : n, 
evaporative : a, 증발의, 증발을 일으키는, 증발에 의한
evaporator : n, 증발
evaporimeter : n, 증발계
evapotranspiration : n, (기상)증발산
evasion : n, 도피, 회피, 둘러댐
evasive : a, 포착하기어려운, 회피적인, 둘러대(기 잘하)는
evasive action : x, (전시에 선박, 항공기가 취하는)회피 행동
evasively : ad, 
evasiveness : n, 회피적임, 파악하기 어려움, 애매함
Eve : n, 이브, 하와(adam의 아내, 신이 창조한 여자)(daughter of eve 여자라는 것)
eve : n, 전야(제), 명절의 전날 밤, (사건등의)직전, 저녁, 밤
Eve's pudding : x, 맨 밑층이 과일로 되어 있는 스펀지 케이크
evection : n, (천)출차(태양 인력에 의한 달 운행의 주기적 차이)
Evelina : n, 여자 이름
Eveline : n, 여자 이름
Evelyn : n, 여자 이름, 남자 이름
even : a, ad, vt, 평평한, 수평의, 한결같은, 규칙적인, 공평한, 침착한, 평정한
evenement : n, (F)사건, (특히)사회적, 정치적 대사건
evenfall : n, 황혼
evenhanded : a, 공평한
evening : n, 저녁, 해질녁, 밤, 오후
evening class : x, 야간 학급(수업), 야학
evening dress : x, 야회복, 이브닝드레스
evening glow : x, 저녁놀
evening gown : x, 여성용야회복
evening paper : x, 석간
evening party : x, 야회
Evening Prayer : x, (영국 국교회의)저녁 기도
evening primrose : x, (금)달맞이꽃
evenings : ad, 매일저녁
evening school : x, =NIGHT SCHOOL
evening star : x, 개밥바라기, 금성, 태백성
evenly : ad, 고르게, 평탄하게, 평등하게, 공평하게
evenminded : a, 마음이 평온한, 차분한
even money : x, 대등하게 태우는 돈
evenness : n, 반반함, 평등, 균등성, 공평, 침착
evens : ad, a, n, (영구)평등(동등)하게(한), =EVEN MONEY
evensong : n, (영국국교회의)만도
even steven : x, (구)대등한, 동점인, 비긴
event : n, 사건, 큰 사건, 경과, 결과, 경우, 종목, 시합(at all events 좌우간, 하여튼, in any event 무슨 일이 있어도, 하여튼)
eventempered : a, 마음이 안정된, 온화한 성질의, 침착한
eventful : a, 사건(파란)많은, 다사한, (사건 등이)중대한, eventfully, ad, eventfulness, n
eventide : n, 땅거미질때
eventless : a, 사건 없는, 평온한
eventual : a, 종국의, (경우에 따라서는)일어날 수도 있는, 있을 수 있는
eventuality : n, 예측못할사건, 만일의 경우, 우발성
eventually : ad, 결국은, 필경에는
eventuate : vi, 결국~이되다, 일어나다, 생기다
ever : ad, 언젠가, 일찌기, 언제나, 도대체, 적어도(than erer 지금 까지보다 점점 더, ever and anon, erer since 그 후 줄곧)
Everard : n, 남자 이름
Everest : n, Mount히말라야 산맥 중의 세계 최고봉
Everest mount : x, 히말라야산맥중의세계최고봉
Everett : n, 남자 이름
everglade : n, 습지대(the Everglades, Florida 남부의 소택지)
Everglade State : x, 미국 Florida주의 속칭
evergreen : a, n, 상록의, 상록수(Evergeen State 미국 Washington주의 속칭), 영원, 영겹(eternity)
Evergreen State : x, 미국 Washington주의 속칭
everlasting : a, n, 영원한, 영구한, 끝없는, 변함없는, 지루한, 영원, 영겁
everlasting flower : x, (식)떡쑥 무리
everlastingly : ad, 영구히, 끝없이
evermore : ad, 언제나, 항상, 영원히, 영구히(for evermore 영구히)
everpresent : a, 항상 존재하는
everready : a, n, 항상 준비되어 있는, 상비군
eversible : a, (밖으로)뒤집을 수 있는, (기관 등을)외번할 수 있는
eversion : n, (의)(눈꺼풀 등의)외전, 밖으로 뒤집기, (기관의)외번
evert : vt, (눈꺼풀따위를)뒤집다, 외번시키다
evertor : n, 외전근
every : a, 모든, 일체의, 어느~이나 다, 각~마다, 때때로, 가끔
everybody : pron, 누구나, 각사람(모두)
everyday : a, 매일의, 일상의(everyday clothes 평상복)
Everyman : n, 보통사람(15세기의 영국의 권선 징악극 Everyman의 주인공에서)
everyone : pron, everybody
everyplace : ad, (미)=EVERYWHERE
everything : pron, 무엇이든지모두, 만사, 가장 소중한 것
everyway : ad, 어느점으로보아도
everywhere : ad, 어디에나, 도처에
Everywoman : n, 전형적인 여성, 여자다운 여자
evg, : x, evening
Evgeni : n, 남장 이름
evict : vt, 퇴거시키다, 쫓아내다, 되찾다
evictee : n, 퇴거당한 사람
eviction : n, 퇴거
eviction order : x, 퇴거 명령
evictor : n, 퇴거시키는 사람
evidence : n, vt, 증거, 증언, 징후(give evidence of ...의 형적을 보이다, give evidenc 증언하다), 증명하다, 증언하다
evident : a, 명백한, 뚜렷한
evidential : a, 증거상의, 증거가되는
evidentiary : a, =EVIDENTIAL
evidently : ad, 분명히, 명백히, 보매, 아무래도(...듯하다)
evil : a, n, ad, 나쁜, 사악한, 해로운, 불운한, 불길한, 악, 악행, 해악, 병, 나쁘게, 사악하게, 해롭게, 불행하게
evildisposed : a, 질이나쁜
evildoer : n, 악인
evildoing : n, 나쁜짓, 악행
evil eye : x, 악의에 찬 눈초리
evileyed : a, 악마의 눈을 한, 독기 서린 눈의
evillooking : a, 인상이 나쁜
evilly : ad, 간악하게, 융악하게
evilminded : a, 흑심이있는, 사악한
evilness : n, 악, 불선, 사악
Evil One : x, 마왕
evilstarred : a, 운수 나쁜, 불행한
eviltempered : a, 몹시 언짢은
evince : vt, (명백히)나타내다
evincive : a, 명시적인, 증명하는
evirate : vt, 거세하다, 연약하게 하다
eviscerate : vt, 창자를끄집어내다, 골자를 빼버리다
evisceration : n, 내장 적출, 골자를 빼버림
evitable : a, 피할수있는
evocation : n, (강신, 영혼의)불러냄, 초혼, (기억 등의)환기, (법)(상급 법원으로의)소권이송
evocative : a, (...을)환기시키는
evocator : n, EVOKE하는 사람(것), 영매, (발생)환기 인자
evoke : vt, (영, 기억, 감정따위를)불러일으키다, 환기하다
evolute : a, n, vi, vt, (수)축폐한, (수)축폐선, 진화(발전)하다(시키다)
evolution : n, (생물의)진화, (사건, 의론 따위의)전개, 발전, (빛, 열 따위의)발생, 방출, 개방, 선회
evolutional : a, =EVOLUTIONARY, evolutionally, ad
evolutionary : a, 발달의, 진화의, 진화적인
evolutionism : n, 진화론
evolutionistic : a, 진화론자의, 진화론적인
evolutive : a, 진화의(하는)
evolve : vi, vt, 전개하다, 진화하다, 진화시키다, 발달하다, 발전시키다, (빛, 열 따위를)발생하다
EVP : x, executive vice president 전무 이사
EVR : x, electronic video recorder
evulsion : n, 뽑아냄, 빼냄
evzone : n, (그리스의)정예 보병
EW : x, electronic warfare, enlisted woman
ewe : n, 암양
ewenecked : a, 목이 가늘고 아래로 처진(말, 개)
ewer : n, (주둥이가넓은)물병
ewigkeit : n, (G)영원, (익살)간데없이, 허공으로
ex : prep, ...으로부터, 본선 인도, ...때문에
ex, g(r), : x, exempli gratia
exacerbate : vt, 악화시키다, 분격시키다
exacerbation : n, 격화, 악화, 분노
exact : a, vt, 정확한, 엄밀한, 정밀한, 꼼꼼한, 엄격한, 까다로운, 엄하게 요구하다, 강요하다
exacta : n, (미)쌍승식(경마의 1, 2착을 도착 순서대로 맞히는 내기)
exactable : a, 강요할 수 있는, 강제로 거두어들일 수 있는
exacting : a, 강제로 징수하는, 가혹한, 엄격한, (일이)고된, 힘드는, 쓰라린, exactingly, ad
exaction : n, 강청, 강요, 강제 징수, 가혹한 요구, 강제 징수금, 가혹한 세금
exactitude : n, 정확, 정밀, 엄격함, 꼼꼼함
exactly : ad, 정확하게, 꼭, 바로 그대로, 조금도 틀림없이, 그렇소, 바로 그렇습니다
exactor : n, 강요하는 사람, (특히)가혹하게 징수하는 사람
exact science : x, 정밀 과학(수학, 물리학 따위)
exact science : n, 정밀 과학(수학, 물리학 등)
exaggerate : vt, 과장하다, 허풍떨다
exaggerated : a, 과장된, 떠벌린, 비정상적으로 확장된, exaggeratedly, ad
exaggeration : n, 과장, 과장적 표헌
exaggerative : a, 과장적인, 침소 봉대의, exaggeratively, ad
exaggerator : n, 과장해서 말하는 사람, 과장적인 것
exalt : vt, (신분, 관직, 품위, 명예따위를)높이다, 의기 양양하게 만들다, 치살리다, (빛깔을)짙게 하다
exaltation : n, 높임, 승진
exalted : a, 지위(신분)가 높은, 고귀한, 고양된, 고상한, 숭고한, 기뻐 날뛰는
exam : n, (구)시험
exam, : x, examination, examined
examinant : n, 시험관, 심사원, 심사받는 사람
examination : n, 시험, 검사, 조사, 심사, 심문, 심리
examination paper : x, 시험용지, 시험문제
examinatorial : a, 시험관의, 고시 위원의, 심사원의
examine : vt, vi, 조사하다, 검사하다, 검정하다, 심사하다, 시험하다, 심문하다, 진찰하다, 조사하다
examinee : n, 수험자
examineinchief : vt, (법)직접 심문하다
examiner : n, 시험관, 검사관, 심사원, (법)증인 심문관
example : n, 실례, 보기, 견본, 표본, 모범, 본보기, 본때, 경계
exanimate : a, 죽은 활기가 없는, 낙담한
ex animo : ad, a, (L)충심으로부터(의), 성심 성으로(의)
exanthem : n, (병리)발진
exanthemata : n, 발진, 피진
exarch : n, (비잔틴 제국의)태수, 총독
exarchate : n, EXARCH의 직(권한, 지위), 그 관할구
exasperate : vt, 격노케하다, 감정을 자극하다, 악화시키다, 더하게 하다
exasperating : a, 분통이 터지는, 화가 나는
exasperatingly : ad, 분통이 터지게, 화가 나게
exasperation : n, 격분, 분노, 격화, 악화
exc, : x, excellent, except(ed), exception
Exc, : x, Excellency
Excalibur : n, Athur왕의 마법의검
excathedra : , 권위를 가지고있는, 권위있는
ex cathedre : x, 권위를가지고, 권위있는
excavate : vt, 파다, 도려내다, 발굴하다
excavation : n, 굴 파기, 개착 2굴, 구덩이, (고고)발굴, 발굴물, 유적
excavator : n, 굴착자(기), (치과용)후벼내는 기구, 발굴자
exceed : vt, vi, (한도를)넘다, 초과하다, ~보다 낫다, ~을 능가하다
exceeding : a, 엄청난, 대단한, 굉장한
exceedingly : ad, 매우, 대단히, 굉장히, 엄청나게
excel : vt, vi, 능가하다, 뛰어나다
excellence : n, 우수, 탁월, 장점, 미점
Excellency : n, 장관, 대사등에대한존칭
excellent : a, 우수한, 탁월한
excelsior : int, 더 한층높이!, 오직향상!
Excelsior State : x, New York주의 속칭
excentric : a, =eccentric
except : vt, vt, prep, 제외하다, 반대하다, 기피하다, ~을 제외하고는, ~이외에는
excepted : a, 제외되어, 예외인
excepting : prep, ...을 빼고, ...말고는, ...을 제외하면
exception : 예외, 제외, 이의take exception to ...에 반대하다, with the exception of ...을 제외하고는), 
exceptional : a, 예외적인, 특별한, 보통이 아닌(exception al child(심신장애로인한)비정상아)
exceptional child : x, (교육)특수 아동(비범하거나 심신 장애로 특수 교육이 필요한
exceptionally : ad, 예외적으로, 특별히, 유난히, 매우
exceptionless : a, 예외(이의)없는
exceptive : a, 제외의, 예외적인
excerpt : n, vt, 발췌, 인용구, 초록, 발췌 인쇄물, 발췌하다, 인용하다
excerption : n, 발췌, 발췌록
excess : n, 과도, 과다, 과잉, 초과, 초과량, 부절제, 지나침, 난폭, 폭음폭식(excess of imports over exports 수입 초과)
excess baggage : x, 제한 초과 수하물
excess charge : x, 주차 시간 초과 요금
excessdemand inflation : x, 수요인플레
excess fare : x, 철도의 거리 초과 요금, 초과 요금
excessive : a, 과도한, 극단적인, 터무니없는
excess luggage : x, =EXCESS BAGGAGE
excess postage : x, 우표 부족 요금
excessprofits tax : x, 초과 이득세
excess reserves : x, (은행)초과 준비금
excess supply : x, (경)공급 초과(과잉)
exch, : x, exchange, exchequer
exchange : vt, vi, n, 교환하다, 주고받다, 환전하다, 환전할 수 있다, 교환하다, 교환, 주고받음, 환전, 어음교환고, 거래소, 전화 교환국
exchangeability : n, 교환(교역)할 수 있음, 교환 가치
exchangeable : a, 교환(교역)할 수 있는
exchange bank : x, 외환 은행
exchange control : x, 환관리
exchange force : x, (물)교환력
exchange market : x, 외환 시장
exchange order : x, 항공표 인환증(항공사가 발행하는)
exchange parity : x, 외환 평가
exchange professor : x, 교환 교수
exchange rate : x, 환율
exchange reaction : x, (물)교환 반응
exchange student : x, 교환학생
exchange ticket : x, 상품권
exchange value : x, (경)교환 가치
exchequer : n, 국고, (개인의)재원, 소득, 재무성
exchequer bill : x, 재무성증권
exchequer bond : x, 국고채권
excisable : a, 소비세를 부과할, 과세하여야 할
excisable : a, 절제할 수 있는
excise : n, vt, 물품세, 물품세를 부과하다, 엄청나게 받다, 청구하다, 잘라내다
excise laws : x, (미)주류 제조 판매 규제법, 소비세법
exciseman : n, (영)(간접세)징수원(담당관)
excision : n, 절단, 절제, 삭제, 파문
excitability : n, 격하기 쉬운 성질, 흥분성
excitable : a, 흥분하기쉬운
excitant : a, n, 자극성의, 자극물, 흥분제
excitation : n, 자극, 흥분
excitative : a, 자극적인
excite : vt, 자극하다, 자극하여 일으키다, 흥분시키다, 격려하다, 설레게 하다, 선동하다
excited : a, 흥분한, 여기한(excited atoms 여기 원자)
excitedly : ad, 
excited state : x, (물)여기 상태
excitement : ad, 자극, 격앙, 흥분, 법석, 동요, 자극하는 것
exciter : n, 자극하는 사람(것), (전)여자기, (의)자극(흥분)제, 여진기
exciting : a, 흥분시키는, 자극적인, 손에 땀을 쥐게 하는, 피끓는, 약동하는
exciton : n, 여기자
excitor : n, (생리)자극 신경
excl, : x, exclamation, excluded, excluding, exclusive(ly)
exclaim : vi, vt, 외치다, 큰 소리로 말하다, 비난하다
exclam, : x, exclamation, exclamatory
exclamation : n, 외침, 절규, 감탄, 감탄사, 감탄부호
exclamation mark : x, 느낌표, 감탄 부호(!)
exclamatory : a, 절규의, 감탄의
exclave : n, 타국 내에 고립되어 있는 자국의 영토
exclosure : n, 울타리로 둘러싼 곳(가축 등의 침입을 막음)
exclude : vt, 몰아내다, 배척하다, 제외하다, 추방하다
excluding : prep, ...을 제외하고(한)
exclusion : n, 몰아냄, 제외, 배척
exclusionary rule : x, (미법)(위법 수집 증거)배제의 원칙
exclusion clause : x, (보험)제외 조항
exclusive : a, 배타적인, 독점적인, 독특한, 유일의, 고급의, 일류의
exclusive distribution : x, 독점적 유통
exclusive economic zone : x, 배타적 경제수역
exclusive fishing zone : x, 어업 전관 수역
exclusive interview : x, 단독 회견
exclusively : ad, 독점적으로, 오로지
exclusive OR : x, (전산)배타적 논리합
exclusivism : n, 배타(쇄국, 독점)주의
exclysionism : n, 배타주의
excogitate : vt, 안출하다
excogitation : n, 
excommunicate : vt, 파문하다, 제명하다
excommunication : n, (기독교)파문, 제명, 추방
excommunicative : a, 파문의
excommunicator : n, 파문시키는 사람, 파문 선고자
exconvict : n, 전과자
excoriate : vt, ~의가죽을벗기다, 껍질을 까다, 혹평하다, 심한 욕을 퍼붓다
excoriation : n, (피부의)벗김, 벗겨짐, 통렬한 비난
excrement : n, 배설물
excrementitious : a, 배설물의, 대변의
excrescence : , 자연발생물(손톱, 발톱, 머리털 따위), 이상 발생물(혹, 사마귀 따위), 무용지물
excrescent : a, 군, 가외의, 혹 같은
excreta : n, 배설물, 대변
excrete : vt, 배설하다
excretion : n, 배설물
excretive : a, 배설의
excretory : a, n, 배설의, 배설기관
excruciate : vt, ~을고문하다, 심한 고통을 주다, 몹시 괴롭히다
excruciating : a, 고문받는(듯한), 몹시 괴로운, (괴로워)견딜 수 없는, 맹렬한, 대단한, 극도의, excruciationly, ad
excruciation : n, 자책감, 고문, 격렬한 고통, 고민, 괴로움
exculpate : vt, 무죄로하다, 무죄를 증명하다(exculpate oneself 자기의 무조를 입증하다)
exculpation : n, 무죄
exculpatory : a, 무죄 변명의, 변명의, 변명하는
excurrent : a, 유출성의, 심장에서 흘러 나오는, (식)외줄기의, (잎맥 등)연출하는
excurse : vi, 앞길로 새다, 잠깐 여행하다, 소풍가다
excursion : n, 소풍, 수학여행, 단체여행, 관광단, 일탈, 습격
excursionist : n, 
excursion ticket : x, 유람차표
excursion train : x, 유람 열차
excursive : a, 배회하는, 산만한, 지엽적인
excursus : n, (책뒤에 붙인)여적, 여록, 부설
excusable : a, 용서할수있는, 변명이 서는
excusatory : a, 변명의
excuse : 변명하다, 용서하다, 보아주다, 면제하다(excuse oneself 변명하다, excuse oneself from 사퇴하다, 그만두고 싶다고 말하다), 변명, 사과, 발뺌, 구실, 핑계
excuseme(dance) : x, 남의 파트너와 춤추어도 되는 댄스
excuser : n, 용서하는 사람, 변명자
Excutive Mansion : x, 대통령(주지사) 관저
exdirectory : a, (영)전화 번호부에 실리지 않은
ex div, : x, ex dividend
exdividend : x, 배당락
exeat : n, (L=let him go out)(학기 중에 주는)단기 휴가, 외박 허가
exec : n, (구)간부
exec, : x, executive, executor
execrable : a, 밉살스러운, 귀찮은, 몹시 싫은
execrate : vt, 저주하다, 몹시 싫어하다, 혐오하다
execration : n, 저주, 몹시 싫어함, 주문, 저주의 말, 매도, 저주받은 사람(것), 몹시 싫은 것
execratory : a, 저주의
executable : a, 실행(수행, 집행)할 수 있는
executant : n, 연주자, 실행자
execute : 시행하다, 수행하다, 실시하다, (미술품을)제작하다, (곡을)연주하다, (유언을)집행하다, 서명 날인하다, (사형을)집행하다, 서명 날인하다, 사형을 집행하다
executer : n, =executor
execution : n, 실행, 수행, 이행, 사형 집행, 처형, 작성, 서명 날인, 솜씨, 효과, (미술품의)제작, 연주
Execution Dock : x, (영사)해적 처형장(템스 강변 Wapping부근에 있었음)
executioner : n, 실행자, 사형 집행인
executive : a, n, 시행의, 실행력이 있는, 행정상의, 행정부, 간부, 간사, 지배인, 대통령, 주지사
executive agreement : x, (미)행정 협정
executive clemency : x, (미)행정관 감형(대통령, 주지사에 의한 감형)
executive committee : x, 집행위원회
executive council : x, (최고집행권한을갖는)평의회, (정부 수반 권고를 위한)평의회
executive officer : x, 행정관
executive order : x, 대통령명령, 행정 명령
executive privilege : x, (미)(기밀 보유에 대한)행정부(대통령)특권
executive secretary : x, 사무 국장(총장)
executive session : x, (수뇌부등의)비밀회
executor : n, 집행인, 지언 유언 집행자
executorial : a, 집행인의
executory : a, 행정상의, (법)미이행의, 미확정의
executrix : n, executor의 여성형
exegesis : n, (성경, 경전의)주석, 해석
exegetics : n, 성경 해석학
exemplar : n, 모범, 본보기, 견본
exemplary : a, 모법적인, 전형적인, 지예적인
exemplary damages : x, =PUNITIVE DAMAGES
exemplification : n, 예증, 예시, 인증 등복
exemplify : vt, 예시하다, 예증하다, ~의 실례가 되다, 인증 등본을 만들다
exempli gratia : x, 예를들면
exemplum : n, 예, 모범, 도덕적(교훈적)이야기
exempt : vt, a, n, 면제하다, 면제된(사람), 면제자
exemption : n, (의무의)면제
exequatur : n, (L=he may perform)(주재국 정부에서 타국의 영사 등에게 주는)인가장
exequies : n, 장례(식)
exercisable : a, 행사(운용)할 수 있는
exercise : n, vt, vi, 운동, 체조, 연습, 실천, 학과, 활동시키다, 행사하다, 다하다, 번거롭게 하다, 연습하다
exercise book : x, 연습장, 연습 문제집
exerciser : n, 운동자(기구)
exercitation : n, 실습, 연습, 문장(연설)의 연습
Exercycle : n, 엑서사이클(페달만 밟게 된 실내 운동 기구, 상표명)
exergue : n, (옛날의 화폐, 메달 뒷면의)도형의 하부와 가장자리 사이(연월일, 제조소등을 새긴 곳)
exert : vt, (힘, 능력을)내다, 활동시키다, (영향을)미치다, 끼치다(exert oneself 노력하다)
exertion : n, 노력, 진력, 발위
exertive : a, 노력하는
exes : n, (구)비용
Exeter : n, 엑세터(잉글랜드 남서부 Devonshire 주의 주도, 대성당이 있음)
exeunt : vi, 퇴장하다
exeunt omnes : n, (L)(극)전원 퇴장
ex factory : x, 공장도
exfiltrate : vi, vt, (미군)적진에서 탈출하다(시키다)
exfoliate : vi, vt, (암석, 나무 껍질 등이)벗겨지다, 벗겨져 떨어지다, 벗기다
exfoliation : n, 벗겨짐, 박락물
exgausted : a, 다 써버린, 써서 다 낡은, 고갈된, 지쳐버린
exgausting : a, 심신을 피로케 할
ex gratia : ad, a, (L=out of grace)호의로서(의)
exhalation : n, 발산물, 호기, 날숨, 증기
exhale : vt, vi, (공기따위를)내뿜다, (냄새 따위를)발산하다, 증발하다, 소산하다
exhaust : 다써버리다, (그릇 따위를)비우다, 없애다, 샅샅이 연구하다, 남김없이 논하다, (체력을)소모하다, 지쳐버리게하다, 유출하다, 배출하다, 배출, 배기
exhaust fan : x, 환풍기
exhaust fumes : x, 배기가스
exhaust gas : x, 배기 가스(특히 엔진의)
exhaustible : a, 고갈시킬 수 있는, 다할 수 있는
exhaustion : n, 소모, 고갈, 배출, (극심한)피로, (문제의)철저한 연구
exhaustive : a, 남김없는, 완전한, 철저한
exhaustively : ad, 철저하게, 남김없이, 속속들이
exhaustless : a, 무진장의
exhaust manifold : x, (내연 기관의)배기 매니폴드
exhaust pipe : x, 배기관
exhaust valve : x, 배기관
exhauxtibility : n, 고갈시킬 수 있음, 다할 수 있는 가능성
exhbn, : x, exhibition
exhibit : vt, n, 진열하다, 출품하다, 공개하다, 보이다, 나타내다, (문서를)제시하다, 투약하다, 전시, 출품물, 증거물
exhibition : n, 전시, 공개, 과시, 출품물, 전람회, 박람회, 제시, 장학금, 시약
exhibitionism : n, 과시벽, 노출증
exhibitive : a, (...을)나타내는, 표시하는
exhibitor : n, 출품자, (미)영화관 경영자
exhibitory : a, 전시(용)의
exhilarant : a, n, 기분이 들뜨는(것 같은), 기분을 상쾌하게 하는 것, 흥분제
exhilarate : vt, 기운을북돋우다, 명랑하게 만들다
exhilarated : a, 기분이 들뜬, 명랑한
exhilarating : a, 유쾌하게 만드는, 유쾌한
exhilaration : n, 유쾌하게 만듦
exhilarative : a, 기운나게 하는, 상쾌하게 하는
exhort : vt, vi, 열심히권하다, 권고하다, 훈계하다
exhortation : n, 권고, 권고의 말, 훈계
exhortative : a, 권고(훈계)적인
exhortatory : a, =EXHORTATIVE
exhumation : n, 
exhume : vt, 발굴하다
exigency : n, 급박, 위급, 긴박(한 때), 급박(절박)한 사정, 급무
exigent : a, 긴급의, ~을 요하는, 살아가기 힘드는
exigible : a, 강요(요구)할 수 있는
exiguity : n, 미소, 근소
exiguous : a, 미소한, 작은, 부족한
exile : n, vt, 망명, 유형, 국외추방, 망명자, 유랑자, 유형자, 추방인, 추방하다, 유형에 처하다
exilic : a, 추방의, (특히)바빌론 유수의
exility : n, 미세, 미묘
ExIm : x, ExportImport Bank of the United States
Eximbank : n, 수출입은행
exist : vt, 존재하다, 실재하다, 실존하다, 생존하다
existence : n, 존재, 실재, 생존, 생활, 실재물(bring into existence 생기게 하다, , 다, 성립시키다)
existent : a, n, 현존하는, 현행의, 목하의, 존재하는 것(사람)
existential : a, 존재에 관한, existentialist 실존주의자(의), n
existentialism : n, 실존주의
existing : a, 현존하는
exit : n, vt, 출구, 퇴출구, 나감, 퇴거, 퇴장, 퇴장하다
exit permit : x, 출국 허가(증)
exit poll : x, 투표소 출구에서의 여론조사(투표결과의 예상 등을 위한)
exit tax : x, (소련)(출국 이주자의)출국세
exit visa : x, 출국 사증
ex lib, : x, ex libris
ex libris : n, 장서표
exlibrist : n, 장서표 수집자
ex nihilo : x, 무에서
exo- : x, (연결형)(바깥, 외부)의 뜻
exoatmosphere : n, 외기권
exobiology : n, 우주생물학
exocarp : n, =EPICARP
exocentric : a, 외심적인
Exocet : n, (F)엑조세 미사일(프랑스제 공대함 미사일)
exocrine : a, 외분비의(exocrine gland 외분비선)
exocrinology : n, 외분비학
Exod, : x, Exodus
exodontia : n, (치과)발치술
exodus : n, 출발, 출국
exoelectron : n, (물)엑소 전자(응력하에서 금속 표면으로부터 방출되는 전자)
ex officio : x, 직권에의한
ex officio : x, 직권에의한
exogamous : a, (사회)이족 결혼의, (생)이계 교배의
exogamy : n, 이족결혼
exogen : n, (식)외생 식물
exogenous : a, (생)외인성의, (식)외생의, (지질)외성의
exon : n, (생화)엑손(진핵 생물의 mRNA의 정보 배열)
exonerate : vt, (비난따위로부터)구하다, (혐의를)벗다, 풀다
exoneration : n, (원죄에서)구하기, 면죄, (의무의)면제, 책임의 해제
exonerative : a, 면죄의, 의무 면제의
exonumia : n, (메달, 라벨 등)화폐 이외의 수집품
exophthalmos : n, (병리)안구 돌출(증)
exoplasm : n, =ECTOPLASM
exor, : x, executor
exorbitance : n, 엄청남, 과대, 과도
exorbitant : a, 터무니없는, 엄청난
exorcise : vt, (악마를)내쫓다, 액막이하다
exorcism : n, 액막이(기도, 굿)
exorcize : vt, =EXORCISE
exordium : n, (논문, 강연의)머리말, 서론
exordiumdial : a, 
exoskeleton : n, 외골격
exosphere : n, 외기권
exoteric : a, 공교적인, 공개적인, 통속적인, 이해할 수 있는
exothermic : a, 발열성의
exotic : a, 외국의, 외래의, 이국풍의, 색다른, 희한한
exotica : n, 이국풍의 것, 이국 취미의 작품, 별난 습속
exotic dancer : x, 스트리퍼
exoticism : n, 이국 취미, 이국 정서, 외국식 어법
exotoxin : n, (생화)(균체)외 독소
exp, : x, expense(s), expired, exportation, export(ed), exporter, express
expand : vt, vi, 넓히다, 넓어지다, 펴다, 퍼지다, 팽창시키다, 확장시키다, 발전시키다, 전개하다
expandable : a, =EXPANSIBLE
expanded : a, 확대한, 팽창한, (영문 활자가)평체인
expanded cinema : x, =INTERMEDIA
expanded metal : x, 엑스팬드 메탈(엷은 그물 모양의 금속판, 모르타르벽 외용)
expanded plastic : x, 발포 플라스틱
expanded tense : x, (문법)확충 시제, 진행형
expander : n, 확대시키는 사람(장치), (전자)신장기
expanding folder : x, 주름통 모양으로 펴지는 서류철
expanding universe : x, (천)팽창하는 우주
expanse : n, 넓음, 넓은장소, 확장, 팽창
expansible : a, 팽창 할수 있는
expansile : a, 신장(확대)의, 확장(확대)할 수 있는, 팽창성의
expansion : n, 확장, 확대, 발전, 팽창
expansionary : a, 확장(발전, 팽창)성의
expansionism : n, 팽창론, 영토 확장론
expansive : n, 팽창력 있는, 광할한, 마음이 넓은, 과대망상적인
expansivility : n, 신장력(성), 팽창력, 발전성
ex parte : ad, a, (L)(법)당사자 한쪽에 치우쳐(친), 일방적으로(인)
expatiate : vi, 상세히설명하다, 부연하다
expatiation : n, 상세한 설명, 부연
expatiatory : a, 자세히(장황하게)설명하는
expatriate : n, (국외로)추방하다, 추방자, 이주자
expatriation : n, 국외 추방, 본국 퇴거, (법)국적 이탈
expect : vt, 기대하다, 예상하다, 예기하다, 당연한 일로 여기다, 바라다, ~라고 생각하다
expectance : n, 예기, 기대, 가망
expectant : a, n, 예기하는, 기다리고 있는, 임신중인, 기대하는 사람, 지망자
expectation : n, 기대, 예기, 예상, 가망성, 유산 상속의 가망성
expectative : a, n, 바라는, 기대하는(대상의), 기대되는 것
expected value : x, (통계)기대값
expectorant : a, n, 가래제거를돕는, 거담제
expectorate : vt, vi, 기침하여뱉다, 가래를뱉다, 침을 뱉다
expectoration : n, 가래(침)뱉음, 뱉은 것
expedience : n, 편의, 형편, 방편, 사리, 편의한것
expedient : a, n, 형편좋은, 편의한, 상책의, 시의를 얻은, 편의주의의, 유리한, 정략적인, 공리적인, 수단, 방편, 편법, 임기응변의조처
expediential : a, 평의주의적인, 편의상의
expedite : vt, 촉진하다, 재촉하다, 재빨리 해치우다
expedition : n, 원정, 탐험대, 신속, 급속
expeditionary : a, 원정의
expeditious : a, 신속한, 날쌘
expel : vt, 쫓아내다, 추방하다, 제명하다, 방출하다
expellant : a, n, 내쫓는힘있는, 구제력있는, 구제약
expellee : n, 국외추방자
expend : vt, 소비하다, (시간, 노력을)들이다
expendability : n, 
expendable : a, n, 소비되는, (군)(병력, 자재 등이)희생될 수 있는, 소모성의, 소모품(자재, 병력)
expenditure : n, 지출, 출비, 경비
expense : n, 비용, 지출, 지출금, 손실, 희생
expense account : x, 교제비, 접대비
expenseaccount : a, 비용 계정의, 교제비의
expensive : a, 비싼, 사치스런
experience : n, vt, 경험, 체험, 경력, 경험담, 경험하다, 경험으로 알다
experienced : a, 경험을 가진, 노련한
experience meeting : x, (교회의)신앙 좌담회
experience table : x, (생보)경험 사망표
experiential : a, 경험(상)의, 경험에 의한, 경험적인, experientialism(철)(인식론의)경험주의, n
experiment : n, vi, 실험, 시험, 실험하다
experimental : a, 실험에 의한, 실험적인, 실험용의, 경험에 의한
experimentalism : n, 실험주의, 경험주의
experimentalist : n, 
experimentalize : vi, 실험을 하다
experimentally : ad, 실험적으로, 실험상
experimentation : n, 실험, 실험법
experiment station : x, (농사 등의)시험장
expert : n, a, 숙련자, 노련가, 전문가, 기사, 감정인, 숙달된, 노련한
expertise : n, 전문적의견
expertism : n, 전문 기술(지식)숙달
expertize : vi, vt, 전문적 의견을 말하다, 전문적 판단을 내리다
expiable : a, 보상할 수 있는
expiate : vt, (죄를)속죄하다
expiation : n, 속죄, (죄를)선행 등으로 갚음, 보상
expiator : n, 속죄자
expiatory : a, 속죄의, 보상의
ex pier : x, (상)부두 인도
expiration : n, 종결, 만료, 만기, 날숨, 죽음
expiratory : a, 날숨의
expire : vi, vt, 끝나다, 만기가 되다, 숨을 내쉬다, 죽다, 내쉬다, 뿜어 내다
expiry : n, 종료, 만기
explain : vt, vi, n, 설명하다, 해석하다, 변명하다, 군더더기, 덧붙이기, 욕설, 허사
explainable : a, 설명(해석, 해명)할 수 있는
explanation : n, 설명, 해석, 해명, 변명, 설명이 되는 말(사실, 사정), (설명으로 밝혀진)뜻
explanative : a, =EXPLANATORY, explanatively, ad
explanatory : a, 설명적인, 해석상의
explant : vt, n, (생)(생체 일부를)외식하다, 외식편
expletive : a, n, 단순히 부가적인, 덧붙이기의, 조사, 허사, 무의미한 감탄사
expletive deleted : x, 비속(외설)어 삭제
expletory : a, =EXPLETIVE
explicable : a, 설명할수있는, 납득할 수 있는
explicate : vt, 차례로풀이하다, 설명하다
explication : n, 설명, 해설, 전개
explicative : a, 설명이 되는, 해설적인
explicatory : a, =EXPLICATIVE
explicit : a, 명백한, 명백히 말한, 노골적인, 숨김없는
explicit faith (belief) : x, (교리 등을 이해한 다음의)명시적 신앙
explode : vt, vi, 폭발시키다, 타파하다, 논파하다, 폭발하다, (감정이)격발하다
exploded : a, 폭발(파열)한, 논파(타파)된, (모형, 그림이)기계를 분해하여 부품의 상호 관계를 나타내는
exploder : n, 폭발 장치, 뇌관
exploit : vt, 개척하다, 개발하다, 채굴하다, 이용하다, 미끼삼다, 착취하다
exploitage : n, (자원 등의)이용, 개발, 이기적인 이용, 착취
exploitation : n, (산야, 삼림, 광산 등의)개척, 개발, 이용, 이기적 이용, (노동력의)착취
exploitative : a, 자원 개발의, 착취적인, exploitatively, ad
exploitive : a, =EXPLOITATIVE
exploration : n, 탐험, 탐구
explorative : a, =EXPLORATORY, 캐기 좋아하는
exploratory : a, (실지)답사의, 탐험(상)의, 탐구를 위한
explore : vt, vi, 탐험하다, 탐구하다
explorer : n, 탐험가, 탐구자, (미국의)인공위성이름
explosion : n, 폭발, 파열, 급증
explosive : a, n, 폭발성의, 격정적인, 파열음의, 폭약, 파열음
explosive bolt : x, 폭발볼트(우주선의분리부분등에쓰임)
expo : n, 박람회
exponent : n, 대표적인물, 대표물, 형, 설명자, 멱지수
exponential : a, 지수의
export : vt, n, 수출하다, 수출품, 수출
exportation : n, 수출, 수출품
exportinport bank : x, 수출입 은행
export reject : x, 수출 기준 불합격품
expose : vt, (일광, 비, 바람따위에)쐬다, 노출하다, 폭로하다, 적발하다, 진열하다, (아이를)집밖에 내버리다
expose : n, (F=exposure)(추문 등의)폭로, 적발
exposed : a, (위험 등에)드러난, 노출된, 비바람을 맞는, 노출한(필름)
exposition : n, 설명, 해설, 전람회, (아이의)유기
expositive : a, =EXPOSITORY
expositor : n, 설명자, 해설자
expository : a, 설명(해설)적인
ex post facto : x, 소급하는
ex post facto : x, 사후의, 소급하는
expostulate : vt, 간하다
expostulation : n, 간, 충고
expostulatory : a, 충고의
exposure : n, 버려둠, (집, 방의)향, 노출, 폭로, 적발, (어린애의)유기
exposure index : x, 노광지수
exposure meter : x, 노출계
expound : vt, 설명하다, 상술하다
expremier : n, 전수상, 전총리
expresident : n, 전대통령
express : 표현하다, 표시하다, 지급편으로 보내다, 명시된, 명백한, 정확한, 특별한, 급행의, 지급편의, 운송편의, 특별히, 급행으로, 속달로, 지급편, 특별편, 급행열차, 운송회사
expressage : n, 속달운송업, 그 운임
express car : x, 급행 화물 차량
express delivery : x, 속달편
express elevator : x, (미)급행 승강기
expressible : a, 표현할 수 있는, 짜낼 수 있는
expression : n, 표현, 말투, 표정
expressional : a, 표현상의, 표정의
expressionism : n, 표현주의, 표현과
expressionistic : a, 표현주의적인
expressionless : a, 무표정한
expression mark : x, (악)나타냄 말, 발상기호
expressive : a, 표현하는, 의미 심장한, 표정이 풍부한, 표현의
expressivity : n, (생)(유전자의)표현도, 표현 능력, 표현의 풍부함
express letter : x, (영)속달 편지
expressly : ad, 명백히, 특별히, 일부러
expressman : n, 운송업자, 급행 트럭 운전사
express rifle : x, 속사 엽총
express train : x, 급행 열차
expressway : n, 고속도로
exprobration : n, 비난, 책망
expropriate : vt, (토지, 재산따위를)몰수하다, 빼앗다
expropriation : n, (토지 등의)수용, 징발, 몰수
expt, : x, experiment
exptl, : x, experimental
expulsion : n, 추방, 제명
expulsion order : x, 국외 퇴거 명령
expulsive : a, 구축력이 있는, 배제성의
expunction : n, 말소
expunge : vt, 지우다, 말살하다
expungement : n, (미)(전과 등의)기록 삭제
expuragator : n, (책 등의)삭제자
expurgate : vt, (책의불온한대목을)삭제하다
expurgation : n, (온당하지 못한 부분의)삭제
expurgatorial : a, 삭제(자)에 관한, 삭제하는
expurgatory : a, 삭제의
expy, : x, expressway
exquisite : a, n, 절묘한, 우미한, 더할나위 없는, (즐거움이)깊은, 예민한, 정교한, (취미, 태도의)우아한, 멋쟁이 남자, 취미가까다로운사람
exr, : x, executor
exrx, : x, executrix
exs, : x, examples, expenses
exsanguinate : vt, ...에게서 피를 뽑다, 방혈하다
exsanguine : a, 핏기없는, 빈혈의
exscind : vt, 잘라내다, 절제하다
exsect : vt, 절제하다
exsection : n, 절제(술)
exsert : vt, 내밀다, 돌출케하다
exsertion : n, 돌출
exservice : a, (영)(군인이)퇴역한, 제대한, (물자가)군에서 불하된
exserviceman : n, 퇴역군인
ex ship : x, 선측인도의
exsiccate : vt, vi, 건조시키다, 건조하다
exstipulate : a, (식)탁엽이 없는
ex store : x, 점두 인도의
ext, : x, extension, external(ly), extinct, extra, exteract
extant : a, (기록따위)현존하는
extemporaneity : n, 임시변통, 즉석
extemporaneous : a, 즉석의, 임시(변통)의
extemporarily : ad, 즉석에서, 임시 변통으로
extemporary : a, 즉석의, 임시의
extempore : a, ad, 즉석의, 즉석에서, 즉흥적(으로)
extemporization : n, 즉석에서 만듦, 즉흥, 즉흥적 작품, 즉석에서 노래 부름, 즉석 연주(등)
extemporize : vt, vi, 즉석에서만들다, 즉석에서 연설하다, 노래하다, 연주하다
extencisor : n, 손가락, 손목 강화 기구, 악력 강화기
extend : 뻗다, 늘이다, 넓히다, 확장하다, 연장하다, 베풀다, 뻗치다, (밧줄을)건너치다, (속기를)보통 글자로 옮겨 쓰다, 평가하다, (토지를)압류하다
extended : a, 뻗친, 장기간에 걸친, 광범위한, 확장된, 증대한, 평체인
extended family : x, (사회)확대 가족(근친을 포함한 것)
extended play : x, Ep판(1분간 45회전 레코드)
extender : n, 늘이는 사람(것), 증량제, 희석제, 체질 안료, (영)(대학 공개 강좌의)교사
extendible : a, =EXTENSIBLE
extensibility : n, 신장성, 연장성, 확장 가능성
extensible : a, 뺄을 수 있는, 신장성의
extensile : a, 넓어지는, 연장되는(될 수 있는)
extensimeter : n, =EXTENSOMETER
extension : n, 신장, 연장, 확장, 증축, 외연
extension cord : x, (전기 기구용)연장 전기줄
extension courses : x, 대학 공개 강좌
extension ladder : x, 신축사닥다리
extension lecture : x, 대학 공개 강의
extension table : x, 신축테이블
extensity : n, 신장성, 넓이, 범위, (심)공간(연장)성
extensive : a, 넓은, 광범위에 걸친, 대규모의, 조방의
extensively : ad, 널리, 광범하게
extensometer : n, (기)신장계(신축, 왜곡을 측정하는)
extensor : n, 신축근
extent : n, 넓이, 크기, 범위, 정도, 넓은 장소
extenuate : vt, (죄따위를)경감하다
extenuating : a, 참작할 만한
extenuation : n, 정상 참작, (죄의)경감, 참작할 점(사정)
extenuatory : a, 참작 사유가 되는 (사정 등)
exterior : a, n, 외부의, 외면의, 외부, 외면, 외관
exterior angle : x, 외각
exteriority : n, =EXTERNALITY
exteriorize : vt, 외면화하다, (의)(수술을 위해)(조직을)몸밖으로 내다
exterminable : a, 근절할 수 있는
exterminate : vt, 근절하다
extermination : n, 
exterminator : n, 근절자, (해충 등의)구제약
exterminatory : a, 근절적인
extern : n, 통근자, 통학생, 외래 환자, 통근 의사
external : a, n, 외부의, 외면의, 외계의, 외면적인, 피상적인, 대외적인, 외부, 외면, 외관
external angle : x, =EXTERIOR ANGLE
externalcombustion : a, (기)외연의
external fertilization : x, 체외수정
external galaxy : x, (천)은하계의 성운
externality : n, 외부(외면)적 성질, 외계, 외형, 외관, 형식주의
externalization : n, 외적 표현, 객관화, 구체화
externalize : vt, (내적인 것을)외면화하다, (사상 등을)구체화하다
external loan : x, 외채
externally : ad, 외부적으로, 외부에서
external screw : x, (기)수나사
exteroceptor : n, (생리)외부 수용기(눈, 귀, 코, 피부 등)
exterritorial : a, 치외법권의
exterritoriality : n, 치외 법권
extg, : x, extracting
extinct : a, 꺼진, 끊어진, 사멸한, 폐지된
extinction : n, 소화, 진화, 흡광, 종식, 사멸, 절명, (가계의)단절, (법)(권리 등의)소멸
extinctive : a, 소멸적인, 소멸성의
extinguish : vt, 끄다, (희망을)잃게 하다, 꺾다, 전멸시키다, 무색하게하다, (부채를)상각하다
extinguishable : a, 끌 수 있는, 절멸시킬 수 있는
extinguishant : n, 소화물(물, 소화제 등)
extinguisher : n, 소화기
extirpate : vt, 근절하다, 박멸하다
extirpation : n, 근절, 절멸, (외과)적출술
extirpative : a, 근절하는
extoll : vt, 격찬하다, 절찬하다
extort : vt, (약속, 돈을)강요하다, 갈취하다, (뜻을)억지로 갖다붙이다
extortion : n, 강탈, (관리의)재물강요죄, 부당한 요금
extortionary : a, 강요의, 강탈의, 착취적인
extortionate : a, 강요(강탈)하는, 엄청난, 폭리의, extortionately, ad
extortive : a, 강요하는, 강탈적인
extra : a, ad, n, 특별한, 가외의, 가외로, 특별히, 임시의(로), 가외물건, 특별한 물건, 경품
extra- : pref, (...외의, ...의 범위 외의)의 뜻
extraatmospheric : a, 대기권 밖의
extrabase hit : x, 장타
extrachromosomal : a, (생)염색체외의
extracorporeal : a, 체외의
extracosmical : a, 우주 밖의
extract : vt, n, 끌어내다, 빼어내다, 짜내다, 알아내다, (쾌락을)얻다, 발췌하다, 추출물, 인용구
extractant : n, (화)추출용 용제(용매)
extraction : n, 뽑아냄, 빼어냄, 적출(법), (화)추출, (약등의)달여냄, 뽑아낸 것, 엑스, 혈통, (수)(근)풀이
extractive : a, n, 발췌적인, 추출할 수 있는, 추출물, 엑스
extractor : n, 추출자, 발췌자, 추출 장치, 뽑아내는 기구
extracurricular : a, 과외의
extracurricular activity : x, 과외 활동, (속)부정(부도덕)행위, 외도
extraditable : a, (도주범이)인도되어야 할, (죄가)인도처분에 해당한
extradite : vt, (당국, 상대국에도망범인을)인도하다, ~의 인도를 받다
extradition : n, (법)(어떤 나라로)외국 범인의 인도, 본국 송화, (심)감각의 사출
extra dividend : x, (증권)특별 배당
extrados : n, (건)(아치의)겉둘레, 외호면
extra dry : x, (포도주 등)거의 단맛이 없는
extraessential : a, 본질 외의, 주요하지 않은
extragalactic : a, (천)은하계 밖의
extrajudicial : a, 사법관할 밖의, 사법 수속에 의하지 않는, 재판(사항)밖의
extralegal : a, 법률의지배를받지않는
extrality : n, (구)=EXTERRITORIALITY
extralunar : a, 달 밖의, 달 밖에 있는
extramarital : a, 혼회성교의, 간통의, 불륜의
extramundane : a, 지구이외의, 물질 세계 밖의
extramural : a, 성밖의, 교외의, 대학 밖의
extraneous : a, 외부로부터의, 외래의, 질이 다른, 관계없는
extranuclear : a, (세포, 원자의)핵 밖의
extraofficial : a, 직권 외의, 직무 외의
extraordinaire : a, (F)극히 이례적인, 비범한, 출중한
extraordinarily : ad, 비상하게, 엄청나게, 유별나게, 이례적으로
extraordinary : a, 보통이아닌, 비범한, 엄청난, 특명의
extraordinary ray : x, 이상광선
extraparochial : a, 교구 밖의, 교구 관할외의
extrapolability : n, (자료에 의거한)추정 가능성
extrapolate : vt, vi, 추정하다, 외삽하다, ~을 추정의 기초로 삼다
extrapolation : n, (통계)외삽법, 보외법
extra sec : x, (샴페인이)쌉살한, 단맛이 거의 없는
extrasensory : a, 초감각적인, 영감적인, 영감의(extrasensory perception)
extrasolar : a, 태양계 밖의
extra special : x, (구)극상의
extraterrestrial : a, 지구밖의, 대기권외의
extraterritorial : a, 치외법권의
extraterritoriality : n, 치외법권
extra time : x, (스포츠)(로스 타임을 보충하기 위한)연장 시간
extrauterine : a, 자궁외의
extravagance : n, 낭비, 방종, 터무니 없음
extravagant : a, 낭비하는, 터무니 없는, 엄청난
extravaganza : n, (문학, 악극등의)광상적작품, 광태
extravasate : vt, vi, (혈액따위가)맥관에서넘쳐나(게하)다, 내출혈하다
extravasation : n, (혈액, 임파액 등의)넘쳐 흐름
extravehicular : a, 우주선밖의(eatravegicular activity 우주선외 할동)
extravehicular activity : x, (우주인의)선외 활동
extraversion : n, (심)=EXTROVERSION
extravert : n, a, =EXTROVERT
extreme : a, n, 극도의, 극단의, 과격한, 맨끝의, 최후의, 극단, 극도, 양극단, 극단적인 수단
extremely : ad, 극도록
extremely high frequency : x, (통신)초고주파
extreme unction : x, 병자성사
extremism : n, =EXTREMENESS, 극단론(주의), 과격주의
extremist : n, 극단론자, 과격파
extremity : n, 끝, 말단, 선단, 극단, 극한, 곤경, 비상수단, 수족
extremum : n, (수)극값
extricable : a, 구출할 수 있는
extricate : vt, 구해내다
extrication : n, 구출, 탈출, (화)유리
extrinsic : a, 외부의, 외래적인, 비본질적인
extrinsic semiconductor : x, (전자)외인성(불순물)반도체
extro- : pref, (바깥으로)의 뜻
extrorse : a, (식)(꽃밥이)외향하는, extrorsely, ad
extroversion : n, (눈꺼풀, 방광등의)외전, 외향성
extrovert : n, a, 외향성의(사람)
extroverted : a, =EXTROVERT
extrude : vt, vi, 내밀다, 밀어내다, 돌출하다
extrusion : n, 밀어냄, 내밈, 구축, 압출 성형(한 제품)
extrusive : a, n, 밀어내는, 내미는, (지질)(화산에서)분출한, (지질)분출암
exuberance : n, 풍부, 충일, 무성함
exuberant : a, 무성한, 풍부한, 원기왕성한, (문체 따위)화려한
exuberate : vi, 풍부하다, 탐닉하다
exudate : n, 삼출물(액)
exudation : n, 스며 나옴, 삼출(작용), 배출, 삼출물(액)
exude : vi, vt, 배어나오다, 배어나오게 하다, 발산하다, 발산시키다
exult : vi, 무척기뻐하다
exultant : a, 크게 기뻐하는, 의기 양양한, 환희의, 이겨 뽐내는, exultantly, ad
exultation : n, 환희, 광희, 열광
exulting : a, 미칠듯이 기뻐하는, exultingly 크게 기뻐하여, ad
exurb : n, 준교외
exurbanite : n, 준교외지역거주자
exurbia : n, (집합적)준교외 주택 지역
exuviae : n, 허물(매미, 뱀 등의), 잔해
exuviate : vi, vt, (짐승이허물을)벗다
exuviation : n, 탈피
ex voto : x, 봉납물
ex voto : x, 봉납물, 봉헌물
exworks : ad, a, (영)공장도로(의)
exx, : x, examples, executrix
Exxon : n, 엑손
eyas : n, 새 새끼, 매 새끼
eye : n, vt, 눈, 눈매, 시력, 주목, 안식, 보는눈, 견해, 눈 모양의 것, 탐정, 레이더 수상기, 잘 보다, 자세히 보다
eye appeal : x, 사람눈을끎, 매력
eyeappealing : a, (미구)남의 눈을 끄는, 매력적인
eyeball : n, 눈알, 안구
eyeballtoeyeball : a, (구, 익살)=FACETOFACE
eye bank : x, 안구은행
eyebar : n, (기, 건)양끝에 구멍이 뚫린 강철봉
eye bath : x, (영)=EYECUP
eyebeam : n, 눈빛의 번득임, 일별
eyeblack : n, 마스카라
eyebolt : n, (기)아이볼트, 고리 볼트
eyebright : n, (식)좁쌀풀 무리
eyebrow : n, 눈썹
eyebrow pencil : x, 눈썹 연필(화장품)
eyecatcher : n, 미인, 사람 눈을 끄는 것
eyecatching : a, 눈길을 끄는
eye chart : x, 시력검사표
eye contact : x, 시선이 마주침
eyecup : n, 세안컵
eyed : a, (...의)눈을 한, 눈구멍이 달린, 눈 모양의 얼룩이 있는
eye dialect : x, 시각와어(발음대로낱말을쓴것)
eye doctor : x, (구)안과 의사, 검안사
eyedrop : n, 눈물
eyedropper : n, 점안기
eye drops : x, 안약
eyefilling : a, (미구)(보기에)굉장한, 아름다운
eyeful : n, 한껏보고싶은것, 미인
eyeglass : n, 안경알, 안경
eyegrabber : n, (속)아주 강하게(크게)눈길을 끄는 것
eyehole : n, 안와, 작은구멍
eyeinthesky : n, 공중 전자 감시 장치(항공기, 인공 위성에 장치한 것)
eyelash : n, 속눈썹
eye lens : x, 대안(접안)렌즈
eyeless : a, 눈없는, 구멍없는, 맹목적인
eyeless sight : x, 무안 시각, 촉시각(손가락에 의한 빛깔, 문자의 식별 능력)
eyelet : n, 작은구멍, 끈 꿰는 구멍, (구두, 서류 따위의 끈 꿰는 구멍에 달린)작은 쇠고리
eyeleteer : n, (끈을 꿸 구멍 뚫는)송곳
eyelevel : n, 눈 높이
eyelid : n, 눈꺼풀, 눈두덩
eye liner : x, 아이라이너(속눈썹을그리는화장품)
eye lotion : x, 안약, 점안액
eye measure : x, 눈어림, 눈대중
eyeminded : a, 사각형의
eyeopener : n, 깜짝놀랄만한사건, 아침술
eyepatch : n, 안대
eyepiece : n, 접안렌즈
eyepit : n, =EYE SOCKET
eyepopper : n, (미구)깜짝놀라게 하는 것, 굉장한 것
eyepopping : a, (눈이튀어나올정도로)대단한, 굉장한, 놀라운
eyepopping : a, (눈이 튀어 나오도록)깜짝 놀라게하는, 굉장한
eyereach : n, 안계
eye rhyme : x, 시각운
eyeservant : n, 주인 눈 앞에서만 알랑거리는 고용인
eyeservice : n, 주인 눈 앞에서만 일함, 눈비음, 눈치껏의 근무
eyeshade : n, 보안용챙
eye shadow : x, 아이섀도
eyeshot : n, 안계
eyesight : n, 시각, 시력
eye socket : x, 안와, 눈구멍
eyesome : a, (고)보기에 매력있는
eyesonly : a, (미)(기밀문서 등)묵독만 하는(낭독, 복사 등이 엄금된)
eyesore : n, 눈에거슬리는것
eye splice : x, (해)삭안(밧줄의 끝을 풀어 잇대어 고리 모양으로 함)
eyespot : n, 감광기관, 안점, 눈모양의반점
eyestalk : n, (동)눈자루(새우 등의)
eyestrain : n, 눈의피로
eyestrings : n, (고)안근
Eyetie : n, 이탈리아사람
eyetooth : n, 견치, 송곳니
eyewall : n, 태풍 눈 주위의 구름벽
eyewash : n, 안약, 속임, 사기
eyewater : n, 안약, (눈의)수양액, 눈물
eyewear : n, 안경류
eyewink : n, 눈깜짝임, 일순간
eyewinker : n, =EYELASH
eyewitness : n, 목격자
eyot : n, (영)=AIT
EYP : x, Electronic Yellow Pages 전자식 직업 전화 번호부
eyre : n, (사)순회, 순회 재판(정)
eyrie : n, =AERIE, AERY
Ez : x, (성)Ezra
ezceptionable : a, 비난할 만한
Ezekiel : n, 에스겔(유대의 예언자)
Ezra : n, 에스라, 유대의예언자
