G : n, 알파벳 일곱번째문자, 사음, 사장조, (로마숫자의)400, 중력의 상수, 중력 가속도, 천, 천 달러
G, A, A, S, F : x, General Association of Asia Sports Federations, 아시아 경기 연맹 총연합회
G, A, B : x, General Arrangements to Borrow, 국제 통화기금의 일반 차입 협정
G, A, R, : n, Grand Army of the Republic, 남북 전쟁 종군 군인회
G, A, R, : x, Grand Army of the Repuvlic 남북 전쟁 종군 군인회
G, A, W, , GAW : x, guarantees annual wage 연봉 보증제
G, B : x, Games Behind승차
G, B, E : x, Knight Grand Cross of the British Empire
G, B, H : x, grievous bodily harm
G, C : x, George Cross
G, C, A : x, General claim Agent일반 청구 대리인, Ground Controlled Approach 지상 유도 착륙
G, C, B : x, Grand Cross of the Bath
g, c, d, , G, C, D, : x, greatest common divisor최대공약수
G, C, E : x, General Certificate of Education보통 수료증서
G, C, G, , g, c, f, , gcf : x, greatest common factor최대 공약수
G, C, I, E : x, Grand Commander of the Indian Empire
G, C, L, H : x, Grand Cross of the Legion of Honor
G, C, M, , g, c, m, , gcm : x, greatest common measure최대공약수, general court martial통합 군법 회의
G, C, M, G : x, Grand Cross of St, Michael and St, George
G, C, S, I : x, Grand Commander of the Star of Inda
G, C, V, O, : x, Grand Cross of the Victorian Order
G, d, : x, Grand Duke
g, e : x, gilt edges
G, F, S : x, Girls'Friendly Society
G, F, W, C : x, General Federation of Women's Clubs
G, FLOPS : n, 컴퓨터의 연산 속도 단위
G, G : x, Grenadier Guards
g, gr, : x, great gross
G, H, Q, : x, General Headquarters
G, L, C : x, Greater London Council 대런던 시의회
g, m, b : x, good merchantable brand
G, M, C : x, General Medical Council
G, M, C : x, General Medical Council
G, M, Q : x, good merchantable quality 판매 적성 품질
G, M, T : x, Greenwich mean time
G, M, T : x, greenwich Mean Time 그리니치 표준시
g, o, b : x, good ordinary brand
G, O, C : x, General Officer Commanding
G, O, C : x, General Officer Commanding
G, O, g, o, : x, general office, general order
G, O, M, , GOM : x, Grand Old Man
G, R et I, : x, Georgius Rex et Imperator
g, s, : x, grandson
G, S, A : x, Girl Scouts of America, General Service Administration
G, S, A : x, Girl Scout of America;General Service Administration
G, S, C : x, General Staff Corps
G, S, C, : x, General Staff Corps
G, S, M, D, : x, Guildhall School of Music and Drama
G, S, P : x, Good Service Pension
G, S, T : x, Greenwich Sidereral Time
G, T : x, gross ton
G, T, : x, gross ton
g, t, : x, gilt top 윗둘레 금박
g, t, : x, gilt top머리 금붙임
G, T, C : x, good till canceled (countermanded) 취소할 때까지 유효
G, T, C, g, t, c : x, good till canceled(countermanded)
g/l : x, grams per liter
gab : n, 수다(떨다), 쓸데없는 지껄임, 능변
gab : n, (기)갈고리(=hook)
gab;le end : n, 박공벽
GABA : n, gamma-aminobutyricacid, 감마아미노 낙산(포유류의 중추신경에 생기는 아미노산)
Gabar : n, 이란파의 배화교도, 이란인 조로아스터 교도
gabardine : n, 개버딘(능직 방수 복지), 개버딘제의 옷(=GABERDINE)
gabber : n, 수다쟁이, (라디오의)해설가
gabble : vi, vt, n, 빠르게 지껄이다, 재잘(종알)거리다, (거위등이)꽥꽥 울다, 빠르게 말하다, (영문도 모를 말을)지껄여대기
gabbler : n, 지껄여대기
gabbro : n, 반려암
gabbroic : a, 
gabby : a, 말많은, 수다스러운
gabelle : n, 세금, 염세(프랑스 혁명 이전의)
gaberdine : n, 품이 크고 긴 상의(특히 중세 유대인의)
gaberlunzie : n, (스코)떠돌이 거지, 동냥자루
Gaberones : n, 가보로네(Botswana의 수도)
gabfest : n, 잡담(수다)의 모임, 방담회
gabion : n, 보람, 돌망태(방축, 둑 등의 기초 공사용)
gable : n, 박공, 박풍, 박공 구조
gabled : a, 박공 구조의, 박공을 단
gable roof : n, 박공지붕
gable roofed : a, 박공 구조의
gablet : n, 작은 박공(창 윗부분등의)
gabletop carton : n, 우유.과즙 등을 넣는 박공 지붕 모양의 종이 용기
gable window : n, 박공창
Gabon : n, 가봉(아프리카 남서부의 공화국, 수도 Libreville)
Gabonese : a, 가봉의, 가봉 사람의
gaboon : n, 타구(=spitton)
Gaborone : n, 가보로네(Botswanna의 수도)
gabriel : n, 남자 이름, 천사 가브리엘(성모 마리아에게 예수의 잉태를 알린)
Gabrielle : n, 여자이름
gaby : n, 바보, 멍텅구리(=foot)
gad : vi, 나다니다, 돌아다니다, 쏘다니다, <초목이>우거지다
gad : n, 촉, 창끝, 뾰족한 막대기(가축을 모는데 쓰는)
gad : vt, (God의 완곡한 변형)저런, 당치도 않다
Gad : n, 갓(야고봐 실바의 아들, 창세기)갓 족(이스라엘 12족의 하나), 갓(다윗 시대의 예언자)
gadabout : a, n, 나다니는(사람), 쏘다니는(사람), 여행하며 돌아다니는(사람)
gadder : n, 
gadfly : n, 등에, 말파리, 쇠파리, 성가신 사람
gadget : n, (기계의)부속품, 간단(편리)한 장치, 묘안
gadgeteer : n, 기계 만지기를 좋아하는 사람
gadgetry : n, (가정용 등의)소도구(기계)류, (기구류의) 허섭쓰레기
gadgety : a, 기계 만지기를 좋아하는, 발명을 좋아하는, 장치가 있는, 장치로서 간편한
gadhelic : a, =Goidelic
gadid : a, n, 대구속의, 대구(같은)
gadolinite : n, 가돌린석
gadolinium : n, 가돌리늄(희토류 원소, 기호 Gd)
gadroon : n, 휘어진 주름새김, 둥근 주름 장식(은식기의 가장자리등)
gadsman : n, 막대기로 가축을 모는 사람
gadwall : n, 알락오리
Gaead : n, 가이아(대지의 여신)
Gael : n, 게일사람(스코틀랜드고지, 아일랜드 등지의 켈트 사람)
Gael : n, Gaelic
Gaelic : a, n, 게일족(어)의, 게일어
Gaelic football : n, 게일식 축구(주로 아릴랜드에서 행해지는 1인, 2팀간의 축구
Gaeltacht : n, (아일랜드의)게일어 사용 지구
gaetkeeper : n, 문지기, 건널목지기
gaff : n, vt, 갈고리대(작살의 일종), 개프, 사형(종범 상부의), (물고기를)갈고깃대로 끌어 올리다(찍다), 속이다, 속임수를 쓰다
gaff : n, 엉터리, 곤경
gaff : n, 싸구려(삼류)극장, (보통 penny~ 라고 함)
gaffe : n, (사절, 외교상의)과실, 실수
gaffer : n, (시골의)늙은이, 영감, 두목, 감독, 십장, 전기(조명)주임
gaffrigged : a, 개프 범장의
gaff sail : n, 개프 세일
gaff topsail : n, 개프톱세일(gaff sail위에 단 삼각돛)
gag : n, vt, vi, (질식 소리를 흉내낸 의성어)재갈, 입마개, 언론탄압, 토론 종결, 개구기, 재갈을 물리다, 언론을 탄압하다, 게우게 하다, 웩웩거리다
gag : n, vt, vi, 개그(배우가 임기응변으로 하는 익살, 농담), 사기, 거짓말 , 개그를 넣다, 속이다
gaga : a, n, 어수룩한(영화팬), (the ~s 무비판한 족속들), 늙은, 망령 들린, 열중한
Gagarin : n, 가가린(소련의 우주 비행사, Vostok I을 타고 세계 최초의 우주 비행에 성공(1961))
gagbit : n, 재갈(말 길들이는데 씀)
gage : n, 저당물, 도전(의 표시로 던지는 물건)(장갑 따위)
gage : n, (미)=GAUGE
gage : n, 담배, 마리화나 담배, 싸구려 위스키
gager : n, =GAUGER
gagers : n, 눈알
gag fein : n, 재갈 고삐(말 길들이는데 씀)
gagger : n, 언론을 억압하는 사람, 물림판, 개그작가(개그맨)
gaggle : n, 거위떼(가 꽥꽥 울다), (여자들의)무리, (시끄러운)집단, 
gaglaw : n, ㄴ언론통제법, 함구령
gagman : n, 개그 작가, 개그맨, 개그에 능한 희극 배우
gag order : n, (법정에서 심리중인 사항에 관한)보도(공표)금지령, 함구령
gag resolution : n, (노예제 반대 청원에 대한)불채택(심의거부)결의(1836-44년에 몇차례 의회 통과)
gagroot : n, 로벨리아
gag rule : n, (어떤 문제에 대한)토론 금지령, 함구령
gagster : n, 개그작가, 농담꾼, 장난꾸러기, 어릿광대
gag strip : n, (연속된 줄거리가 없는)개그 만화
gahnite : n, 가닛, 아연 첨정석
Gaia : n, =Gaea
gaiety : n, 유쾌, 쾌활, (의복 등의)호사 화려, (pl, )환락, 법석
Gail : n, 남자 또는 여자 이름
gaillardia : n, 엉거시과의 풀(미국 서부산)
gaily : ad, 흥겹게, 유쾌(화려)하게, 야하게
gain : vt, 얻다, 이기다, 획득하다, (무게, 힘 등이)늘다, (시계가)더 가다
gain : vi, 이익을 얻다, 나아가다, 잘되다, ~ (up)on ~에 접근하다, (아무에게) 빌 붙다, ~에 침식하다, ~ over 설복시키다, (자기 편으로)끌어들이다
gain : n, 이익, 증가, 진보, (pl) 이득, 벌이
gainable : a, 얻을수 있는, 달할 수 있는
gain control : n, (전자)(수신기, 중폭기의)이득 제어
gainer : n, 획득자, 이득자, 승리자, 뒤로 재주넘는 다이빙
gainful : a, ad, 이익이 있는, 벌이가 되는, 수지맞는(=paying), (직업등이)유급인, 돈벌이에 열중한, 이익이 나도록, 유급으로
gainings : n, 이득, 소득, 벌이
gainless : a, 이익이 없는, 무익한
gainly : a, (태도등)경쾌한, 민활한, 우아한
gainsaid : v, gainsay의 과거(분사)
gainsay : vt, n, 반박(부정)하다, 부정, 반론
gainsayer : n, 반박자, 부정자
gainst : n, AGAINST:prep=AGAINST
gaint sequoia : x, =BIG TREE
gait : n, vt, 걷는 모양, 걸음걸이, (말의)보조, (말에)걸음걸이를 조련하다, (개를)심사원 에 걷게하다
gaited : a, (보통 복합어를 이루어)걸음걸이가 -한
gaiter : n, 각반, 각반모양의 목 긴구두
gaitered : a, 각반을 친
Gaitskell : n, 게이츠켈(영국의 경제학자, 정치가, 노동당 당수)
gal : n, =GIRL
gal : n, 가속도 단위
Gal : n, Galatians, gal, gallon(s)
gala : n, 축제(의), 제례, - dress 나들이 옷
galactic : a, 은하의, 젖의, 젖에서 얻은, 은하계의, 성운의
galactic circle : n, (equ'tor)은하 적도
galactic noise : n, 은하전파
galactic plane : n, 은하면
galactic pole : n, 은하극
galactometer : n, 검유기(=lactometer)
galactose : n, 갈락토스(유당의 성분)
galah : n, 분홍앵무(호주 원산), 바보, 멍청이(=fool)
Galahad : n, 아서왕 이야기 중의 원탁의 기사의 한 사람, 고결한 남자
galantine : n, 갤런틴(닭고기, 송아지 고기 등의 뼈를 바르고 향미료를 넣어 삶은 음식, 식혀서 먹음
galanty show : n, 그림자 그림연극, 겉만 화려한 구경거리
Galapagos Islands : n, 갈라파고스 제도(에콰도르 서쪽 해상의)
galatea : n, 고급무명(보통 흰 바탕에 푸른 줄이 있음
galatea : n, 갈라테아(키프로스왕 Pygmalion이 만든 상아의 처녀상, Pugmalion은 Aphrodite에게 기원하여 그 상에 생명을 부여받았음)
Galatia : n, 갈라디아(소아시아 중부의 옛왕국
Galatian : a, n, 갈라디아(사람)의, 갈라디아 사람
Galatians : n, pl, , 갈라디아 서
galavant : vi, (=GALLIVANT)
galaxy : n, 은하, 은하수, 은하계, (미인, 재사 등의)화려한 무리
galbanum : n, 갈바눔, 풍자향(고무질 수지, 의약, 향료용
Galbraith : n, 갤브레이스(캐나다 태생의 미국 경제학자)
Galbraithian : n, a, 갤브레이스주의(의), 갤브레이스주의자(의)
gale : n, 강풍, 큰바람, 폭풍, 실바람, 폭소, 환희, 흥분 상태, 미풍, 광희
gale : n, 버드소귀나무의 일종
gale : n, (=SWEET GALE)
gale : n, 정기 지불금(지대, 이자등의)
galea : n, 도상체, 도상 돌기
galeate : n, 헬멧을 쓴
galeated : a, 투구 모양의
galeeny : n, 뿔닭(=guinea fowl)
Galen : n, 갈레노스(그리스의 의사), (익살)의사)
galena : n, 방연광
Galenic : a, 갈레노스의, 갈레노스타 의술의, (보통)생약의, 본초약의
galenical : n, a, 본초약, 생약, 본초약(생약)의, 갈레노스파의
galenite : n, (=GALENA)
galere : n, 달갑지않은, 패거리, 동아리, 뜻밖의 상태, 난처한 입장, 곤란한 처지
Galician : a, n, 갈라시아(인, 어)의, 갈리시아어(인)
Galilean : a, n, Galilee의(사람), (the ~)=JESUS, Galileo의
Galilee : n, 예배실(교회당 서쪽의), 현관
Galilee : n, 갈릴리(Palestine 북부의 옛 로마의 주)
Galileo : n, (1564~1642)Galilei(1564~1642) 이탈리아의 물리학자, 천문학자
galimatias : n, 뜻을 분별할 수 없는 말, 횡설 수설(=nonsense)
galingale : n, 방동사니의 일종(남부 영국산)
galiot : n, (옛날 지중해에서 쓰던)작은돛배, 네덜란드의 작은어선(상선)
galipot : n, 갤리폿(송진의 일종)
gall : n, 담즙(bile), 담낭, 쓸개, 쓴것, 진절머리, 증오, 뻔뻔스러움, dip one's pen in ~ 독필을 휘두르다
gall : vt, n, 스쳐벗어지게하다, 노하게하다, 애태우다 , 찰과상, (특히 말의 등의) 스쳐서 벗겨진 상처, 걱정거리
gallant : a, 훌륭한, 당당한, 화려한, 용감한, 기사적인, 여성에게 친절한, 연애의 ~ adventures 정사
gallant : n, 용감한 사람, 여성에게 친절한 남자, 상냥한 남자
gallantly : ad, 용감하게, 씩씩하게, (여성에게)정중하게, 친절하게
gallantry : n, 용감, 여성에게 친천함, 정중한 말씨, 정사, 연애관계
gallbladder : n, 담낭, 쓸개
galleass : n, 갈레아스선(옛날 스페인의 3(4)층 갑판의 대범선)
galleon : n 스페인의 큰 돛배(상선, 군함)
galleried : a, 회랑이 있는, 갱도(지하도)가 있는
gallery : 회랑, 주랑, 노대, 복도(건물의 내부에 면하고 홍예받이로 받쳐진), (교회당, 회관 등의)특별석, 높이  불쑥 나온 별석, (극장의)맨 위층 관람석(가장 싼), 꼭대기 관람석의 관객, 좀고 긴방, 실내 사격  연습장, 넓은 복도, 갱도, 지하도(두더지 등의)지하 통로, 미술관, 화랑, 미술품 진열실(전시장), 사진촬영소, 남포의 등피받치개
gallery forest : n, 대초원의 강을 따라 생긴 대상림
gallery hit : n, 대인기(를)끌기
galleryite : n, 극장의 꼭대기 관락석의 관람객, 일반 관람객, 팬
galley : n, 갤리배(노예가 노를 젓는 돛배), (고대 그리스, 로마의)군함, 대형보트, (선내의)취사실, 게라(스틱으로부터 옮긴 활자를 담는 목관)
galley proof : n, 교정쇄
galley slave : n, 갤리배를 젖는 노예, 고역을 맡은 사람
galley west : ad, 철저하게(당하여)
gallfly : n, 몰식자벌
galliambic : a, 갤리앰버스격의, 단단장장격의
galliard : n, 경쾌한 3박자의 춤(곡)
Gallic : a, 골(사람)의, 프랑스의
gallic : a, 갈륨의
gallic : a, 오배자의, 몰식자성의
gallic acid : n, 갈산
Gallican : a, n, (=Gallic), 고대 프랑스 교회의, 갈리아주의의(프랑스의 카톨릭 교회에서의), 갈리아주의자, 프랑스의 카톨릭교도
gallicism : n, (독특한)프랑스어법, 프랑스어풍
gallicization : n, 
Gallicize : vt, vi, 프랑스풍으로 하다, 프랑스화하다
galligasking : n, pl, 느슨한 바지, (잇살)헐렁한 바지, 가죽 각반
gallimaufry : n, 주워 모은 것, 잡동사니, 잡탕(수프)
gallinacean : n, 순계류의 새(닭, 꿩, 자고새등)
gallinaceous : a, 가금의, 순계류
galling : a, 울화 치미는, 속타게하는
gallinipper : n, (미국산)큰모기, 쏘는(무는)벌레
gallinule : n, 쇠물닭류의 물새
Gallio : n, 직무외의 책임을 피하는 사람(종교의 간섭을 거부한 로마의 지방 총독의 이름)
galliot : n, (돛과 노를 사용하는)쾌속 소형 갤리선(옛날 지중해의)
Gallipoli Peninsula : n, 갈리폴리 반도
gallipot : n, (작은)약단지
gallium : n, 갈륨(희금속 원소, 기호 Ga)
gallium arsenide : n, 비화 갈륨, 갈륨 비소(반도체 재료)
gallivant : vi, 이성의 꽁무니를 쫑아다니다, 건들건들 놀러다니다
gallnut : n, 몰식자, 오배자
Gallo : n, (연결형)(French)의 뜻
Gallomania : n, 프랑스 심취(광)
Gallomaniac : n, 프랑스에 심취한 사람, 프랑스 숭상자
gallon : n, 갤런(=4 quarts), 영국에서는 약4, 5리터 미국에서는 약 3, 8리터
galloon : n, 좁다란 레이스(리본), 끈목(때때로 금실, 은실을 짜넣은)
gallop : n, vi, vt, 갤럽(말의 전속력 구보), 급속도, 갤럽으로 달리(게 하디), 급속도로 나아가다
gallopade : n, 갈로파드(2/4)박자의 빠르고 약동적인 헝가리 춤), 그무곡
galloper : n, 말을 갤럽으로 모는 사람, 질주하는 말, 전령장교
Gallophile : a, n, 프랑스를 좋아하는(사람)
Gallophobe : a, n, 프랑스를 싫어하는(사람)
Gallophobia : n, 프랑스를 혐오하는 사람
galloping : a, 급속도의, (병세가)급속히 진행하는, 분마성 폐렴
galloping inflation : n, 급성 인플레이션
gallous : a, 제1갈륨의, 2가의 갈륨을 함유한
Galloway : n, 복마, 작은말, 갤러웨이 종 육우
gallows : n, 교수대, 교수형, (pl, )바지 멜빵
gallows bird : n, 극악한 사람
gallows humor : n, 위험을 앞에 두고 빈정거리는 유머
gallowsripe : a, 교수형에 처해야 할 
gallows tree : n, 교수대(gallows)
gallstone : n, 담석
Gallup : n, 갤럽
gallup poll : n, (통계학자 G, H, Gallup지도의)갤럽여론조사
gallused : a, 바지 멜빵을 한
galluses : n, 바지 멜빵
gall wasp : n, 어리상수리흑벌
galoot : n, 얼빠진 사람, 어리보기
galop : n, 갤롭(경쾌한 춤), 그 곡
galop : vi, 갤롭을 추다
galore : ad, 풍부하게
galosh : n, =OVERSHOE
gals, : x, gallons
Galsworthy : x, John(1867~1933)영국의 소설가, 극작가(1932년 노벨 문학상)
galumph : vi, 의기양양하게 걷다
galv, : x, galvanized
galvani : x, Luigi(1737~1798)이탈리아의 생물학자, 물리학자
galvanic : a, 동전기의, (웃음 따위가)경련적인, 깜짝 놀라게하는
galvanically : ad, galvanic의 ad형
galvanic current : n, 직류
galvanic pile : n, 전퇴
galvanic skin response : n, 전기 피부 반응(거짓말 탐지기에 응용)
galvanism : n, 동전기, 전기 요법
galvanizaion : n, 직류 전기를 통함, 직류전기 치료, 전기 도금, 급격한 자극으로 활기를 넣음
galvanize : vt, 동전기를 통하다, 활기를 띠게 하다, 전기도금하다, ~d iron 함석
galvanized iron : n, 아연 철판(양철)등
galvano- : (연결형)(갈바니 전기의)뜻
galvanoacupuncture : n, (=ELECTROACUPUNCTURE)
galvanograph : n, 전기판(인쇄물)
galvanography : n, 전기 제판술
galvanometer : n, 검류계
galvanometric : a, 검류계의, 검류계로 잰
galvanometry : n, 전류측정(법)
galvanoplastric : a, 전기판술(전기 주조법)의
galvanoplastrics : n, 전기 주조(법), 전기판술
galvanoscope : n, 검류기
Galveston : n, 갤버스턴(미국 Texas주 Galveston만 입구의 섬에 있는 해항)
galways : n, 구레나룻
Galwegian : a, n, 스코틀랜드 Galloway지방의, Galloway의 주민
gam : a, n, vt, 고래 떼, 사교적인 방문(고래잡이 배들 사이의), (고래떼처럼)몰려들다, (고래잡이배의 선원이)방문 교환하다, (친구등을)상호 방문하다, (시간을)환담하며 보내다
gam : n, 다리, (특히 여자의)날씬한 다리
gam- : 에서는 gam-) (연결형)(암수가 합친, 자웅 합체의)의뜻(모음)
gam, : x, (=gamut)
Gama : n, 가마 Vasco da(포르투갈의 항해자)
gamb : n, 짐승다리
gamba : n, (=VIOLA DAGAMBA)
gambade : n, (=GAMBADO)
gambado : n, 도약(말의), 깡충깡충 뛰어다님, (발레의)도약, 희룽거림
gambado : n, (등자 대신)안장에 붙인 장화(각반), 긴 각반
Gambia : n, a, 아프리카 서북의 공화국, ~n 갬비아의(사람)
Gambian : n, a, 감비아 사람, 감비아(사람)의
gambier : n, 빈랑고, (갬비어)아선약(수렴제)
gambit : n, (체스)(졸 따위를 희생하고 두는)첫수, (거래 등의)시작
gamble : vi, 도박하다, ~in stocks 투기하다
gamble : vt, 도박으로 잃다(away)
gambler : n, 노름꾼, 도박(투기)꾼
gamblesome : a, 노름을 즐기는
gambling : n, 노름, 도박
gambling house : n, 노름꾼 소굴, 도박장
gamboge : n, 자황(영대 수지에서 뽑는 치자빛 그림물감, 하제)
gambol : vi, 깡충깡충 뛰놀다
gambrel : n, (말 따위의)과 관절=~rooof 물매가 2단으로 굽은 지붕
game : n, 유희, 오락, 농담, 경기, 한판, 승부의 점수, 경기회, 책략, The same old ~! 또 그 수법이군
game : a, 투지에 찬, 용감한, 자진해서 ~하는(for, to do), die ~ 용감히 싸우다 죽다, 끝까지 버티다
game : vt, vi, 내기하다, 내기에 잃다
game : a, = LAME (his ~ leg)
game act : n, 수렵법
game bag : x, 사냥감 넣는 주머니
game ball : n, 게임볼(정구 등에서 한 점으로 어느 편이 이기게 되는 때의 서브)
game bird : x, 엽조
game breaker : n, 시합의 승패를 결정하는 플레이(선수)
gamecock : n, 투계, 싸움닭, 용감한 사람
gameelan : n, 가멜란(가멜란 음악에 쓰이는 실로폰 비슷한 타악기)
game fish : x, (낚시를 대상이 되는)물고기
game fowl : x, 싸움닭
game keeper : n, 사냥터지기
game laws : x, 수렵법
game license : x, 수렵 면허
gamely : ad, 투계같이, 용감하게
gameness : n, 용기, 불굴의 정신
game park : x, (아프리카 등의)동물 보호 구역)
game plan : x, (경기의)작전 계획, (면밀한)행동 방침, 작전
game point : x, (테니스 등의)게임 포인트(한 게임의 승리를 결정하는 점수)
game preserve : x, 금렵구
game preserver : x, 엽조수 보호 구역 설치자
game reserve : x, (=game preserve)
game room : n, 오락실
gamesman : n, 흥정에 능한 사람, 책사
gamesmanship : n, 반칙비슷한(비신사적)술수를 써서 이기려 하기(경기.경쟁에서)
games master : n, 체육 교사
games mistress : n, 여자 체육 교사
gamesome : a, 놀이를 좋아하는, 장난을 좋아하는, 뛰노는, 희룽거리는
gamester : n, 도박꾼, 노름꾼
gamet- : x, (연결형)배우자, 생식체의뜻
game table : n, 도박대
gamete : n, 배우자, 생식체
game tenant : x, 수렵(어렵)권 임차인
game theory : x, 게임의 이론(불확정한 요소 중에서 최대의 효과를 올리는 수학적 이론)
game therapy : x, 유전 요법(유전자 공학에 의한 유전상의 결합을 개선)
gametic : a, 배우자의
gametocyte : n, 배우자 모세포, 생식 모세포
gametogenesis : n, 배우자형성
gametophyte : n, 배우체
gametying : a, (스포츠)동점의
game warden : x, 수렵 감시관
gamewinning RBI : x, 승리타점
gamey : a, (=GAMY)
gamic : a, 유성의
gamily : ad, 용감하게
gamin : n, 부랑아
gamine : n, 말괄량이, 깜찍한 장난꾸러기 계집애
gaminess : n, 용감, 용맹
gaming : n, 도박, 내기
gaming house : n, 노름집, 도락장
gamma : n, 그리스어 알파벳의 세째 자(영어에 G, g에 해당)
gamma decay : x, 감마 붕괴(감마선 방출에 의한 원자핵의 붕괴, 광자 방출에 의한 소립자 붕괴)
gammadion : n, 대문자 감마를 결합해서 만든 장식적 도형
gamma globulin : x, 감마글로불린(혈장에 포함된 단백질의 한 성분)
gamma radiation : n, 감마 방사선, 감마선 방사
gamma radiation sterilization : n, 감마선 조사 살균(밀봉된 상품의 살균도 가능)
gamma ray : x, 감마선
gammaray astronomy : n, 감마선 천문학(천체가 방출하는 감마선으로 그 천체를 연구함)
gammaray laser : n, (=GRASER)
gammasonde : n, (대기 상부의)감마선 강도 관측기
gamma surgery : x, 감마선 외고(감마선에 의한 암세포 파괴나 파틴슨병의 치료등)
gammer : n, 할머니, 노파
Gammexan : n, 농업용 살충제(상표명)
gammon : n, 허튼 소리, 사기
gammon : vi, vt, 속이다
gammon : n, 베이컨의 허벅지 고기, 훈제햄
gammon : vt, (제1기움돛대를)이물에 고정시키다
gammoning : n, 이물의 제1기움돛대를 매는 밧줄(사슬)
gammy : a, 
gamogenesis : n, 암수생식, 양성 생식
gamopetalous : a, 합성화판의 통꽃잎의
gamp : n, 큰 박쥐우산
gamut : n, 온음정, 전범위, 전역, run the ~ of 온갖(표현)을 해보다
gamy : a, 엽조(엽수)의 냄새가 나는, (고기가)약간 상한
gan : n, (=begin)의 과거
ganappe : n, 견모사
gander : n, goosed의 수컷, 얼간이
ganderneutral : a, 성적 구별이 없는
Gandhara : n, 거위의 수컷, 바보, 얼간이, 아내와 별거중인 남편, 한범 홀낏 봄
Gandhi : x, 간디(무저항주의를 내세운 인도의 지도자)
gandy dancer : n, 철도 보선공, 임시(계절)노동자
ganef : n, 좀도둑, 비열한 기회주의자
gang : n, (노예, 노동자등의)일단, 패, (악한의)일당, 놀이친구, 한동아리, (조립식도구의)한 벌 , 집단을 이루다
gang : vi, 집단을 이루다
gang : vi, 가다, 걷다
gang bang : x, (한 여성 상대의)난교, 파티, 윤간
gangboard : n, (=GANGPLANK)
gangbuster : n, 경찰의 강력계
ganger : n, (노동자들의)두목, 십장
ganges : n, 갠지스강(벵골 만으로 흐르는 인도의 큰강
gangetic : a, 갠지스강의
ganggle : vi, (사람, 물건등이)어색하게 움직이다
gangglia : n, GANGLION의 복수
gang hook : n, 닻 모양의 낚시 바늘
gangion cell : x, 신경절 세포
gangister : n, 개니스터(노의 내벽용 내화성 규질암)
gangland : n, (갱들이 판치는)암흑가
gangliated : a, (=GANGLIONATED)
gangling : a, (몸이)후리후리한, 껑충한
ganglionic : a, 신경절의
gangly : a, (= GANGLING)
gangmaster : n, (노동자의)우두머리, 십장
Gang of Four : x, 4인방(중공의 문혁파의 과격파)
gangplank : n, 배다리, 트랩(배와 부두 또는 선창을 연결하는 널판
gang plow : x, 연동식 모습
gangrape : n, vi, 윤간(하다)
gangrene : n, vi, vt, 회지(가 되다, 되게하다)
gang shag : x, =GANG BANG
gangsman : n, =ganger
gangster : x, 갱의 한 사람, 악한
gangsterism : n, 갱 행위, 폭력 행위
gangue : n, 맥석
gangway : n, 현문=GANGPLANK, 좌석의 통로, (방해다)비켜라!
ganja : n, 마리화나
gannet : n, 북양가마우지(해조)
gannet : n, 북양가마우지
ganoid : n, a, 경린어(철갑상어따위), 경린(어)의
gantian : n, 용담속
gantlet : n, =GAUNTLET
gantry : n, (이동 기중기의)구대, (신호기를 받치는)구름다리
gantry crane : x, 고가 이동 기중기
Ganymede : n, Olympus 신들의 술시중을 드는 미소년, 술시중꾼, 가니메데이성(목성의 제 3 위성)
GAO : x, General Accounting Office 회계 감사원
gaol : x, =JAIL
gaolbird : n, =JAILBIRD
gaolbreak : n, =JAILBREAK
gaoler : n, =JAILER
gap : n, vt, 갈라진 틈(을 내다), 산이 끊어진 데, 산협, 결합, 간격, 차이
GAPA : n, ground, to, air pilotless aircraft, 무선 유도 비행기
gape : n, vi, 하품(하다), 딱 벌린 입, 입을 크게 벌리다, 입을 벌리고 바라보다, 갈라진 틈, the ~s 하품(의 연발), (닭 따위의)부리를 헤벌리는 병
gaper : n, 입을 딱 벌리고 멍하니 바라보는 사람, 하품하는 사람, 다랑조개의 일종, 넓적부리새
gapeseed : n, 백일몽, 몽상, 터무니 없는 계획(목표), 사람을 아연케 만드는 일, 입을 벌리고 바라보는 사람
gapeworm : n, 기관개취층
gapingly : ad, 입을 벌리고, 멍하니, 어이없이
gapless : a, 끊어진 데가 없는, 갈라진 틈이 없는
gaposis : n, (단추, 스냅등을 채웠을때 옷이 팽팽해져서 생기는)틈, 갭, 간격, 결합
gapped : a, 금(틈)이 많은
gapped scale : x, 갭트 스케일(실제 쓰지 않은 음을 뺀 음계
gappy : a, 틈 투성이의, 결함 있는, 연락없는, 토막토막의
gaptoothed : a, 치열에 틈이 생긴
gar : n, 동갈치
garage : n, (자동차)차고, 개라지, 격납고
garageful : n, 차고(정비 공장)에 가득한 양
garageman : n, 자동차 수리공
garage sale : x, (중고 가구 등의)투매(이사 갈 때 따위)
garage shop : n, 자택의 차고를 개조한 것 같은 조그마한 공장
garage studio : x, 간이 녹음 스튜디오(음향효과, 공간 등의 배려가 안 되어 있음)
Garand rifle : x, 반자동식 소총
garb : n, (직업, 직위 등을 알 수 있는)복장, (한 벌의)옷, 외관, 모양
garb : vt, ~에게 (~의)복장을 입히다
garbage : n, (부엌의)쓰레기, 고기찌끼, 찌꺼기
garbage can : x, (부엌의)쓰레기통
garbage collection : x, 불요 정보 정리(정리된 스페이스를 만드는 기술)
garbage collector : n, 쓰레기 수거인
garbage disposal : n, 음식 찌꺼기 처리기
garbage drug : n, 역효과를 초래하기 쉬운 마약(접착제나 시너 등)
garbage dump : n, 쓰레기 처리장
garbageology : n, 주개학(폐기물의 내용에서 문화, 사회를 연구하는 학문)
garbage truck : x, 쓰레기차
garble : vt, (자료, 원고 등을)멋대로 고치다, (고의로)오전하다
garbo : n, 쓰레기 수거인
garboard : x, 용골익관
garbologist : n, 쓰레기 수거인, 쓰레기 연구가(학자)
garbology : n, 쓰레기학
garcon : n, 급사, 보이
garda : n, 아일래드인 경관(경호원)
gardant : a, =GAUARDANT
garden : n, 정원, (pl, )유원지, 비옥한 땅
garden apartment : x, (저층의)정원 딸린 아파트
garden balm : x, 향수 박하
garden balsam : x, 봉숭아
garden city : x, 전원 도시
garden cress : x, 튼다닥냉이(향신료, 샐러드용 야채)
gardener : n, 원예사, 정원사, 조원업자, 원예(애호)가, 취미로 정원 가꾸는 사람, 채소 재배자, 외야수
gardenesque : a, 정원 같은, 정원풍의
garden frame : x, 촉성 재배용 온상
Garden Gtate : x, 미국 New Jersey주의 별칭
garden house : n, 정원에 있는 정자, 옥외변소(조로 미국 남부, 중부)
gardenia : n, 치자나무, 치자나무 꽃
gardening : n, 뜰 가꾸기, 원예
garden party : x, 원유회
garden plant : x, 원예 식물, 재배 식물
garden plot : x, 정원(채원)부지
garden seat : x, 정원벤치
garden spider : x, 무당 거미
garden state : n, 미국 NEW JARSEY주의 속칭
garden stuff : x, (집안의 채마밭에서 가꾼)야채
garden subrub : x, 전원 주택지
garden truck : x, 시장으로 나갈 야채, (흙 운반용)2륜차
gardenvariety : a, 흔해빠진, 보통(종류)의
garden warbler : x, 정원솔새(유럽산)
garden white : x, 배추흰나비
garderobe : n, 옷장(의 의류), 침식, 사실, 변소
garefowl : n, 큰 바다오리
Gareth : n, 남자 이름, 개리스(Arthur왕의 조카, 원탁의 기사 중의 한 사람)
Garfield : n, 가필드(미굴 제20대 대통령)
garfish : x, =GAR
Gargantua : n, 가르강튀아(라블레의 소설 중의 굉장한 식욕을 가진 거인)
gargantuan : a, 거대한, 원대한, 엄청난
garget : n, (소, 돼지, 가금 등의)인후 종양, (소, 양의)유방염)
gargety : a, 유방염의(에 걸린)
gargle : vt, vi, n, 양치질하다, 양치질
gargolism : n, 가고일리즘(골격 대사의 이상, 장애 등을 수반하는 질병)
gargoyle : n, (괴물 모양으로 만든)홈통주둥이, 낙수홈
garibaldi : n, 여성, 어린이용 헐거운 블라우스, 건포도를 넣고 살짝 구운 비스킷, 자리돔과의 물고기(남캘리포니아산)
Garibaldi : n, 가리발디(이탈리아의 애국자)
GARIOA : x, Government Appropriation for Relief In Occupied Aress(미국)점령지구제기금
garish : a, 번쩍거리는, 야한, 화려한
garland : n, vt, 화환(화관)(으로 꾸미다)
garlic : n, 마늘
garlicky : a, 마늘 냄새(맛)가 나는, 마늘이 들어 있는
garment : n, 옷(한가지)(skirt coat clock등), 의복
garment bag : x, (여행용)양복 커버(접어서 휴대함)
garn : int, 허어(불신, 모멸)
garner : n, vt, 곡창, 저장소, 축적(하다)
garnet : n, 석류석
garnet paper : x, 사포
garnish : n, vt, 장식(을 달다), 문식(하다), (음식에)고명(을 얹다)
garnishee : n, vt, garnishment를 받는 사람, (채권을)압류하다, 압류를 통고하다
garnisher : n, 장식자, 채권 압류 통고자
garnishment : n, 장식, 압류 통고, 출정 명령
garniture : n, 장식(품), 요리에 곁들인 것, 고명
garotte : N, =GARROT(T)E
GAROTTER : n, =GARROT(T)ER
GARP : x, Global Atmospheric Research Program(Project)
garpike : n, =GARFISH
garret : n, (망루의 뜻에서)다락방, 제일윗층, 초라한 작은 방, 머리
garreter : n, 다락방에 사는 사람, 싸구려 문인, 가난뱅이 작가
garrion finish : x, (경마 등에서의)역전승
garrison : n, vt, 수비대(를 두다), 요새지(로서 수비하다)
garrison artillery : x, 요새 포병
garrison cap : x, 약모
garrison decree : x, 위수령
garrison state : x, 군국
garrison town : x, 위수 도시, 수비대 주둔 도시
garron : n, 사역용 조랑말
garrot(t)e : n, vt, (스페인의)교형구, 교수형, 교살 강탈(사람 뒤에서 줄 등으로 목을 졸라 금품을 빼앗는, 교수형에 처하다, 목을 졸라 금품을 빼앗다
garrote : n, vt, 교수형, 교수형에 처하다, 교살하고 소지품을 빼앗다
garrotter : n, 교살자, 교살 강도
garrulity : n, 수다, 말많음
garrulous : a, 잘 지껄이는
garryowen : n, 채공시간이 긴 높은 볼킥(필드의 포지션을 유리하게 하기 위한 전법)
garter : n, 양말 대님(으로 동이다), 가터 훈장(훈위)
garter belt : x, (여성용)양말(가터)벨트
garter snake : x, 누룩뱀(북미, 중미산)
garter stitch : x, 가터 뜨개질
garth : n, 회랑에 둘러싸인 안뜰, (물고기를 잡기 위한)어량, 뜰, 안뜰
Garveyism : n, (자메이카의 흑인민족주의자 이름에서)흑인에 의한 흑인 분리 독립주의
Gary system : x, 게리식 학교 제도
gas : n, , 기체, 가스, 웃음가스(laughing gas), 독가스, 가솔린, 허풍, 객적은 소리, step on the ~ 액셀러레이터를 밟다, 가속하다, 서두르다
gas : vt, 가스를 내다, 가스로 중독 시키다, 독가스를 뿌리다
gas alarm : x, 독가스 경보
gas attack : x, 독가스 공격
gasbag : n, 가스 주머니, 비행선, 경기구, 허풍선이, 수다쟁이
gas bomb : x, 독가스탄
gas bracket : x, 가스등 받침(벽에서 내민)
gas buoy : x, 등부표(아세틸렌사스를 연료로 하는)
gas burner : x, 가스 버너
gas carbon : x, 가스 카본, 가스탄(석탄가스 제조중에 생기는)
gas cell : x, 비행선의 가스낭의 한 구획, 가스전지
gas chamber : x, 가스처형실(특히 나치스의)
gas chromatograph : x, 유기화합물 혼합체 분석기
gas chromatography : x, 가스 크로마토그래프법(유기화합물 혼합체 분석법)
gas coal : x, 가스용 석탄
gas coke : x, 가스 코크스(통칭 코크스)
Gascon : n, a, (프랑스의)가스코뉴사람, 제자랑꾼, 허풍선이, 가스코뉴(사람)의, 허풍선이의
gasconade : n, vi, 자랑(하다), 허풍(을 떨다)
gas cooker : x, 가스 레인지
gas cooled : a, 가스 냉각의
gas cooled reactor : x, 가스 냉각로
gas crunch : x, 가솔린 위기
gas cutting : x, (금속의)가스 절단
gasdynamics : n, (단수 취급)기체 역학
gaseater : n, 연료를 많이 소비하는 자동차
gasefficient : a, 연료 효율이 좋은, 휘발유 소비량이 적은
gaseity : n, 가스모양, 가스체
gaselier : n, =GASOLIER
gas engine : x, 가스 내연 기관
gaseous : a, 가스(체)의, 가스상태의, 기체의, 텅빈, 속없는, 믿은 수 없는(정보 등)
gaseous diffusion : x, 기체 확산법
gas field : x, 천연 가스 발생지
gas filter : n, 가스여과기
gas fire : x, 가스불, 가스 난로
gas fired : x, 가스 연료를 사용한
gas fitter : x, 가스공, 가스기구 설치업자
gas fitting : x, 가스 장치 공사, 가스기구(류)
gas fittings : x, 가스 기구
gas fixture : x, 가스(등) 장치, 가스전
gas furnace : x, 가스로, 가스 중류로
gas gangrence : x, 가스 회저
gas gauge : x, =FUEL GAUGE
gas geyser : x, 가스 온수기
gasguzzler : n, 연료 소비가 많은 차, 연료비가 비사게 먹히는 차
gasguzzling : a, (자동차 엔진 등이)연료를 많이 소비하는
gash : n, vt, 깊은 상처, (지면, 바위 등의)깊이 갈라진 틈, 입, 깊은 상처를 입히다, 갈라진 틈을 만들다
gash : a, n, 여분의, 찌꺼기, 폐기물, 쓰레기
gash : a, 빈틈없는, 재치있는, 깔끔한
gas heater : x, 가스 난방기(가열기)
gas helmet : x, =GAS MASK
gasholder : n, 가스 탱크
gashouse : n, 가스 공장
gasifiable : a, 가스체로 변할수 있는, 기화할 수 있는
gasification : n, 가스화, 기화, 가스의 지하 발생
gasification desulfurization process : x, 가스화 탈유황 처리(법)(중질유에서 유황분을 제거하는 기술)
gasiform : a, 가스체의, 기체의
gasify : vt, vi, 가스화(기화)하다, 가스가 되다, 기화되다
gas jet : x, 가스 화구, 가스의 불꽃
gasket : n, 괄범삭, 개스킷(실린더, 파이프 등의 결합부를 메우는 고무, 석명, 코르크 등의 판 또는 테), (일반적으로)틈 메우는 물건, 패킹
gas lamp : x, 가스등
gas laser : x, 기체 레이저
gaslight : n, a, 가스등, 가스등의 불빛, 가스등의 점화구, 가스등 시대의
gas lighter : x, 가스의 점화구, 가스라이터
gaslight paper : x, 가스라이트지(밀착용 인화지)
gas line : x, 주유하려는 자동차의 행렬
gasline bomb : x, 가솔린 폭탄, 화염병
gas liquid chromatography : x, =GAS CHROMATOGRATOGRAPHY
gas log : x, 가스 난로 연관
gas main : x, 가스(공급용)본관
gasman : n, 가스업자, 가스 사용량 검사원, 가스료 수금인, 폭발 가스 경계원
gas mantle : x, 가스맨틀(가스등의 밝기를 높이기 위하여 점화그에 덮어 씌우는 그물)
gas mask : x, 방독면
gas masked : a, 방독면을 쓴
gas meter : x, 가스 미터
gas motor : n, =GAS ENGINE
gasogene : n, 가스 발생 장치
gasohol : n 가소홀(휘발유에 알코올을 10! 정도 탄 연료, 휘발유 대체품으로 등장)
gas oil : x, 경유
gasolier : n, 가스등으로 장식된 샹들리에
gasoline engine : x, 가솔린 기관
gasoline mileage : x, 연비(휘발유 1갤런으로 달릴 수 있는 마일 수로 나타내는)
gasolinic : a, 
gasometer : n, 가스 계량기, 가스저장기, 가스탱크
gas oven : n, 가스 조리기, 가스 레인지
gasp : n, vi, vt, 헐떡거림, (공포, 놀람등으로)숨막힘, 헐떡거리다, (놀람등으로)숨이 막히다, 열망하다, 헐떡거리며 말하다
GASP : x, Group Against Smoker's Pollution, 여러가지 반공해, 반흡연 단체명
gas pedal : x, (자동차의)액셀러레이터 페달
gasper : n, 헐떡거리는 사람, 값싼 궐련, 마리화나 담배
gasping : a, 헐떡거리는, 숨결이 가쁜, 경련하는
gaspingly : ad, 헐떡이면서, 숨이 턱에 차서
gas pipe : x, 가스관
gas plant : x, 서양 백선, 가스 제조 공장, 가스 발생 장치
gas poisoning : x, 가스 중독
gas poker : n, 가스관
gas prodecer : x, 가스 발생기
gas proof : a, 가스가 들어가지 않는, 내가스성의
gas range : x, (요리용)가스 레인지
gas ring : x, 가스 풍로
gasripened : a, (야채등을)에틸렌 가스로 숙도 촉진처리를 한
gassed : a, 술취한
gasser : n, 수다스러운 사람, 허풍선이, 우스운 사람, 천연가스전
gas shell : x, 독가스탄
gassing : n, 가스 처리, 독가스 공격, 가스 발생, 수다떨기, 잡담, 허훙
gassipper : n, 휘발유 소비가 적은 자동차
gassipping : a, (자동차 등이)휘발유 소비가 적은
gas snipper : x, 소형차, 휘발유 소비가 적은 자동차
gas station : x, 주유소
gas stove : x, 가스 스토브
gassy : a, 가스질(상태)의, 가스가 가득 찬, 제 자랑이 많은 허풍떠는
gas tank : x, 가스 탱크, 가스 통
gastar : n, 콜타르
gasteropod : n, =GASTROPOD
gas thermometer : x, 기체 온도계
gastight : a, 가스가 새지(통하지)않는, 가스 방지 구조의, 기밀의
gastr : x, `위'의 뜻의 결합사
gastralgia : n, 위통
gastrectomy : n, 위절제(수술)
gastric : a, 위의(근처의)
gastric cancer : x, 위암
gastric juice : x, 위액
gastric ulcer : x, 위궤양
gastrin : n, 가스트린(위액 분비를 촉진하는 호르몬)
gastrinoma : n, 가스트린 분비 과다로 인한 다발성 위궤양
gastritic : a, 위염의
gastritis : n, 위염
gastro : x, 위, 이 뜻의 결합사
gastrocamera : n, 위카메라(위장 내부를 촬영하는 초소형 카메라)
gastrocolic : a, 위장의
gastroenteritis : n, 위장염
gastrology : n, 위학, 요리학
gastromy : n, 위절개(술)
gastronome : n, 미식가, 식도락가
gastronomic : a, 미식법의, 요리법의
gastronomist : n, =GASTRONOME
gastronomy : n, 미식, 식도락
gastronomy : n, 미식법, (어느 지방의 독특한)요리법
gastrophotography : n, 위경 촬영법
gastropod : n, 복족동물(달팽이, 괄태충 따위)
gastropoda : n, 복족류
gastroptosis : n, 위하수
gastroscope : n, 위경
gastroscopic : a, 
gastroscopy : n, 위경검사(법)
gastrula : n, 장배, 원장배, 낭배
gastrular : a, 장배의
gastrulate : vi, 장배(원장)를형성하다
gastrulation : a, 장배형성
gas turbine : x, 가스터빈
gas warfare : x, 독가스전
gas well : x, 천연가스 정
gasworks : n, 가스제조(공급)소, 하원
gat : n, get의 과거
gat : n, 권총
gate : n, 문, 문짝, 수문, 출입구, (전람회, 경기회 등의)입장자수, 입장권 매상총액
gate : vt, (학생에게)금족을(외출 금지를) 명하다
gateau : n, 과자, 케이크
gate bar : x, 문빗장
gate bill : x, 폐문 시간 지각부, 폐문 시간 지각 벌금
gate crash : vt, vi, 입장권 없이(초대되진 않고) 들어가다, 불청객
gatecrasher : n, (연회 등의)불청객, 입장권 없이 입장한 자
gatefold : n, (잡지 등의)접은 페이지
gatehouse : (사냥터 등의)문지기 집, 수위실, 누대(감옥이나 중세도시 성문위에 있는 망루), 
gatekeeper : n, 문지기, 수위;건널목 지키는 사람(마케팅)정보의누설을 통제하는 사람
gateleg table : x, 접을 수 있는 탁자
gateman : n, =GATEKEEPER
gate money : x, 입장료(수입)
gatemouth : x, 남의 개인적 사항을 여기저기 퍼뜨리는 사람
gatepost : n, 문기둥, between yo and me and the ~ 이것은 비밀이지만
gate tower : x, 문탑, 누문
gateway : n, 출입구, (~에 이르는)길, 수단
Gath : n, 가드(Philistia 의 도시;거인Goliath의 출샐지;사무엘 상6:17)
gather : vt, 모으다, 채집하다, 증가(증대)하다, 점차 늘리다, (눈살을)찌푸리다, 추측하다(that), (힘, 용기를)내다, (지혜를)짜내다, (몸을)긴장시키다
gather : n, 개더, 주름, ~ing 집합, 집회, 수금, 거두어들이기, 화농, 종기 ~ing ground 수원지대
gatherd : n, 눈살을 찌푸린, 주름을 잡는 장치
gatherer : 모으는 사람, 채집하는 사람, 채집인; 수금원, (재봉틀의)주름잡는 장치, 
gathering : n, 모임, 집회, 집합, 채집, 수확, 곪음, 부어 오름, 종기, 농양, 접지 맞추기, (옷등의)주름(달기), 개더
gathering coal : x, 불씨(밤 사이 꺼지지 않도록 불붙여 두는 큰 석탄 덩어리)
Gatling(gun) : n, 개틀링 기관총(초기의 기관총)
gator : n, 악어, 재즈팬
Gatorade : n, 게이터레이드(미국청량 음료의 일종)
GATT : x, General Agreement on Tariffs and Trade 관세 무역 일반협정
gatup : n, 권총 강도
gauche : a, 재치 없는, 서투른
gaucherie : n, 어색함, 서투름, 어색한(서투른)행동(말)
gauchist : n, =GAUCHISTE
gauchiste : n, 정치적 과격파, 좌익주의자
Gaucho : n, 남아메리카의 목동(스페인 사람과 인디언의 혼혈)
gaud : n, 값싸고 번지르르한 물건
gaudery : a, 화려한, 촌스럽게 번지르르한, 야한, 저속한, 겉치레의, (문체등이)지나치게 장식한
gaudily : ad, 저속하고 화려하게
gaudiness : n, 저속한 화려함, 야한 미
gaudy : a, 번쩍번쩍 빛나는, 야한, 값싸고 번지르르한
gaudy : n, (대학 따위의)교우대회
gauffer : vt, n, =GOFFER
gauge : n, 표준 치수(규격), 자, 계기, 게이지, (레일의)궤간, (평가, 검사의)표준, 방법, (영국에서는 보통gage)홀수 범위, (바람과 딴 배에 대한)위치 관계, broad(narrow) ~ 광궤(합궤), take the ~ of ...을 계측(평가)하다
gauge : vt, 측정하다, 평가하다 , ~able a, gauger 계량하는 사람, 계기, (술통의)검사관, 징세리
gaugeable : a, 측정할 수 있는, 평가할 수 있는
gaugeably : ad, 
gauge cock : x, (보일러 등의)험수기
gauge glass : x, (보일러의)험수관
gauger : n, 재는 사람;검량관(술통등의), 징세관
Gauguin : n, Paul(1848~1903)프랑스의 후기 인상파의 화가
Gaul : n, 갈리아(유럽 서부에 있었던 옛나라), 갈리아인, 프랑스인
Gauleiter : n, (나치스의)지방 장관;(중요지위의)하급 행정관;지방의 압제자
Gaulish : n, 고대 골(사람)의, 프랑스(사람)의 , 골 말의
Gaulist : x, , De GAULLIST
Gaullism : n, 드골주의
Gault : n, 중녹사통(녹사층 중의 점토질의 중생대 지층)
gaunt : a, 수척한, 여윈, 무시무시한, ~ly ad
gauntlet : n, (기사, 골키퍼 등의)손가리개, 긴 장갑, fling(throw) down the ~ 도전하다, take(pick) up the ~ 도전에 응하다
gauntlet : n, (병사의)태형, run the ~ (두줄로 선 사람들 사이를 걸으며)태형을 받다, 혹평을 받다
gauntry : n, GANTRY
gaur : n, 큰 들소(인도산)
gauss : n, 가우스(전자 단위)
Gautama : n 석가모니의 처음 이름
Gauussiann interger : x, 가우스의 정수
gauze : n, 성기고 얇은 천, 사, 가제, (가는)철망, 엷은 안개, gauzy 
gauzy : a, 사(깁)같은, 얇게 비치는
gavage : n, 위관 영양(위에 삽이뵌 고무관 등으로의 강제적 영양 공급)
gave : v, give의 과거
gavel : n, (의장 등이 쓰는)의사봉(작은 망치)
gavel : n, (봉건시대의)연공, 조세
gavelkind : n, (유언이 없는 유산의)남자의 균분 상속 토지소유
gavial : n, 인도약어
Gavin : n, 남자 이름
gavotte : n, 가보트(minuet식의 경쾌한 댄스)
Gawain : n, 가웨인(아서왕의 원탁 기사의 한 사람; 왕의 조카)
gawk : n, 아둔한(열퉁적은)사람, 멍청이
gawkish : a, =GAWKY
gawky : a, 얼빠진, 멍청한, 덜된
gawp : vi, 빤히 쳐다보다;멍청하게 입을 벌리고 보다
gay : a, ad, 쾌활한, 화려한, 방탕한, ~ quarters 화류계, ~ly
gay bar : x, 동성 연애자들이 출입하는 술집
gay bashing : x, 남성 동성 연애자에 대한 폭력행위
gay boy : x, 게이보이
gay cat : n, 신참의(풋내기)깡패, 때때로 일도 하는 부랑자;난봉꾼
gayety : n, =GAIETY
gayin : n, 호모의 집단적 사랑 행위
Gay Lib : x, =Gay Liberation, 이 행방운동의 철폐 운동
Gay Liberation : x, 동성 연애자 행방운동(차별 철폐운동)
gayly : ad, =GAILY
gaymarriage : x, 동성 연애자간의 결혼
gayness : n, 쾌활, 유쾌, 명랑
gayola : n, 게이 바 등의 호모조직이 범죄 조직에 바치는 뇌물
GayPayOo : n, 게페우(G, P, U)(소련의 비밀 경찰, 1934년 폐지)
Gay Plague : x, AIDS의 별칭
gay quarters : x, 홍등가, 유흥가
gayrights : n, 동성 연애자의 권리
gayrights movement : n, 호모의 권리 획득 운동
gay science : x, 미문학, 시, (특히)연애시
gay woman : x, 동성애의 여성
gaz : n, gazette, gazetteer
Gaza : n, 가자(팔레스타인 남서부의 해항, 삼손이 죽은곳)
gazabo : n, (종종 경멸적)놈, 녀석
Gaza Strip : x, 가자 지구(이스라엘 남서부에 인접하는 항만 지역
gaze : n, vi, 응시, 응시하다(at, on, upon), stand at ~ 응시하고 있다, 
gazebo : n, 전망대(옥상의 망루, 정자 등)
gazehound : n, (냄새로 쫓는 것보다)눈으로 짐승을 쫓는 사냥개
gazelle : n, 가젤(아프리카, 아시아산 영양의 일종)
gazelleeyed : a, 영양처럼 순한 눈을 한
gazer : n, 응시하는 사람
gazette : n, vt, 신문, 관보, (임명등을)관보에 게재하다, 관보로 고시하다
gazetteer : n, 지명사전, (신문)기자
gazi : n, =GHAZI
gazogene : n, 가스 발생 장치, 탄산수 제조기(휴대용)
gazump : vt, n, (매매 계약 후에 집값을 올리어)(산사람을)곤란케하다, 결정후에 값올리기, (매매 계약후의)집값의 인상
gazumping : n, 매매 계약 후의 집값 인상(보통 구두 가계약 후, 정식 계약전에 값을 올려고객에게 골탕을 먹임)
GB : n, 신경성 독가스의 일종
gcal : x, gram alorie(s)
GCC : x, Gulf Cooperation Council
GCI : x, ground controlled interception
GCT, G, C, T : x, Greenwich Civil Time그리니치 상용 시간
Gd : x, gadolinium
gd, : x, good, guard
Gdn(s) : Garden(s)
GDP : x, gross domestic product
GDR, G, D, R : x, German Democratic Republic
gds, : x, goods
Ge : x, germanium
GE : x, General Electric
gear : 톱니바퀴(장치), 기어, 전동 장치, (자동차의)변속 기어, (작업용)장치, 도구, 용구, 도르래, 활차, (말등이)끄는 기구, 삭구, 장구, 장비, 가구, 가재도구, 물품, (집합적)의복, 복색, 장신구, 매력적인  것, 고급(품), 도난품, 마약(기구), 기어를 넣다, 전동 장치로 연결하다, (기계를)연동시키다, (장치등을)설치하다, (말등에)마구를 달다, (계획, 요구등에)맞게 하다, 조정하다, 연결되다, (톱니바퀴가)맞물리다, (기계가)걸리다, 태세를 갖추다, 준비하다, 근사한, 매력있는 멋진
gearbos : n, =GEAR CASE, (자동차 등의)변속장치
gearcase : n, 톱니바퀴통
gear change : x, (특히 자동차의)변속레버, 기어 전환 장치
gear cutter : x, 기어의 톱니 깎는 기계
gearing : n, (톱니바퀴의) 맞물림, 전동장치
gear lever : x, =GEARSHIFT
gearshift : n, 변속장치
gear stick : x, \GEARSHIFT
gear whell : x, 톱니바퀴
gecko : n, 도마뱀 붙이
GED : x, general educational development종합 교육 개발
gee : int, 이러!, 어디여!(마소 부리는 소리), 에이 참!(실패, 실망, 화날 때의 소리)
geegee : n, 말
gee ho, geeup : x, 이러, 어디여(소나 말을 빨리 가게 하는 소리
geek : n, 기괴한 짓을 하는 흥행사, 괴짜, 기인, 변태자, 술주정뱅이
geep : n, 기프(염소와 양의혼합종)
gee pole : x, (개가 끄는)썰매의 채
geese : n, goose의 복수
geest : n, 충적토
geewhiz(z) : int, 아이고!, 깜짝이야!
geewo : x, =GEE HO
Geez : n, 게이즈 말, 고대 에티오피아 말
geezer : n, 괴짜, 괴상한 늙은이, 늙다리, 할아범, 할멈, 놈, 녀석, 독한 술, 마약주사
gefilte fish : x, 송어, 잉어 고기에 계란, 양파등을 섞어 둥글게 뭉쳐 끓인 것
gegenschein : n, 대일조
gegstrophic : a, 지구의 자전에 의한 편향력의
Gehenna : n, 게헤나(지옥), 고난의 땅
Geiger counter : x, 가이어 계수관
Geigers : n, 방사성 입자
Geissler tube : x, 가이슬러관(진공 방전의 실험 진공관)
Geist : n, 정신, 영혼, 지적 감수성, 지적 정열
gel : n, vi, 교화체, 겔, 교화하다, 굳어지다
gelandesprung : n, (스키)겔렌더슈프룽(도랑등의 장애물 뛰어넘기)
gelatin : n, 젤라틴, 강풀
gelatinate : vt, vi, 을 젤라틴으로 하다, 젤라틴화하다, 젤라틴이(모양으로)되다
gelatiniform : a, 젤라틴(갖풀)모양의
gelatinization : n, 젤라틴화
gelatinize : vt, vi, 아교질로 만들다, 아교질이 되다, 젤라틴화하다, 젤라틴으로 씌우다
gelatinous : a, 젤라틴(아교0모양의, 아교질의, 젤라틴에 관한, 젤라틴으로 된
gelatin paper : x, 젤라틴 감광지
gelatin plate : x, 젤라틴 건판
gelatin process : x, 젤라틴 판
gelation : n, 동결, 빙결
gelation : n, 교화, 겔화
gelationid : a, n, 젤라틴 모양(상태)의 (물질), 아교질의(물질)
geld : vt, 거세하다
geld : n, (지주가 군주에게 바치던)세금, 공납금
gelding : n, 불깐 말
Gelfoam : n (외과용)지혈제
gelid : a, 얼음 같은, 얼어붙는 듯한, 매우 차가운, 냉담한
gelidity : n, (얼음처럼_차가움, 극한, 냉담함
gelignite : n, 젤리그나이트(니트로글리세린이 들어 있는 강력한 폭약의 일종)
gelt : v, geld의 과거(분사)
gelt : n, 돈, 금전
gem : n, vt, 보석(을 박다), 소중한(아름다운) 것(사람)
GEM : x, ground effect machine
Gemara : n, 게마라(유대교의 신학서Talmud의 제2부)
gem cutting : x, 보석 연마(술)
Gemeinschaft : n, 공동 사회
geminate : vt, vi, 쌍(두겹)으로 하다(되다)
geminate : a, 두 겹(쌍)의
gemination : n, 이중, 중복, 반복, 자음 중복
Gemini : n, 쌍둥이자리, 쌍자궁, (미국의) 2인승 우주선
gemma : n, 싹, 무성아, 아체
gemmate : vi, 발아하다, 싹트다, 아체에 의해 번식하다
gemmation : n, 발아(법), 싹의 배열법, 세포발아, 발아중식, 아생
gemmiferous : a, 보석을 산출하는
gemmiparous : a, 발아하는, 발아 생식하는
gemmology : n, 보석학
gemmule : n, 어린 싹, 작은눈, 아구, 소아체
gemmy : a, 보석을 함유하는, 보석 같은
gemsbok : n, 몸집이 큰영양 (남아프리카산)
Gem State : x, 미국 Idaho주의 속칭
Gem State : x, 미국 Idaho주의 속칭
gemstone : n, 보석의 원석, 준보석
gemutlich : a, 마음이 편한, 기분 좋은, 쾌적한, 느낌이 좋은, 마음에 드는
gemutlichkeit : n, 마음이 편함, 쾌적
gen : n, 정보, 일반 포고
Gen : x, General, Genesis, Geneva(n)
gendarme : n, 헌병, 뾰족한 바위 봉우리
gendarmerie : n, 헌병대
gender : n, 성
gender gap : x, 성별 지지율의 격차(선거에서 후보에 대한 남성과 여성의 지지율의 차이)
genderless : a, 성이 없는, 무성의
gene : n, 유전(인)자
genealogical : a, 계도의
genealogical tree : x, (생물)계통(가계)수
genealogist : n, 계보학자
genealogize : vt, vi, -의 족보(계통)를 더듬다, 계보를 만들다
genealogy : n, 계도, 계통학
gene bank : x, 유전자 은행(유전 물질을 생존시킨 상태로 보존하는 시설
gene deletion : x, 유전자 삭제(불필요한 유전자의 제거)
gene expression : x, 유전자 발현(유전자 정보가 특정 형질로서 나타나기)
gene insertion : x, 유전자 삽입(빠져있는 유전자를 삽입하기)
gene manipulation : x, 유전자 조작(인위적으로 유전자를 옮기거나 염색체 등을 변화시키기)
gene mapping : x, 유전자 지도(염색체상의 유전자 자리를 결정하기)
gene pool : x, 유전자 풀, 유전자 공급원(멘델 집단을 구성하는 모든 개체가 가지고 있는 유전자 전체)
genera : n, genus의 복수
generable : a, 낳을 수 있는, 생성 가능한
general : a, 전반(보편)적인, 광범위에 걸친, 일반적인, 개괄(총칭)적인, 최고위의, 주된, as a ~ rul 대체로, in a ~ way 일반적으로, 대체로
general : n, 일반, 총체, (육군)대장, 장군, 전술가, 병법가, (수도회의)총회장, 잡역부, G, of the Army 육군원수, in ~ 전반적으로, 일반적으로, in the ~ 개괄적으로, 대체로
general account : x, 일반 회계
general Accounting Office : x, 회계 감사원
general adaptation syndrome : x, 범적응 중후군
general affairs : x, 서무, 총무
general agent : x, 총대리인
General American : x, 일반 미국 영어(미국 New England 지방 및 남부를 제외한 전역에서 일상 사용되고 있는 영어)
general anesthesia : x, 전신 마취(법)
general anesthetic : x, 전신 마취약
General Assembly : x, (유엔)총회
general attack : x, 총공격
general audience : x, 일반용
general average : x, 공동 해손
general cargo : x, 일반 화물(적재에 특별한 주의를 요하지 않는 뱃짐)
general clerk : x, 서무계
general conceop : x, 일반 개념
general Confession : x, 총고해
general consul : x, 총영사
general consumption tax : x, 일반 소비세
general course : x, 보통 과정
generalcy : n, 장성의 지위(임기)
general dealer : x, 잡화상(인)
general delivery : x, 유치우편
general discharge : x, 보통 제대(증명서)
general drills : x, 전원 배치 훈련(군함의 승무원 전원이 소정의 위치에 배치되는 훈련)
general editor : x, 편집장(주간)
general education : x, (전문(기술)교육에 대하여)일반 교육, 보통 교육)
general election : x, 총선거
General Eletcion Day : x, 총선거일
General Gost Office : x, 런던 중앙 우체국
general headquarters : x, (단수.복수취급)총사령부
general hospital : x, 종합 병원, 육군 병원
general information : x, 일반적인 지식
generalissimo : n, 대원수(영, 미 이외의 나라에서의), 전군 최고사령관, 총통(자유중국 등의)
generalist : n, (전문의에 대하여)종합(일반)의사, 다방면의 지식을 가진 사람, 갖가지 일을 할 수 있는 사람
generality : n, 일반적임, 일반성, 보편성, 개략, 개론, 통칙, 대부분, 과반수, 태반
generalization : n, 일반화, 보편화, 종합, 개괄, 개념, 통칙, 귀납적 결과, 일반론
generalize : vt, vi, 개괄(종합)하다, 법칙화하다, 일반성만을 그리다, 일반적으로 말하다, 막연히 말하다, 일반화하다, 보급시키다
general knowledge : x, 일반 지식(상식)
general law : x, 일반법, 일반법칙
generally : ad, 일반적으로, 대개, 보통, 통상
general magazine : x, 종합 잡지, 일반(대중)잡지
general manager : x, 총지배인
general meeting : x, 총회
general mobilizaion : x, 국가 총동원
general obligation bond : x, 일반 보증제(원금과 이자 지불이 보증되어 있는 지방정부채)
general officer : x, (육군, 공군, 해병대의)장성
general opinion : x, 일반적 견해, (일반적)여론
general orders : x, 일반 명령, 보초 일반 수칙
general outline : x, 개요, 개관
general pardon : x, 일반사면
general person : x, 일반인
general post : x, (오전)첫번째 배달 우편), 실내 유회의 일종
General Post Office : x, 중앙 우체 본국
general practitioner : x, (전문의가 아닌)일반의
general principle : x, 통칙, 원칙
general provision : x, 총칙
general public : x, 일반 진료
general public : x, 일반대중
generalpurpose : a, 다용도의, 다목적의, 만능의
general reader : x, (전문가에 대해서)일반독자
general resemblance : x, 대동 소이
general rule : x, 총칙
general secretary : x, (중국 공산당의)총서기, (소련 공산당의)서기장, (사회당 등의)서기(국)장
general semantics : x, 일반 의미론
general servant : x, 잡역부
general service : x, 일반 근무, 총예비대, 미국 본토에 배치한 총예비 부대
General Services Administration : x, 조달 본부
generalship : n, 장수다운 틀(인물), 용병의 지략, 용병술, 지휘(통솔)수완, 장군의 직(지위, 신분)
general shop : x, =GENERAL STORE
general staff : x, (사단, 군단등의)참모(부)
General Staff Office : x, 참모 본부
general store : x, 잡화점
general strike : x, 총파업
general tariff : x, 국정(보통)세율
general term : x, 전반(일반)명사, 공항, 일반항, 개괄적인 말
general welfare : x, 대중의 복지, 일반복지
General Winter : x 동장군(의인화, 군사 행동에 큰 영향을 주었다)
generateator : n, (가스 등의)발생기, 발전기, 낳는 것
generating : a, 전기를 일으키는
generating station(plant) : x, 발전소
generation : n, 출생, 생식, 산출, 발생, 자손, 일족, 일대, 시대, 세대, 동시대의 사람들, ALTERMATION , ~ after ~ 대대로 계속해서, rising ~ 청년(층), 젊은이들
generational : a, 세대의
generation gap : x, 세대차, 세대간의 단절
generative : a, 생산(생식)의(하는)
generative grammar : x, 생성 문법
generative semantics : x, 생성 의미론
generativetransformationalgrammar : x, 생성 변형 문법
generativist : n, 생성 문법가
generator : n, (가스 등의)발생기, 발전기
generatrix : n (선, 면, 입체를 생기게 하는)모점, 모선, 모면, (낳는)모체, 발전(발생)기
generic : a, 일반적인, 총칭적인 -name 속명
generically : ad, 속에 관하여, 속적으로, 일반적으로, 총칭적으로
generic product : x, 상표없이 일반명으로 판매되는 상품
generosity : n, 관대, 도량이 큼, 활수함
generous : a, 관대한, 마음이 넓은, 풍부한, 비옥한, (술이)감칠맛이 있는, ~ly ad
generously : ad, 활수하게, 관대하게, 풍부하게
genesic : a, =GENTETIC
genesis : n, 발생, 기원, 창세기
genesis rock : x, 창세기의 암석, 원시 암석
genesplicing : n, 유전자 접합
genet : n, 사향고양이, 그 모피=JENNET
gene therapy : x, 유전자 요법(결손된 유전자를 보충하여 유전병을 고치는 요법)
genetic : a, 기원의, 발생학적인, ~s 발생(유전)학
geneticallyengineered : a, 유전자 공학에 의해 생산된
genetic alphabet : x, 유전자 알파벳
genetic code : x, 유전 코드(DNA분자 중의 화학적 기초 물질의 배열)
genetic counseling : x, 유전 상담(양친의 염색체 검사 등에 의한 신생아의 유전병에 관한 상담)
genetic drift : x, 유전적 부동
genetic engineering : x, 유전자 공학
geneticist : n, 유전 학자
genetic load : x, 유전적 하중(돌연 변이 유전자에 의한 자연 도태의 강도)
genetic map : x, 유전자 지도(유전자(군)의 상대 위치를 나타내는 염색체 지도)
genetics : n, (단수 취급)유전학, 유전적 특징
genetic surgery : x, 유전자 수술(유전자의 인위적 변경, 이식)
geneva : n, 제네바, 네덜란드 진(술)
Geneva : n, 제네바(스위스의 도시)
Geneva Convention : n, 제네바 협정(1864~1865년 조인의 적십자 조약)
Geneva cross : n, 적십자
Geneva gown : x, 검은 목사 예배복
Genevan : a, n, 제네바의(사람), 칼뱅파의(교도)
Geneva spirit : x, 제네바 정신(1955년 7월 제네바에서 미, 소, 영, 불의 정부 수뇌가 모여 세계평화 문제를 논의했을때의 화합, 협력의 분위기를 말함)
Geneve : n, Geneva의 프랑스명
Geneve bands : x, 목에 늘어뜨리는 폭넓은 마면포의 장식(목사 예배복의 일부)
Genevese : a, n, 제네바의(사람), 칼뱅파의(교도)
Genevieve : n, 여자 이름
Genghis Khan : x, 징기스칸
gengronics : n, 젠트로닉스(유전학과 전자 공학을 결합한 혁신적 기술 분야)
genial : a, 온화한, 쾌적한, 온난한, 친절한, 다정한
geniality : n, 온화, 쾌적, 친절
genialize : vt, -을 유쾌하게 하다, -을 온정적으로 하다
genially : ad, 친절하게, 상냥스럽게, 싹싹(쾌활)하게
genic : a, 유전자의, 발생의
geniculate : a, 술상 관절이 있는, 굽은
geniculation : n, 슬상, 만곡(부)
genie : n, 귀신, 제니(동력을 가진 비행 전용의 강력한 항공 로켓)
genii : n, genie, genius의 복수
genista : n, 양골담초속
genital : a, n, 생식의, 생식기
genital herpes : x, 음부 헤르페스, 음부포진(음부에 포진, 격통 등의 증상이 일어나는 성병의 일종)
genitalia : n, 성기
genitality : n, 성기의 충분한 감도, 능력 소유, 성기에 대한 관심의 집중, 성기 편중
genitival : a, 속격의
genitive : n, a, (소유)격(의)
genito- : x, (연결형)(생식기의)의 뜻
genitourinary : a, 비뇨 생식기의
genius : n, 천재, 천성, (타고난)자질, 특질, 진수, 사조, 경향, (고장의)기풍, (날때부터 사람에 붙어 다니는)수호신, 귀신
genius loci : n, (=genius of the place), 고장의 수호신, 고장의 기풍
Genl, gean, : x, general
gennedup : a, -에 정통한, -을 잘 알고 있는, 정보에 소상한
gennerate : vt, 낳다, 산출하다, 일으키다, 생기다, (점, 선, 면이 움직여 선, 면입체를)이루다
Genoa : n, 이탈리아 북서부의 주, 그 주도
Genoa cake : x, 건포도가 든 케이크
genocidal : n, 집단(대량)학살의(을 초래하는)
genocide : a, 몰살, 민족 섬멸
Genoese : a, n, 제노바(사람)의, 제노바 사람
genome : n, 게놈(염색체의 1조)
genophobia : n, 성공포, 성욕 공포증
genotype : n, 유전형, 인자형, 공통 유전형을 갖는 개체군
Genova : n, Genoa의 이탈리아명
Genovese : a, n, =GENOESE
genre : n, 유형, 양식, 장르, 풍속화
genre painting : x, 풍속화
genre publishing : x, 장르별(유형별)출판
gens : n, (고대 로마의)씨족, 일족
gent : n, 신사, 사이비 신사
Gent : x, gentlemen
genteel : a, 지체 높은, 품위 있는, 우아한, 예의바른, 멋진, 현대적인, 점잖은 체하는
genteelism : n 고상한 말, 점잖은 말투
gentes : n, GES의 복수
gentianbitter : n, 용담 고미액(건위 강장제)
gentian violet : x, 겐티아나 바이올렛(아날린 염료의 일종)
Gentile : n, a, (유대인 측에서 본)이방인(의), 이교도(의)
gentility : n, 지체 높음, 품위, 예절바름, 점잔 빼기, 
gentle : a, 상냥한, 온화한, 얌전한, 지체 높은, 품위 있는, ~ and simple(상하)귀천, the ~ sex 여성
gentle : n, 양갓집 사람, (낚시밥의)구더기
gentle : vt, (말 따위를)길들이다
gentle breeze : x, 산들 바람
gentle craft : x, 낚시질, 낚시 친구, 인내를 요하는 활동, 힘드는 일
gentlefolk(s) : n, 양갓집 사람들
gentlehook : n, 가문이 좋음, 고상, 우아
gentleman : n, 신사, 지체높은(점잖은)사람, 남자, 남자분, 종복, 수입이 있지만 직업이 없는남자, 유한계급, 남자용 변소, ~ at large 무직자, ~ of fortune 해적, 모험가, 협잡꾼, my ~ (지금말한)그치, 그 남자, 
gentleman's agreement : x, 신사 협정
gentleman's agreement : x, 신사협정
gentlemanatarms : n, 의장병
gentlemancommoner : n, Oxford, Cambridge양 대학의 특별 자비생
gentlemanlike : a, 신사적인, 신사다운
gentlemanly : a, 신사적인, 신사다운, 예의바른, 교육 잘 받은
gentlemanranker : x, 양가집 출신의 하사관
gentlemans gentleman : n, 종복
gentlemanship : n, 신사의 신분, 신사임, 신사다움
gentleman usher : x, (특히 영국 왕실의)의정관, 안내관
gentlem farmer : x, (지방의)호농, 취미로 농업을 하는 신사
gentleness : n, 친절, 정다움, 온순, 안은, 과격하지 않음, 부드러움
Gentle People : x, 무저항주의 사람들
gentleperson : x, (종종 비꼼, 익살스런 호칭)여러분, 제군, 신사(분)
gentle sex : x, 여성
gentlewoman : n 귀부인, 숙녀, 귀부인의 시녀
gently : ad, 양반답게, 범절 있게, 점잖게, 부드럽게, 친절히, 조용히, 천천히, 서서히, 완만하게
gentrification : n, (주택가의)고급 주택화
gentrify : vt, (슬럼화된 주택가글)고급 주택가로 하다, 고급 주택(지)화하다, -을 고급화하다, 상류 계급화하다
gentry : n, (영국에서는 귀족 다음 가는)상류 계급
Gents, Gents' : n, 남자용(공중)화장실
genu : n, 무릎
genualp : a, 무릎의(같은)
genuflect : vt, (특히 예배볼 때)무릎을 굽히다, 무릎꿇고 절하다
genuflection : n, (예배보기위한)무릎 꿇기, 비굴한 태도
genuine : a, ad, 순수한, 진실의, 진짜의, 성실한, ~ly 
genuinely : ad, 진정으로, 성실하게, 순수하게
genuineness : n, 진짜임, 순수함
genus : n, 속(보기, 고양이의 학명), 종류, 유
Geo. : x, George
GEOARCHIVE : n, 지구 과학 관련의 정보를 총망라하여 수록한 데이터 베이스
geobanker : a, 세계적 은행 업무의
geobotany : n, 식물 지리학
geocentric : a, 지구를 중심으로 하는(하여 측정한)
geocentric latitude : x, 지심 위도
geocentric longitude : x, 지심 경도
geochemistry : n, 지구 화학
geochronology : n, 지질 연대학
geocorona : n, 중간권(지구 대기의 가장 바깥 층)
geod, : x, geodesic
geode : n, 정동, 이질, 정족, 정동석
geodesic : a, n, =GEODETIC, (두점간의)최단선, 측지선
geodesic dome : x, 측지선 돔(다각형 격자를 짜맞춘)
geodesist : n, 측지학자
geodesy : n, 측지학
geodetic : a, 측지학의, 최단선의, 측지선의
geodetic satellite : x, 측지위성(지구의 형성을 상세하게 조사하는 인공위성)
geoduck : n, 대합
geodynamic : a, 지구 역학상의
geodynamics : n, (단수 취급)지구 역학
Geoffrey : n, 남자 이름
geog, : x, geographer
geognosy : n, =GEOLOGY, 지방 지질학, 지구 구조학
geographer : n, 지리학자
geographical : a, 지리학(상)의, 지라(학)적인
geographical latitude : x, 지리학적 위도, 지형위도
geographical mile : 지리 마일(적도에서의 경도 1분, 
geographic edition : x, 지역판(한가지 잡지 안에서 지역별로 만들어진 판)
geography : n, 지리학, 지리, 지세, 지지, 지리학 책
geogrphical medicine : x, 지리 의학, 기후 환경 의학
geoid : n, 지오이드(평균 해면과 그연장으로 생가되는 상상의 면)
geoidal : a, 
geol, : x, geologic(al), geometry
geolinguistics : n, 지리 언어학, 언어 지리학
geological : a, 지질학(상)의, 지질의
geological map : x, 지질도
geological oceanography : x, 지질 해양학(대양의 바닥이나 지형, 퇴적물 등을 연구)
geological survey : x, 지질 조사
geological time : x, 지질 연대
geologist : n, 지질학자
geologize : vi, 지질(학)을 연구하다.지질 조사를 하다
geology : n, 지질학, 지질
geomagnetic : a, 지자기의
geomagnetic storm : x, 자기 폭풍(태양 흑점에 의한다고 생각되는 지구 자기의 이변
geomagnetism : n, 지자기, 지자기학
geomancer : n, 흙점쟁이
geomancy : n, 흙 점(한 줌의 흙을 땅 위에 던졌을 때의 모양 또는 땅위의 선, 점 등에 의한)
geomantic : a, 
geomedicine : n, 환경 의학, 지리적 의학
geometer : n, 기하학자
geometric : a, 기하(학)적인
geometric(al) progression : 기하(등비)급수, 
geometrical proprortion : x, 등비 비례
geometrical tracery : x, 기하학적 도형의 창문 장식
geometrician : n, 기하 학자
geometric mean : x, 등비(비례) 증항;상승(기하)평균
geometric series : x, 기하(등비)급수
geometric spider : x, 기하 도형 모양으로 그물을 치는 거미
geometrid : a, 자벌레
geometrize : vt, 기하학을 연구하다:기하학적으로 고찰하다;기하학적으로 도형 하다
geometry : n, 기하학, 기하학책, analytic ~ 해석 기하학, plane(solid, spherical) ~ 평면(입체, 구면) 기하학
geomorphic : a, 지형의, 지형학의
geomorphology : n, 지형학
geophagy : n, 흙을 먹음, 흙을 먹는 버릇
geophone : n, 지중 청음기
geophysical : a, 지구 물리학의
geophysicist : n, 지구물리학자
geophysics : n, 지구 물리학
geopolitician : n, 지정학자
geopolitics : n, 지정학
geopolitics : n, (단수취급)지정학
geopolitist : n, =GEOPOLITCIAN
geoponic : a, 농경(농업)의 :(익살)촌스러운, 시골티나는
geoponics : n, (단수의취급)농경수ㄹ, 농학
geopressured : a, 큰 지질학적 압력을 받고 있는
geoprobe : n, 지오프로브, 우주 탐사 로켓(지구표면ㅇ에서 지구 반경(640Km)이상 떨어진 우주 공간을 조사하는 로캣)
georama : n, 지오라마(돔식 파노라마)
Geordie : n, 21실링의 금액, 기니 금화, 탄갱부, 석탄배, 갱부용 안전등
Geordie : n, 남자이름, Tyne강변의 주민, 그방언
George : n, (가터 훈장에 딸린)St, George 보석상(용을 퇴치하는 모습의), 자동조종장치
George Cross : x, 조지 훈장(George 4세때 제정 1943)
Georgette : n, 조젯(얇은 본견, 크레이프)
Georgia : n, 조지아주, 그루지야(소련 남부의 한 지방)
Georgia Mafia : x, 조지아 마피아(조지아주 출신의 Carter대통령 측근들
georgian : a, n, 미국 Georgia주의, (서부 아시아의)그루지야(공화국)의, Georgia주 사람, 그루지야 사람
Georgiana : 여자이름, n, 
Georgia pine : x, 미송(미국 남부산)
georgicp : a, n, 농사의, 농업의, 농경(전원)시, 농경가
Georgie : n, George의 통칭
Georgina : n, 여자이름
geoscience : n, 지구 과학, 지학(지질학, 지구 물리학, 지구화학등)
geoscientist : n, 지구 과학자
geostatic : a, 지압의, (건물등이)지압에 견디는
geostatics : n, 지압학, 강체역학
geostationary : a, (인공위성이)지구 쪽에서 보아 움직이지 않는, 지구 정지 궤도에 올라 있는
geostationary orbit : x, (위성의)정지 궤도
geostationary satellite : x, 정지 위성
geostrategy : n, 전략 지정학, 지정학에 바탕을 둔 전략
geosynchronous : a, =GEOSTATIONARY
geotaxis : n, 중력 주성, 주지성(중력 자극에 대한 주성)
geotechnology : n, 지질 공학(공학, 과학의 수법을 이용하는 발전)
geothermal : a, 지열의
geothermal power generation : x, 지열발전(지열로 분출하는 증기, 열수를 이용하는 발전)
geothermic : a, 지열의
geotropic : n, 굴지성, 향지성
geotropism : n, 굴지성
ger : n, 게르, 파오(몽고인의 둥근 천막)
ger, : x, gerund, gerundial, gerundive
geracquainted : a, 친숙(익숙)해지기 위한, 예비 조사의
Gerald : n, 남자이름
Geraldine : n, 여자이름
geranium : n, 제라늄, 양아욱, 선홍색
gerbera : n, 아프리카 민들레
gerbil : n, 게르빌루스쥐
gerentocratic : a, 관리자(경영자)지배의, 관리자적인, 지배 관리 체제의
gerfalcon : n, (이이슬란드, 북극 부근의)송골매의 일종
geriatric : a, 노인병의, 고연령(층)의, 노인의
geriatrician : n, 노인병 학자(전문의)
geriatrics : n, 노인병학
gerkin : n, =GHERKIN
germ : n, 배종, 어린싹, 병원균, 세균, 싹틈, 근원, in ~ 미발달(상태)로
germ : vi, 발아하다
german : a, 같은 부모(조부모)에서 난, =GERMANE
German : a, n, 독일의, 독일 사람, 독일어
Germanamerican : n, 독일계 미국인(의)
German band : x, 관악기를 연주하며 거리를 누비고 다니는 소인수의)가두 음악대
German Democratic Republic : x, 동독
germander : n, 개곽향속의 식물, 개불알꽃
germane : a, 밀접한 관계가 있는, 적절한
German Federal Republic : n, 독일 연방 공화국
Germanic : a, 독일(민족)의, 게르만(튜튼)족의
Germanic : n, 게르만(튜튼)어, East ~ 동게르만어, North ~ 북게르만어(Scandinavia의 여러말), West ~ 서게르만어(영, 독, 네덜란드, 프리지아어 등)
Germanism : n, 독일 정신, 독일 사람 기질, 독일 말투(말씨)
Germanity : n, 독일풍, 독일정신, 독일 사람기질
germanium : n, 게르마늄(희금속 원소, 트랜지스터의 재료, 기호, Ge)
Germanizaion : n, 독일식, 독일화, 독일식 방법
Germanize : vt, vi, 독일식으로 하다, 독일화하다, 독일식 방법을 쓰다, 독일말로 옮기다, 독일식으로 되다
German measles : x, 풍진
Germano : x, (연결형)(독일 사람의뜻)
German Ocean : x, 게르만 해(북해)
Germanomania : n, 독일광, 독일 심취
Germanophile : n, 독일 숭배자, 친독파
Germanophobe : n, 독일 공포자, 독일을 싫어하는 사람
Germanophobia : n, 독일 혐오(공포)증, 배독열
German shepherd : (dog)독일종 셰퍼드(경찰견)
German silver : x, 양은
German text : x, 독일(장식 문자)
Germany : n, 독일, Federal Republic of ~ 독일 연방 공화국
germ bomb : x, 세균탄(폭탄)
germ carrier : x, 보균자
germ cell : x, 생식 세포
germen :  ㅜ, 생식선, 생식질
germfree : a, 무균의, 세균이 없는, (실험 동물이)무균 상태에서 자란
germicidal : a, 균을 죽이는, 살균(성)의, 살균력이 있는
germicide : n, a, 살균제, 살균력이 있는
germiculture : n, 세균 배양
germinal : n, 어린 싹(배종의, 초기(원시))의
germinant : a, 싹(움)트는, 발달하기 시작하는, 성장력이 있는, 시초의, 발단의
germinate : vi, vt, 싹트다(싹트게 하다), 발아하다(시키다)
germination : n, 싹틈, 발아, 맹아, 발생
germinative : a, 싹트는, 움트게 하는, 발아력이 있는
germinator : n, 발아시키는 사람(것), 발아력 시험기
germ layer : x, 배엽
germ plasm : x, 생식(세포)질
germ theory : x, 배종설, 매균설
germ warfare : x, 세균전
germ weapon : x, 세균 병기
germy : a, 세균 투성이의, 불결한
Gerneral Certificate of Education : x, 일반 교육 증서, (이 증서를 얻기 위한)일반 교육 이수 증명 시험
Gerneral Court : x, 주의회
gernotocracy : n 노인 정치, 노인 지배, 노인 정부(지배국)
gernotophobia : n, 노령(노인)공포(혐오)
Geronimo : int, 와아~(낙하산 부대가 뛰어 내릴때의 구호)
geront : x, (노인, 노령)의 뜻
gerontic : a, 노령의, 늙은, 노쇠한
gerontological : a, 노인학의(노년학)
gerontology : n, 노인병학, 장수학
gerontophilia : n, 노인애(노인을 성애의 대상으로 하는, 성도착의 일종)
gerous : x, (연결형)(생기는, 있는)의 뜻
gerovital : n, 노화방지 약
Gerry : n 남자(여자)이름, 독일사람(군인)
gerrymander : vt, n, (선거구를)자당에 유리하게 고치다, 부정 하게 손을 대어 고치다(고치기)
Gersh win : x, George(1898~1937)미국의 작곡가
Gertie : n, 여자이름
gertrude : n, 유아용 슬립(속옷류)
Gertrude : n, 여자이름
gerund : n, 동명사
gerundgrinder : n, 라틴어 문법 선생, 학자인 체하는 선생
gerundial : a, 동명사의
gerundival : a, 동사상 형용사의
gerundive : n, (리틴어의)동사상 형용사
Geryon : n, 게리온(삼두 삼신에 날개를 가진 괴물왕)
Gesamtkunstwerk : n, (음악, 연극, 시 등을 하나로 한)종합 예술 작품
gesellschaft : n, 게젤샤프트, 이익사회(고려, 타산, 계약과 같은 선택 의지로 이어진 인간결합)
gesso : n, (회화, 조각용)석고(분), (회화용)석고 바탕
gest : a, (특히 춤에서)몸의 움직임의(에 관한)
Gestalt : n, 형태
Gestalt psychologyn : x, 형태 심리학
Gestapo : n, 비밀 경찰
gestate : vt, vi, -을 회태(회임)하다, 9을 마음에 품다, 입안(창안)하다, 회임하다, 구상(등)을 가다듬다
gestation : n, 임신 기간
gesticulate : vi, 손짓으로 나타내다
gesticulation : n, 몸짓(손짓)하기(으로 말하기)
gesticulative : a, 몸짓(손짓)으로 하는 말하는, 몸짓(손짓)을 많이 하는
gesticulator : n, 몸짓(손짓)으로 나타내는(말하는)사람)
gesticulatory : a, 몸짓(손짓)이 섞인(많은)
gestosis : n, 임신 중독(증)
gesture : n, 몸짓, 손짓, 태도, 거동(암시적 의사 표시가 포함된), 선전적 행위, 제스처
gesture language : x, 몸짓 언어
gesundheit : int, 몸조심하세요!(특히 재채기를 한 사람에게 하는 말, God bless you!라고도 함, 이때의 대답은 Thank you또는Danke schon)
get : vt, 얻다, 취하다, 잡다, (전화에)불러내다, 달하다, 손에 넣다, 사다, (병에)걸리다, 가져오다(가다), (식사의)준비를 하다, (동물이 새끼를)낳다, 때리다, 곤란케 하다, 해치우다, 죽이다, 이해하다, 먹다....시키다....하게하다....하여지다
get : v, , 도착하다, 벌다, 이익을 얻다, -이 되다, -당하다, -하기시작하다, 그럭저럭...하다
get : n, (동물의)새끼, 새끼를 낳음, 어린애, 개구장이, (테니스등에서)어려운 공을 받아치기, 이익, 벌이, 도망, (강도의)도망 루트
getacquainted reception : x, 간친회, 친목회
getatable : a, 도달할(손에 넣을) 수 있는, 접근하기 쉬운
getaway : n, 도망, 스타트, 출발
Gethsemane : n, 겟세마네(예루살렘 동쪽의 동산, 예수 수난의 땅)
getout : n, (궁지에서의)탈출, 회피(책), 도피(수단)
getoutthevote compaign : x, 기권방지 운동
getrichquick : a, 일확 천금의
gettable : a, 얻을 수 있는, 손에 넣을 수 있는 
getter : n, vt, 얻는 사람, 게터(전구, 진공관 내의 잔류 가스를 흡수시키는 물질), (게터로 잔류 가스를) 제거하다
gettogether : n, 친목회, (비공식의)회합
gettough : a, 단호한, 강경한
Gettysburg : x, Pennsylvania주의 시(남북 전쟁의 싸움터)
Gettysburg Address : x, 1863년 11월 19일 Lincoln이 Gettysburg에서 한연설
getup : n, 몸차림, (책의)장정, 창의, 정력
getupandgo : n, =getup
geum : n, 뱀무속의 식물
GeV : x, gigaelectron volt
gewgaw : a, 값싸고 번지르르한 (물건), 장남감
gey : a, 상당한, 꽤, 매우
geyser : n, 간헐천, 분천, 자동 온수 장치
geyserite : n, 간헐석
GFE : x, government furnished equipment
Gfilm : n, 일반 대중용 영화
GFRP : x, glass fiber reinforced plastics
GG : x, government to governmernt, 정부간 거래
GHA : x, Greenwich hour angle
Ghana : n, 서아프리카의 공화국(수도 Accra)
Ghanaian : a, 가나의, 가나 사람의
gharry : n, (인도)마차
ghastlily : ad, =GHASTLY
ghastly : a, ad, 할쑥한(하게), 송장(유령)같은(같이), 파랗게 질린(질려), 무시무시한(하게), 지독한
ghat : n, 강가의 층계, 상륙장, 산길, 재
ghaut : n, (카리브)(바다로 통하는)계곡
ghazi : n, (이교도와 싸우는)이슬람 용사
ghee, ghi : n, 버터 기름(인도 요리용)
gherkin : n, 작은 오이
ghero : n, vt, 포위 단체 교섭, (경영자를)사업소 내에 가두다
ghetto : n, 유대인 거리, (특정 사회 집다)거주지, 빈민구
ghettoism : n, ghetto의 분위기, 슬럼화, 슬럼가에서의 생활
ghettoization : n, ghetto화
ghettoize : vt, ghetto에 가두다, ghetto화하다
ghibli : n, 기블리(북아프리카 사막의 열풍)
Ghielline : n, a, 황제 당원(의)(중세 이탈리아에서 독일 황제편을 들어 교황 당원에 반대했음)
ghilgai : n, =GILGAI
ghost : n, 유령, 망령, 환영, 환상, 근소한 가능성, 유령의, 영적인
ghost : vi, vt, -을 따라 다니다
GHOST : x, Global Horizontal Sounding Technique, 정점 고공 기상 관측법
ghost candle : x, 악마 쫓는 촛불(시체의 주위에 켜 놓음)
ghost dance : x, 교령춤(아메리칸 인디언들이 죽은 사람의 혼과 통하기 위하여 추는 춤
ghostdom : n, 유령제
ghost image : x, 다중상
ghostlike : a, ad, 유령같은(간이), 무시무시한(하게), 음산한(하게)
ghostliness : n, 유령같음, 요괴스러움, 유령이 나올 듯한
ghostly : a, 유령의, 유령이 나올 듯한, 유령에 관한, 유령같은, 희미한, 그림자 같은, 영적인, 정신적인, 종교적인
ghostly adviser : x, 성직자, 고해신부
ghostly comfort : x, (고해, 임종때 신부가 주는)영적 위로
ghostly enemy : x, 악마
ghostly hour : x, 야삼경
ghost shift : x, 무인 교대제(인간 대신 로봇만으로 작업을 하는 것)
ghost station : x, 무인역, 폐쇄된 정거장
ghost story : x, 괴담, 꾸며낸 이야기
ghost surgery : x, (환자에게 알리지 않고 행하는)대리 외과 의사의 수술
ghost town : x, 유령 도시(전쟁, 기근, 불경기 따위로 주민이 떠난 도시)
ghost word : x, 유령어(오식, 오해 등으로 생긴말)
ghostwrite : vi, vt, (연설문, 문학 작품을)대필(대작)하다
ghoul : n, (무덤속의 시체를 먹는)악귀
ghoulish : a, 송장 먹는 귀신 같은, 잔인한, 잔학한
GHQ, G, H, Q, : x, General Headquarters
ghyll : x, =GILL
gi, : x, gill(s)
GI, : a, 관급의, 규정(표준형)의, 군대식의
GI, : n, 병(사), ~ Jane 여군병사, ~ Joe 미군병사
giant : n, 거인, 위인, 거대한
giant(s) stride : x, 회전 그네
giant cactus : x, 큰 선인장
giantess : x, 여자 거인
giantism : n, 거인증
giantkiller : x, (스포츠에서)거물 잡는 선수(팀)
giant panda : x, 바둑곰, 자이언트 팬더
giant planet : x, 대행성(목성형 행성, 목성, 토성, 천왕성, 해왕성의 총칭)
giant power : x, 다이너마이트의 일종
giant salom : x, (스키의)대회전(경기)
giant star : x, 거성(직경, 광도, 질량)등이 현저하게 큰 항성
giant swing : x, (철봉의)대차륜
giaour : n, 이단자(기독교도에 대한 회교도의 멸칭)
gib : n, (특히 거세한)수코양이
gib : n, vt, 요자모양의 쐐기, 요자형의 쐐기로 죄다
Gib, : x, Gibraltar
gibber : vi, 횡설수설하다
gibberellin : n, 지베렐린(고등 식물의 생장 호르몬)
gibberish : n, 횡설수설
gibbet : n, vt, 교수대, 교수형에 처하다, 망신주다
gibbon : n, 긴팔원숭이
gibbose : a, =GIBBOUS
gibbosity : n, 불룩한 모양, 불룩하게 굽음(솟음), 융기, 꼽추
gibbous : a, 철면의, 반달보다 큰, 꼽추의
gibe : n, vt, vi, 조롱(하다)
gibeon : n, 기브온(고대 palestine의 도시)
Gibeonit : n, 기브온 주민
GI Bill : x, (대학 자금이나 주택 자금의 급부 등)
gibingly : ad, 조롱하며, 놀려대며
giblet : n, (닭, 거위등의)내장, 찌꺼기
Gibraltar : n, 지브롤터
Gibson : n, 기브슨(진 또는 보드카와 드라이 베르무트에 양파를 곁들인 칵테일)
Gibson girl : n, 미국의 화가, 휴대용 무선 송신기
gibus : n, 오페라 모자
giddily : ad, 아찔하게, 현기증 나게, 정신을 못차려, 경솔하게
giddiness : n, 현기증, 경솔
giddy : a, 현기증나는, 들뜬 , 현기증 나게 하다
giddy : vt, 현기증 나게 하다
Gide : vt, (Paul Guillaume)(1869, 1951)프랑스의 소설가, 평론가, Nobel상 수상(1947)
Gideon : n, 유대의 용사, the ~s 성서 기증 협회(행상인들이 설립1899)
Gideons International : x, 국제 기드온 협회(1899년 설립된 성서 기증 협회)
Gideon Society : x, Gideons Internation의 구칭
gidger : n, 활발하고 귀여운 소녀
gie : v, =GIVE
Gifford : n, 남자 이름
gift : n, vt, 선물, 천분, 재능 , 선사하다, (재능을)부여하다
giftbook : n, 증정본, 기증본
gift certificate(coupon) : x, 상품(경품)권
gift coupon : x, 경품(교환)권
gifted : a, 천부의 재주가 있는, 수재의
gift horse : x, 선물로 주는 말
giftie : n, 재능
gift shop : x, 선물 가게
gift tax : n, 증여세
gift voucher : x, (답례용)경품권
giftwrap : vt, (리본 따위로)예쁘게 포장하다
giftwrapping : n, 선물용 포장재료(종이, 리본등)
gig : n, (한 필이 끄는)2륜 마차, (돛이나 노를 쓰는)가벼운 보트, (배에 실은)소형 보트
gig : n, v, vt, (고기잡이용)작살, (낚시)갈고랑쇠, 작살을 쓰다, (물고기를)작살로 찍다
gig : n, vt, (학교, 군대등의)과실 보고, 벌점, -에 벌점을 매개다
gig : n, vi, 재즈(록)연주회, 재즈(록)연주(계약), 그 연주(회장), (재즈 연주가로)일하다
giga- : x, (연결형)(10억, 무수)의 뜻, 기가(기호)
gigabit : n, 10억 비트
gigahertz : n, 10억 헤르츠
gigantean : a, =GIGANTIC
gigantesque : a, 거인의, 거대한
gigantic : a, 거인 같은, 거대한
gigantism : n, 거인증, 거대증
gigaton : n, 기가톤(10억 통 TNT의 폭발력에 상당)
giggle : vi, n, 낄낄거리다(거림)
giggle house :  ㅌ, 정신병원
gigglesmoke : n, 마리화나
giggly : a, 낄낄 웃는(버릇이 있는)
giglet : n, 말괄량이
gigmill : x, 보풀 세우는 기계, 기모기, 기모 공장
GiGo : n, garbage in gargage out, 기고(불안전한 프로그램을 입력하면 불완전한 답이 나올수 밖에 없다는 원칙)
gigolo : n, 남자 직업 댄서, 기둥 서방, (매춘부의)정부
gigot : n, 양의 다리 고기, 양다리 모양의 소매
gigue : n, 지그(바로크시대의 약동적인 무곡), 16세기 영국의 급속도의 활발한 춤
Gila monster : x, (미국산)독도마뱀
gilbert : n, 길버트(지자력의 단위)
Gilbert : n, 남자이름, 길버트(영국의 희극 작가)
Gilbertese : n, 키리바시어(태평양 중부 키리바시 공화국의 원주민어)
Gilbertian : a, 우스운, 뒤가 닿지 않고 익살맞은
gild : vt, 금을  입히다, 금도금을 하다, 금빛으로 물들이다, ...을 실물보다 아름답게 꾸미다, 장식하다, ~ the pill 환약을 금빛으로 칠하다, 싫은 것을 보기좋게 만들다
gild : n, =GUILD
gilded : a, 금도금한, 부자의 gilded youth 귀공자 
gilder : n, 도금사, 금박공
gilder : n, =GUILDER
gilding : n, (입히거나 바른)금, (금박, 금가루(등)), 금박 입히기, 도금(술), 외식, 허식, 분식
Giles : n, 남자이름
gilet : n, 질레(블라우스 모양의 조끼)
gilgai : n, 빗물이 괴는 접시 모양의 오목한 지형
Gilgamesh : n, (슈메르)길가메시(슈메르와 바빌로니아 신화의 영웅)
Giliak : n, =GILYAK
gill : n, (물고기의)아가미
gill : n, 질(액량 단위, 1/4파인트)
gill : n, 협곡, 계곡, 계류
gill cover : x, 아감딱지
gilled : a, 아가미가 있는, (버섯 갓 안쪽에) 주름이 있는
Gillian : n, 여자이름
gillie : n, 시종, 하인
gillion : n, 억조, 방대한 수
gill net : x, 자망(물속에 수직으로 침)
gilly : x, n, 곡마단의 운반(자동)차, 작은 곡마단, 사육제의 꽃 자동차)
gillyflower : n, 비단향꽃 무우(4, 5월경 자줏빛 꽃이 핌)
gilt : v, gild의 과거(분사)
gilt : a, n, 금도금한, 금박, 금분, 금니
giltcup : n, =BUTTERCUP
giltedged : a, 금테의, (어음, 증권 따위)확실한
Gilyak : n, 길랴크족(시베리아의 아무르 지방에 사는 몽고계 민족)
gimbals : n, 수평 유지 장치, (나침판의)칭평환
gimcrack : a, n, 싸고 허울만 좋은 (물건)
gimcrackery : n, (집합적)값싸고 번지르르한 물건
gimcracky : z, 값싸고 번지르르한
gimlet : n, vt, T자형 나사송곳(으로 구멍을 뚫다)
gimlet eye : x, 날카로운 눈
gimleteyed : a, 눈이 날카로운
gimme : n, a, 금품 강청, 물욕, 사욕, (금품을)강청하는
gimmick : n, (요술장이의)비밀 장치, 트릭
gimmickery : n, (집합적)(속임수의)장치, 장치의 사용
gimmicky : a, 교묘한(속임수)장치를 한, 눈길을 끌기 위한, 허울만의
gimp : n, (철사 넣은)장식 끈
gimp : n, vi, 불구자, 절름발이, 다리를 절다
gimpy : a, 절름발이의
gin : n, 진(증류주의 일종)
gin : n, vt, 기중기, 씨아(로 씨를 빼다), 덫(으로잡다)
gin : x, =BEGIN
ginandJaguar : a, (신흥)상위 중류 계급
gin and tonic : x, 진토닉
gin block : x, 일륜 활차
gin fizz : x, 진피즈(탄산수, 레몬을 탄 진)
ginger : n, 생강, 원기, 활력, 고동색
gingerade : n, =GINGERBEER
ginger ale(beer) : x, 생강을 넣은 청량 음료의 일종
ginger beer : x, 진저비어(진저에일 비슷하나 알코올을 조금 함유)
ginger brandy : x, 진저브랜디(생강맛 나는 강장제)
gingerbread : n, 생강이 든 빵, 싸구려, 값싼(물건)
gingerbread nut : x, 생강 비스킷
gingerbread work : x, 값싸고 번지르르한 장식
ginger cordial : x, 진저 코디얼(생강, 레몬 껍질, 건포도, 물로 만든 음료)
ginger group : x, (정당 따위 조직 내부의)혁신파
gingerly : a, 주의 깊은
ginger nut : x, =GINGERBREAD NUT
gingerroot : n, 생강 뿌리
gingersnap : n, (얇고 바삭바삭한)생강이 든 쿠키
ginger wine : x, 진저와인(생강, 레몬, 건포도, 설탕을 혼합하여 잘효시킨 음료)
gingery : a, 생강 같은, 매운, 성마른
gingham : n, 깅엄(줄무늬 따위가 있는 무명)
gingili : n, 참깨, 들기름
gingiva : n, 잇몸, 치경
gingival : a, 잇몸의, 윗잇몸의
gingivitis : n, 치은염
gingko : n, =GINKGO
ginglymus : n, 경첩 관절
ginhead : n, 술취한 사람, 주정뱅이
ginhouse : n, 조면 공장
gink : n, 놈, 사내, 기인
ginkgo : n, 은행나무
ginkgo nut : x, 은행
gin mill : x, 싸구려 술집
gin mill : x, (싸구려)술집
ginner : n, 조면공
ginnery : n, 조면공장
ginney : n, 이탈리아 사람
ginormous : a, 터무니없이 큰
gin palace : x, 화려하게 꾸민 싸구려 술집
gin rummy : x, 진러미(가지고 있는 패의 합계가 10점 혹은 그 이하일때 그 가진 패를 보이는 카드놀이의 일종)
ginseng : n, 인삼
ginshop : x, 진(을 파는)술집
gin sling : x, 진에 설탕, 향료, 얼음을 넣은 청량 음료
ginzo : n, 외국인, 이민(특히)이탈리아 이민
Gioconda : x, La 모나리자(Mona Lisa)의 초상화
giocoso : a, ad, 활발한, 활발하게, 우스운, 우습게
Giotto : x, (1266~1337)르네상스 이전의 이탈리아 최대의 화가
gip : vt, (생선의)배를 따다
gippo : n, 수프, 스튜
gippy : n, a, 이집트 병사(사람), 이집트의
gippy tummy : x, (열대지방 여행자가 걸리는)설사
Gipsy : x, =GYPSY
giraffe : n, 지라프, 기린
girandole : n, 가진 달린 장식 촛대, 회전 꽃불, 회전 분수, 큰 보석 둘레에 작은 보석을 박은 귀걸이(등)
girasol : n, 화단 백석, 뚱딴지
gird : vt, 허리띠로 졸라매다, ...을 허리에 두르다, 몸에 붙이다, 허리에 차다, (권력 따위를)주다, 둘러싸다  ~gird oneself 단단히 허리띠를 죄다
gird : n, vt, 조롱(하다)
girder : n, 도리, 대들보, 거더
girderage : n, 도리, 형 맞춤
girder bridge :  ㅌ, 형교
girdle : n, vt, 띠(...로 두르다(감다)), 거들(고무가 든 간단한 코르셋의 일종), 두르는(싸는)것, 둘러싸다...의 나무껍질을 고리모양으로 벗기다
girdlecake : n, 번철에 구운 과자
girdler : n, 둘러싸는 사람(것), 나무 껍질을 둥글게 먹어들어가는 각종 곤충, 띠만드는 사람
girguide : n, 띠
girl : n, 계집아이, 소녀, 젊은 여자, 숫처녀, 하녀
girlcott : vt, (여성이 여성에게 편견을 가진 사람을 보이콧하다_
girl Friday : x, (무슨 일이든지 충실히 해주는)여사무원, 여비서, 여자 조수
girl friend : 여자 친구, 
girl guide, girlscount : n, 소녀단
Girl Guides : x, 소녀단
girlhood : 소녀임, 소녀 시절, 소녀들, 
girlie : n, 소녀, 아가씨
girlish : a, 소녀의, 소녀시대의, 소녀같은, 소녀다운, 순진한, 앳된, (소년이)계집애 같은, 연약한
girl scout : x, 걸스카우트, 소녀단원
girl wife : x, 소녀 같은(앳된)아내
girlygirly : a, 지나치게 소녀적인
Giro : n, 은행(우편) 대체제도
Gironde : n, 지롱드당, 온건파
Girondist : n, a, 지롱드 당원(의)
girt : v, gird의 과거(분사)
girth : n, (말의)뱃대끈, 띠, 둘레의 치수(가슴둘레 따위)
girth : vt, vi, 뱃대끈을(으로) 졸라매다, 치수가 ...이다
Giscard d'estaing : x, 프랑스 대통령(1974~1981)
gism : n, =JISM
gismo : n, =GIZMO
Gissing : n, (1857~1903)영국의 소설가
gist : n, 요점, 본질, 골자, 주요 소인
git : vi, =GET
git : n, 쓸모없는 놈, 멍텅구리
gittern : n, 기타 비슷한 옛악기
giusto : a, ad, (속도에 대해)정확한(하게), 적절한(하게)
give : vt, 주다, 선사하다, 공급사다, 건네다, 맡기다, 치르다, 바래다, 약해지다, 무너지다
give : vi, 자선(기부)하다, 굴복(양보)하다, (빛이)바래다(날다), 약해지다, 무너지다
give : n, 탄력성, (정신, 성격의) 순응성, 유연성
giveandtake : n, 공평한 교환, 상호 양보, 타협, 담화(농담)의 응수
giveaway : n, 무심코 지껄여버림, (라디오 따위의)청취자 참가 프로(상품 따위가 붙어 있는)
giveaway : a, 손해를 각오하고 싸게 파는
given : v, give의 과거분사
given : a, 주어진, 이미 알고 있는, 일정한, 경향을 띠어, 탐닉하여
given information : x, 구정보, 이미 아는 정보
givenname : n, (성에 대한)이름
giver : n, 주는 사람
giveup : n, 포기, 양도, 항복, (증권업자에 의한)위탁자(명)명시 거래, (다른 증권업자에 대한)수수료 분여, 분여된 수수료
giveupitis : n, 패배주의
giza : n, 기자)이집트 Cairo부근의 도시, 피라미드와 스핑크스로 유명)
gizmo : n, 이름도 없는 것, 설비, 장치
gizzard : n, (새의)모래주머니, (사람의) 위
GK, Gk : x, Treek
Gl : x, glucin(i)um
GL : x, gunlaying
gl, : x, glass, gloss
glabrous : a, 털 없는, 반들반들한
glace : a, (천, 가죽 따위를)반들반들하게 만든, 설탕(등)을 입힌(바른)
glacial : a, 얼음(모양)의, 빙하기의, 차가운
glacial acetic acid : x, 빙초산
glacial epoch(period) : n, 빙하기(시대)
glacialist : n, 빙하학자
glacial period : x, 빙하 시대
glaciate : vt, 얼리다, 빙하로 덮다
glaciated : a, 빙하 작용을 받은, 빙하로(빙원으로)덮인
glaciation : n, 빙하 작용, 빙결
glacier : n, 빙하
glaciology : n, 빙하학
glacis : n, 가파르지 않은 비탈, (정면의)경사진 둑(제방)
glad : a, 기쁜, 기쁜 듯한, 유쾌한, (듣기만해도)기쁜
glad : vt, =GLADDEN
glad : n, 글라디올러스
gladden : vt, vi, (사람, 마음을)기쁘게 하다, 기뻐하다
glade : n, 숲 속의 빈 터, 습지
glade eye : x, 다정한 눈길, 추파
gladeye : vt, -에게 추파를 던지다
glad hand : n, 환영(의 손)
gladiator : n, (옛 로마의)(직업적)검투사, 논객
gladiatorial : a, 검투(사)의, 논쟁(자)의
gladiola : n, =GLADIOLUS
gladiolus : n, 글라디올러스
gladly : ad, 기꺼이, 즐거이, 쾌히
gladness : n, 기쁨, 즐거움
glad rags : n, 나들이옷, 야회복
gladsome : a, 기쁜
Gladstone : n, 영국의 정치가
Gladstonial : a, n, Gladstone파(류)의 사람
Gladys : n, 여자이름
glahad : n, Arthur왕의 원탁기사의 한사람, (a ~)고결한 사람
glair(e) : n, vt, (알의)흰자위, (흰자위로 만든)질그릇의 겉칠약, 흰자위 같은 점액, 흰자위를 바르다
glaireous : a, =GLAIRY
glairy : a, 흰자위같은, 풀기있는, 흰자위를 바른
glaive : n, 날이 넓은 칼
glam : n, a, vt, =GLAMOUR, =GLAMOROUS, =GLAMORIZE
Glam, : x, Glamorgan
glamor : n, 마법, 매력
glamor : vt, 매혹하다
glamorize : vt, 매력을 갖추게 하다, 돋보이게 하다
glamorous : a, 매력에 찬, 매혹적인
glamour : n, 마법, 매력
glamour : vt, 매혹하다
glamourboy(girl) : n, (성적)매력 있는 청년(여자)
glamour issue : x, 성장주
glamour stock : x, 값이 오를 것으로 기대되는 주식
glance : n, 흘긋 봄, 별견, 일견, 흘긋(눈짓), 번쩍임, 번득임 at a ~ 일견하여, 잠깐 보아서, cast(throw) a ~ 흘긋 보다
glance : vi, 흘긋보다, 일견하다, 훑어 보다, 번쩍 빛나다, (이야기가)잠깐 언급되다, 스치고 지나가 다, 빗나가다 흘긋 돌리다
glance : vt, 잠깐(훑어)보다, 흘긋 돌리다
glance coal : x, 휘탄, 무연탄
glancing : a, 번뜩이는, 번쩍이는, 번쩍번쩍 빛나는, (타격, 총탄등이)맞고 빗나가는, (언급등이)넌지시 빗대는
gland : n, 선
gland : n, (피스톤 등의)눌림쇠(마개)
glandered : a, 비저병에 걸린
glanderous : a, 비저성의
glanders : n, 비저병(말의 전염병)
glandiform : a, 결과모양의, 선모양의
glandular : a, 선의, 선같은, 선이 있는, 선천적인, 타고난, 성적인
glandular fever : x, 선열
glandule : n, 소선, 작은 샘
glans : n, 귀두, 결과
glare : n, 번쩍이는 빛, 눈부신 빛, 야함, 현란함, 날카로운 눈씨
glare : vi, vt, 번쩍번쩍(눈부시게) 빛나다(비추다), 눈에 띄다, 노려 흘겨 보다
glare : a, 얼어 붙은 얼음의 표면(과 같은)
glaring : a, 번쩍번쩍 빛나는, 눈부신, 야한, 눈에 띄는, 명백한, 흘겨보는
glary : a, =GLARING
glary : a, (얼음처럼)매끄러운
Glasgow : n, 스코틀랜드 남서부의 항구 도시
glasnost : n, (소련의 물자 부족 등에 관한)공식적 개방 정책
glasphalt : n, 글라스팔트(유리 가루와 아스팔트로 만든 도로 포장재, 상표명)
glass : n, 유리, 유리 모양(질)의 물질, 컵, 글라스, 한 컵의 양, 술, 거울, 창유리, (시계의)유리면, 렌즈, 망원경, 현미경, 온도계, 안경, 쌍안경, 유리제품 under~ 온실에서, 유리창에
glass : vi, 유리를 끼우다, 거울에 비추다
glass arm : x, (야구 선수등의)건이 손상된 팔
glass block : x, 유리 블록(건물의 외벽, 칸막이에 씀)
glass blower : n, 유리 부는 직공(기술, 작업)
glassblowing : n, 유리를 불어서 만드는 제법
glass brick : x, 유리벽돌
glass case : n, 유리를 넣은 상자, 유리 그릇(진열장)
glass cloty : x, 유리 섬유 직물, 유리 닦는 천, (연마용)유리 사포
glasscrete : x, 콘크리트와 유리로 된
glass culture : n, 온실 재배
glass cutter : n, 유리칼, 유리공
glassdust : n, (연마용)유리 가루
glass eye : n, 의안, 사기눈, (말의)흑내장
glass fiber(fibre) : n, 유리 섬유
glassful : n, 유리공장, 유리상점, 온실, 유리지붕의 사진 촬영실
glasshouse effect : x, =GREENHOUSE EFFECT
glassine : n, 글라신지(얇은 반투명의 종이, 책 커버나 식품 포장용)
glassivation : n, 글라시베이션(용융 글라스를 써서 반도체 칩의 표면을 보호, 안정시키는 방법)
glass jaw : x, (권투 선수의)약한 턱
glassmaker : n, 유리 제조인
glassmaking : n, 유리(기구)제조술(업)
glassman : n, 유리 장수, 유리 제조인, 유리직공
glass panerl : x, 글라스패널(자동차 등의 앞좌석과 뒷자석을 가르는 칸막이 창)
glass paper : n, 사포
glass snake : n, 유리뱀, 무족 도마뱀
glass string : x, (연 싸움에 쓰는)유리 파편을 바른 연출
glass tank : x, 유리 용해로
glassteel : a, 유리와 강재로 된
glassware : n, 유리 그릇(제품)
glass wool : x, 유리솜(산의 여과, 절연등에 씀)
glasswork : n, 유리 공장(제품)
glassworker : n, 유리 제조(업), 유리 제품(세공), 거울 장치를 이용한 트릭 촬영, 유리 끼우기
glassworks : n, 유리 공장(제품)
glassy : a, 유리질(모양)의, 매끄러운, (눈이)흐린
glassyeyed : a, 멍한(흐릿한)(표정의), (취하여)거슴추레한, 멀거니 바라보니
Glaswegian : a, n, (시민)의, Glasgow시민
glatingly : ad, 자못 기쁜 듯이(만족스러운 듯이), 고소하다는 듯이
Glauber : x, 망초, 황산소다
glauc- : x, (연결형)(GLAUCOUS)의 뜻(모음앞 에서는 glauc-)
Glauce : n, 글라우케
glaucoma : n, 녹내장
glaucomatous : a, 녹내장의
glauconite : n, 해록석
glaucous : a, 녹회색의, (포도처럼)시설이 덮인
glaum : vi, 잡다, 움켜쥐다
glaze : vt, 판유리를 끼우다, (질그릇에)유약을 칠하다, (종이, 가죽에)윤을 내다, 조미한 국물을 치다
glaze : vi, 매끄럽게 되다, 윤이 나다, (눈이)흐려지다
glaze : n, 윤내는 약, 질그릇의 유약, 구물, 조미한 국물, 우빙(빗물이 땅위에 얼어 붙는 현상)
glazed : a, 유리(창)를 끼운, 유약을 칠한, 웃칠한, 윤낸, 윤나는, 글레이즈를 바른, (눈, 표정등이)흐리멍덩한
glazed brick : x, 광활제를 칠한 화장 벽돌
glazed frose : n, =GLAZE
glazed paper : x, (광활제를 입힌)윤나는 종이
glaze ice : n, =GLAZE
glazier : n, 유리 장수
glazier : n, (도자기에)유약칠하는 직공(기계)
glazier's diamond : x, 유리 자르는 다이아몬드 조각
glaziery : n, =GLASSWORK
glazing : n, 유리 끼우기(세공), 유약 바르기, 유약
glazingbar : n, (창유리의)창살
glazy : a, 유리(유약)같은, 유약을 바른, (눈이)흐릿한
GLCM : x, groundlaunched cruise missile 지상 발사 순항 미사일
gld, : x, guider
gleam : n, vi, 어렴풋한 빛, 번적임, 희미한 징조 , 희미하게 번쩍이다, (생각이)번득이다
gleamer : n, 얼굴에 윤기나게 하는 화장품
gleamy : a, 번득이는, 흐미한, 별나고 비가 오는
glean : vt, n, (이삭을)줍다, 조금씩 모으다, 이삭
gleaner : n, 이삭 줍는 사람, 수집가
gleaning : n, 이삭 줍기, 이삭
glebe : n, 교회 부속지, 성직영지, 땅, 들, 밭
glee : n, 환희, 유쾌, 합창곡
glee club : n, 합창단
gleeful : a, 매우 기뻐하는, 대단히 기분이 좋은, 즐거운
gleeman : n, (중세의)방랑 시인, 방랑 가수
gleep : n, 실험용 증식로
gleesome : n, =GLEEFUL
gleet : n, 만성 요도염, 후림
Gleitzeit : n, =FLEXTIME
glen : n, 작은 골짜기, 협곡
glen check : x, =GLEN PLAID
Glengarry : n, 스코틀랜드 고지 사람의 챙 없는 모자
glenoid : a, 얕은 홈이 있는
glen plaid : x, 글랜 플래드, 글렌 체크(격자무의 일종)
glia : n, 글리아, 신경교
gliadine : n, 글리아딘(밑등에 함유된 단순 단백질의 일종)
glib : a, 유창한, 말솜씨가 훌륭한, 행동이 스마트한
glide : vi, 미끄러지다, 활주(활공)하다
glide : vt, 미끄러뜨리다
glide : n, 미끄러짐, 활주, 활공
glide bomb : x, (날개 달린)활공 폭탄
glidebomg : vt, (45-60도의 각도로)활공 폭격하다
glide path : x, 글라이드 패스, 글라이드 슬로프(특히 계기 비행시 무선 신호에 의한 활강 진로)
glider : n, 미끄러지는 사람, 글라이더, 활공기
gliding : a, n, 미끄러지는, 활공하는, 활주하는, 활공, 활주
gliding angle : x, 활공각
glidingly : ad, 미그러지듯, 술술
gliding shift : x, FLEXTIME에 의한 교대 근무(제)
gliding time : x, =FLEXTIME
glim : n, 등불, 초, 제등, 초롱, 창, 눈
glimmer : vi, n, 희미하게 빛나다, 어렴풋이 보이다, 미광, 어렴풋한 인식, 막연한 생각
glimmering : n, a, 미광, 희미하게 방나는, 알아차림, 생각나는 일
glimpse : n, 흘긋봄, 흘긋 보다
glimpse : vt, vi, 희미하게 보이다, 흘긋 보(이)다
glint : vi, 반짝 빛나다, 반짝임, 섬광
glioma : n, 신경교종
glissade : n, 글리사드, 제동활강(피켈로 평형을 잡으면서 미끌어져내림), 글리사드(미끌어지듯 발을 옮김)
glissando : n, 글리산도(활주법)의, 활주부
glissement : n, 활주
glisten : vi, (부드럽게)반짝 빛나다, 빛남, 섬광
glister : vi, n, 반짝반짝 빛나다
glitch : n, (기계등의)돌연한(사소한)고장, 전류의 순간적 이상
glitter : vi, n, 반짝반짝 빛나다, 반짝임, 광채, 화려, All is not gold that glitters 빛나는 것이 다 금은 아니다
glitterati : n, 사교계의 사람들
glitter ice : x, (비가 급속히 얼어서 생기는)우빙
glitter rock : x, 글리터 록(펑크 록의 일종)
glittery : a, =GLITTERING
glitz : n, 야함, 화미, 현란
glitzy : a, 야한, 화미한, 현란한
GLM : x, graduated length method
gloam : n, 박모
gloaming : n, 땅거미, 황혼
gloat : vi, 황홀한 듯이(만족한 듯이, 빤히) 바라보다
glob : n, (액체의)작은 방울, 덩어리, 반고체의 구슬
global : a, (지)구상의, 전세계의
globalism : n, 세계적 관여주의
globalist : n, 글로벌리스트, 세계적 관여주의자
Global Negotiation : x, 포괄 교섭(UN에서의 남북 문제의 일괄 교섭)
global tectonics : x, =PLATE
global village : x, 지구촌(통신의 발달로 일체화된 세계를 가르킴)
globate : a, 공 모양의
globe : n, 공, 구체, 지구, 지구(천체)의, 공 모양의 물건
globe : vi, vt, 공 모양으로 하다(되다)
globefish : n, 복어
globeflower : n, 금매화
globelike : a, 공모양의
globes : n, (여자의 양쪽)유방
globetrot : n, vi, 세계(관광)여행(을 하다)
globetrotter : n, 세계 관광 여행자
globetrotting : n, 세계 관광 여행(의)
globe valvep : x, (기계의)구형판
globigerina ooze : x, (심해의)글로비게리나 연니
globin : n, 글로빈(헤모글로빈 중의 단배질 성분)
globoid : a, n, 거의 공모양의, 구형체
globose : a, 구형의, 공 모양의
globosity : n, 구형
globulaity : n, 구형을 이루고 있음
globular : a, 공 모양의, 작은 알로 된
globular chart : x, 구면 투영 지도
globular cluster : x, 구상 성단
globular projection : x, (지도 제작상의)구면 투영법
globular sailing : x, 구면 항법
globule : n, 소구, 알
globulin : n, 글로불린, 혈구소
globulous : a, 소구의, 작은 공 모양의, 작은 방울 모양의
glockenspiel : n, 철금, (한 벌의)음계종
glodbrick : n, vt, vi, 가짜 금덩어리, 모조품, 게으름뱅이, 뜨내기, 꾀병앓는 사람, 속이다, 사기하다, 꾀병 앓다, 꾀부리다
glofification : n, (신의)영광을 찬양함, 찬미, 칭찬(찬미)을 받음, 축제, 축연, 미화
glom : vt, 보다(look at), 붙잡다, 체포하다, 훔치다
glomerate : a, (빈틈 없이)꼭 뭉친
glomeration : n, 구형으로 감기, 구형으로 모으기, 밀집, 집괴
glomerular : a, 사구의, 신사구체의
glomerule : n, 단산화서(취산화서의 일종), =glomerulus
glomerulus : n, (신장등의)사구체
glonoin : n, 니트로글리세린
gloom : n, 어둠, 암흑, 암영, 우울, 음울, 음울한 표정
gloom : vi, vt, 어두워(음울해)지(게 하)다, 어두운 얼굴을 하다
gloomster : n, 비관론자(불황, 천재등을 역설, 불안감을 조성하여 자기의 저서나 기사를 팔려고 하는 사람)
gloomy : a, 어두운, 우울한
glop : n, vt, 맛없는(질척한)음식, 감상벽, -에 질척한 것을 치다
Gloria : n, (신을 찬송하는)영광의 찬가, 송영곡, 후광, 견모(견면) 교직물의 일종
Gloria : n, 여자 이름
Gloria patri : x, (성부와 성자와 성령께 영광이 있을지어다)의 찬가
glorifier : n, 찬미자
glorify : vt, (신을)찬미(찬송)하다, (사람을)칭찬하다, 영광을 더하다, 꾸미다, 장식하다
gloriole : n, 후광, 원광
glorious : a, 영광스러운, 빛나는, 장려한, 유쾌한, 현란한, 유쾌한, 기분좋은
Glorious Fourth : x, 영광의 제4일(미국 독립 기념일:7얼 4일)
gloriously : ad, 빛나게, 훌륭히, 멋지게, 근사하게, 기분이 썩 좋게
Glorious revolution : x, 명예 혁병
glory : n, 영광, 명예, 찬미, 송영, 하늘의 영광, 천국, 장관, 번영, 융성, 득의 양양함, 큰기쁨, 후광, Old Glory 미국 국기, 성조기, go to ~ 승천하다, 죽다
glory : vi, 기뻐하다, 뽑내다(in), 자랑하다
glory bos : x, 결혼을 앞둔 여자의 의상함
glory hole : x, 허섭쓰레기를 넣어두는방(서랍, 찬장), 용융 유리 가열로
gloryofthesnow : n, =CHIONODOXA
Glos, : x, Gloucestershire
gloss : n, 윤, 광택, 과택면, 허식
gloss : vt, 윤(광택)을 내다, 겉치레하다, ~ over 용케 숨기다, 속이다
gloss : n, (여백에 적는)주석, 해석, 어휘, 그럴듯한 설명
gloss : vt, vi, 주석(해석)하다, 그럴듯하게 해설하다
gloss, : x, glossary
gloss- : x, (연결형)(혀, 언어)의 듯
glossal : a, 혀의, 혀에 관한
glossarial : a, 어휘의, 용어풀이의
glossarist : n, 어휘주해(주석)자, 용어사전 편자
glossary : n, 어휘, (특수)용어 해설, (주석서 권말의)주요 용어집
glossator : n, 주석자
glossematics : n, 언리학, 언어 기호학
glossily : ad, 번들번들하게, 그럴듯하게
glossiness : n, 광택나는 것, 그럴듯한 것
glossitis : n, 설염
glossmeter : n, (물체 표면의 광택을 재는) 광택계
glosso- : x, (연결형)=GLOSS-
glossographer : n, 주석자, 주해자
glossolalia : n, 방언(펜테코스테파 신자의 기도, 알아들을 수 없는 말을 함)
glossology : n, 언어학, 명명법, 술어학
glossy : a, n, 광택(윤)이 나는, 번질번질한, 모양좋은, 그럴듯한, (윤나는 용지의)미려한 고급 잡지
glot : x, (연결형)(몇 개)언어에 통달한)의 뜻
glottal : a, 성문의
glottal stop : x, 성문 폐쇄음
glottic : a, =GLOTTAL
glottis : n, 성문
glottochronology : n, 언어 연대학
Gloucester : n, 글로스터치즈
Gloucestershire : n, 영국 남서부의 주
glove : n, 장갑, (야구, 권투용)글러브, fit like a ~ 꼭 맞다, handle with ~s 친절히 다루다, take off the ~s 본격적으로 덤벼들다, throw down(take up) the ~ 도전하다(도전에 응하다)
glove box : ㅌ, 글러브 박스(방사성 물질 등을 다루는 밀폐 투명 용기), =GLOVE COMPARTMENT
glove compartment : x, (자동차 운전대 전면 계기판에 달린)장갑 등을 넣는 함
glove doll : x, =HAND PUPPET
glove man : x, 수비 강화 요원
glovemoney : n, (하인에게 주는)팁, 행하
glover : n, 장갑 제조인, 장갑 장수
glove sponge : x, 장갑 모양의 해면
glow : vi, 백열빛을 내다, (개똥벌레 등이)빛을 발하다, (눈이)빛나다, (몸이)달다, 열중하다, (감정이)불붙다
glow : n, 백열, 작열, 빛, (몸이)닮, 만족감, 기쁨, 열중, 열정, 빛남, 불어짐, 선명함
glow discharge : x, 글로방전(저압 가스속에서의 소리없는 발광 방전)
glower : vi, n, 노려보다, 노려봄, 무서운(찡그린) 얼굴(을 하다)
gloweringly : ad, 상을 찡그려
glowfly : n, =FIREFLY
glowing : a, 백열의, 샛빨간, 홍조된, 열렬한, 열심인
glow lamp : x, 백열 전구, 백열(전)등)
glowworm : n, 개똥벌레의 유충
gloxinia : n, 글록시니아(관상 식물의 하나)
gloze : vt, 그럴듯하게 설명하다, 말을 꾸며대다(over), 아첨하다
gloze : vt, vt, n, 빛나(게 하)다, 빛남, 불꽃
glt, : x, gilt
glucagon : n, 글루카곤(췌장에서 나오는 호르몬의 일종)
glucinium : N, =GLUCINUM
glucinum : n, 글루시늄, =BERYLLIUM)
glucoreceptor : n, 글루코리셉터(포도당에 예민한 뇌신경 세포)
glucose : n, 포도당
glucosic : a, 
glucoside : n, 글루코사이드, 당원질, 배당체
glue : n, vt, 아교(로 붙이다)
gluefase : a, 롤러로 풀을 붙이는
gluepot : n, 아교 냄비(아교를 끓이는 이중 냄비)
gluesniffing : n, (본드등)접착제의 냄새를 같기, 시너놀이
gluey : a, 아교를 바른, 아교성질(모양)의, 들러붙는
glum : a, 음울한, 무뚝뚝한
glumpy : a, 
gluon : n, 글루온(쿼크간의 상호 작용을 매개하는 입자)
glut : n, 포식(시키다), 식상(케하다), 공급 과잉(되게 하다)
glutamic acid : n, 글루타민산
glutamine : n, 글루타민(아미노산의 일종)
glutathione : n, 글루타티온(생물 세포속에 들어 있는 글루타민산)
gluteal : a, 둔근의, 둔부의
gluten : n, 글루텐, 부질
gluten flour : x, 글루텐 맥분(밀가루에서 전분의 대부분을 제거한 것)
gluteus : n, 둔근
glutinosity : n, 점착성
glutinous : a, 점착성의
glutinous : a, 아교질의, 점착성의, 끈적끈적한
glutton : n, 대식가, 지칠 줄 모르는 사람, 악착꾸러기, 끈덕진 사람, 족제비과의 동물(오소리 비슷함)
gluttonize : vi, 대식하다, 포식하다
gluttonous : a, 많이 먹는
gluyttony : n, 대식
glycerin : n, 글리신(아미노산의 하나)
glycerinate : vt, 글리세린으로 처리하다
glycerol : n, 글리세롤
glyceryl : a, 글리세릴기의
glycine : n, 글리신(아미노산의 하나)
glyco- : x, (연결형)(달다)의 뜻
glycogen : n, 글리코겐
glycogenesis : n, 글리코겐 합성(생성)
glycogenic : a, 글리코겐의, 당원 생성의
glycol : n, 글리콜(글리셀린과 에틸알코올과의 중간 물질, 자동차동 부동액)
glycolic : a, 글리콜의
glycolysis : n, 해당, 당분해
glyconic : n, a, (그리스, 라틴시의)글라이콘 시체(일종의 4운각 시체) 글라이콘 시체시, 글라이콘 시체의
glycoprotein : n, 당단백(질)(점액소 및 연골의 주성분)
glycoside : n, 배당체, 글리코시드
glycosuria : n, 당뇨
glyph : n, 세로홈, 그림문자, 상형문자, 그림(도안)표지
glyphofraph : n, 전기 조각술
glyphographic : n, 납각 전기 제판(술)의
glyptic : a, 조각의(에 관한), 무늬가 있는
glyptics : n, (보석)조각술)
glyptodont : n, 조치수(armadillo류의 큰 포유동물)
glyptograph : n, 조각한 보석류(보석등의)조각 무늬
glyptography : n, 보석 조각술(학)
gm : x, guided missile, 유도탄
GM : x, Geiger, muller counter
GM(C) : x, General Motor(Corporation)
gm, : x, gram(s)
Gman : n, Government man, 연방수사국원
Gmc, : x, Germanic
Gmen : x, 지맨(미국 연방 수사국의 수사관)<비밀 경찰관>
GMP : x, good manufacturing practice 의약품 제조 품질 관리 기준
GMS : x, general merchandise store 종합 소매점
GMV : x, gram molecular volume
gnarl : n, (나무의)마디, 옹이, 혹
gnarl : vt, ...에 마디를(혹을) 만들다, 비틀거리다
gnarl : vi , (개따위가)으르렁거리다
gnarled : vi, 마디(옹이)가 많은(knotty), 울퉁불퉁한, 비뚤어진, 비꼬인
gnarly : a, =GNARLED
gnash : vi, vt, 이를 악물다, ~ one's teeth (노여워) 이를 갈다
gnat : n, 각다귀, 모기 strain at a ~ and swallow a camel 작은 일에 구애되어 큰 일을 모르고 지나다
gnat's whistle : x, 일품
gnathic : a, 턱의
gnathion : n, 하악점(하악골 중앙 시상면의 최하점)
gnathous : x, (연결형)-턱을 가진)의 뜻
gnaw : vt, vi, 물다, 쓸다, 부식하다, 괴롭히다, 애먹이다
gnawer : n, 무는 사람, 부식시키는 것, 설치 동물
gnawing : n, a, 갉기, 쏠기, 근임없는 고통, 갉는, 쏘는, (고통등이)에는 듯한, 괴롭히는
gnawn : v, GNAW의 과거 분사
GND : x, gross national demand 국민 총수요
GNE : x, gross national expenditure  국민 총지출
gneiss : n, 편마암
gneissic : a, 편마암의
gneissoid : a, 편마암상의
GNI : x, gross national income
gnocchi : n, 뇨키(밀가루, 달걀, 치즈로 만든 흰 경단의 일종)
gnome : n, 땅속의 요정(탄갱 등의 수호신)
gnome : n, 격언
gnomic : a, 격언의, 격언적인
gnomish : a, 땅 신령 같은, 변덕스러운, 장난꾸러기의
gnomology : n, 금언(격언)집, 격언(경구)적 작품
gnomon : n, (해시계의)바늘
gnomonic : a, 
gnomonic projection : x, (지도 제작의)심사도법, 그노모닉 투영
gnomonics : n, 해시계 구조 원리, 해시계 제작법
gnomy : x, (연결형)(판단술(학))의 뜻
gnosis : n, 영적, 인식, 영지
gnosis : x, (연결형)(특히 병적 상태)의 인식의뜻
Gnostic : n, a, 영지교인(의), 영지의
gnostic : x, (연결형)(지식(인식)의 뜻)
Gnosticism : n, a, 영지(그노시스)설(초기 기독교 시대의 신비 철학)
Gnosticize : vi, vt, 그노시스주의적 입장을 취하다, -에 그노시스주의적 해석(성질)을 부여하다
gnotobiology : n, =GNOTOBIOTICS
gnotobiotic : a, 무균의, 특정한 기지의 세균만을 가진 환경의
gnotobiotics : n, 노토바이오틱스, 무균 생물학
GNP, G, N, P : x, gross national product
gnu : x, (남아프리카산의)암소 비슷한 영양
go : n, vt, 가다, 나아가다, 지나가다, 떠나다, ...죽다, 없어지다, 망치다, 못쓰게 되다
go : vt, (내기를)걸다(I will go you a dollar 1달러를 걸겠다), 견디다, 참다
go : n, 가기, 진행, 기력, 정력, 사태, (특수한)상태, 난처한 일, 유행, 시도, 한 잔(의 술), (음식의)한 입, near ho 위기일발, 아슬아슬한 순간
goa : n, 영양의 일종(티벳산)
Goa : n, 고아(인도 남서안의 옛 포르투갈 영토)
goad : n, vt, (가축을 목기 위한)뾰족한 막대기(로 찌르다), 자극(을 주다), 격려(하다)
goahead : a, 전진하는, 진취적인(행동), 야심, 기력
goaheadativeness : n, 진취적 기상, 적극성
goaheadism : n, 적극주의, 진취적 기상
goahead run : x, 리드를 잡는 득점
goal : n, 골, 결승점, 목적지
goal area : x, 골에어리어
goal arerage : x, (구기에서의)평균 득점, 득점률
goal difference : x, 골 득실차
goalie, goalee : x, =GOAL KEEPER
goal keepper : n, 골키퍼
goal kick : x, 골킥
goalline : n, 골라인
goal line defense : x, 골라인 수비
goal line offense : x, 골라인 공격
goalmouth : N, (하키)골문의 기둥과 기둥 사이
goalpost : n, 골대
goaltender : n, 빙구의 골키퍼
Goa powder : x, 고아 분말(브라질산 아라로바나무에서 채취하는 약용 분말)
goaround : n, 한차례의 승부, 격론, 우회도로, 회피
goasyouplease : a, (경주에서)규칙에 얽매이지 않는, 되는 대로의, 제멋대로의
goat : n, 여소, 염소자리, 색골, 악인, (남아)희생, get a person's ~ 아무를 노하게 하다(괴롭히다)
goatbeard : n, =GOATSBEARD
goatee : n, 염소 수염
goat god : x, 목양신
goatherd : n, 염소 지기
goatish : a, 염소 같은, 호색의
goatling : n, 염소새키(1-2세의 암컷)
goatsbeard : n, 눈개승마, 나도쇠채
goatskin : n, 염소 가죽
goatsucker : n, 쏙독새
goaty : a, =GOATISH
gob : a, vi, (점코, 크림, 구름등의)덩어리, 많음, 잡석인 충전물, 버력, 입속에 가득찬 침, 뱉음 침, 수병, 입, 침을 뱉다
gobbet : n, (날고기, 음시의)한 덩어리, 한입, (해석, 번역등을)위한 본문의 일부분, 발췌, 악곡의 일부분
gobble : vt, 게걸스레 먹다, 통째로 삼키다
gobble : vt, (칠면조가)골골 울다(우는 소리)
gobble : n, 가블(공을 구멍에 빠른 속도로 쳐넣기)
gobbledegook : n, (공문 서식의)딱딱하고 꽤까다로운 표현(강연), 뜻모를 소리
gobbler : n, 칠면조의 수컷
gobbler : n, 걸귀, 남독가
Gobelin : a, (프랑스의 Gobelin공장에서 만든)고블랭천의
Gobelin blue : x, 짙은 청록색
gobernment : n, 통치, 지배, 정치, 정부, 내각
gobetween : n, 매개인, 중매 장이
gobi : n, 고비 사막
goblet : n, 받침 달린 컵(잔)
goblin : n, 악귀, 도깨비
gobo : n, 텔레비전 카메라용 차광막
gobstopper : n, 크고 둥근 딱딱한 캔디
goby : n, 문절망둑
goby : n, 지나쳐 감, 못 본체함, give(get) the ~ 무사하다(당하다), 못 본체하다(체함을 당하다)
gocart : n, 유모차, (유아용)보행기
gock : n, 더러운(추접스러운)것
god : n, 신, 하느님, 조물주, (초자연적인)신, 우상, 중요한 사람, 삼등석의 관객
god : vt, 신격화하다, 숭배하다
God's Eye : x, 신의 눈(잔가지로 만든 십자가에 색실을 기하학적 무늬로 감은 것, 멕시코, 미국 남서부에서 행운의 부적으로 씀)
God's medicine : x, 마약
god Almighty : x, 전능의 신
Godardian : x, 고다르풍의(카메라의 분방한 사용법, 시나리오의 즉흥성, 파격적인 연출 등이 특색)
godawful : a, 정말 싫은, 지독한
god beetle : x, 풍뎅이
godbox : n, 교회, 예배당, 오르간
godchild : n, 대자
goddamn, goddam : int, n, vt, ad, 망할, 빌어먹을, 제기랄(분노, 울분을 나타내는 욕설), (종종)=DAMN, 대단히
goddamnit : int, =GODDAMN
goddaughter : n, 대녀
goddess : n, 여신
godeneye : n, 흰뺨오리
godet : n, (의복에 넣는)바대
godetia : n, 고데티아(달맞이꽃 비슷한 관상용 1년초)
godevil : n, 유정 안의 다이너마이트 폭파기, 급유관 청소기, 목재 운반용 썰매
godfather : n, 대부
godfearing : a, (악마를 두려워 않고) 신을 두려워하는, 믿음이 깊은
godforsaken : a, 신에게 버림받은, 타락한, 황량한, 쓸쓸한
godfrey : n, 남자이름
godgiven : a, 하늘이 준, 고마운, 절호의
godhead : n, 신성, 신격, 하느님
godhood : n, 신성, 신격
Godiva : n, 여자이름, 고다이바(11세기 영국 머시아 백작 Leofric의 아내)
godking : n, 신격화된 군주
godless : a, 신의 존재를 부인하는, 신을 인정하지(믿지)않는, 믿음이 없는, 불경한
godlike : a, 신같은, 존엄한, 위엄있는
godliness : n, 경신, 경건, 청렴한 인격, 신앙심 깊은 성격
godly : a, 신을 공경하는, 믿음이 깊은, 경건한, 믿음이 깊은 사람들
Godman : n, =CHRIST
godmother : n, 대모
godown : n, 지하실
godown : n, (동남아시아의) 창고
godparent : n, 대부, 대모
God save the Queen : x, 여왕(국왕)폐하 만세(영국 국가, 작사, 작곡자 불명)
godsend : n, 하늘이 준것, 뜻밖의 행운
godsent : a, 하늘이 주신
godship : n, 신임, 신위, 신격
God slot : x, (라디오, 텔레비젼의)종교 프로
godson : n, 대자
Godspeed : n, 행운, 성공(안전)(의 기원)
Godward : ad, a, 신을 향하여, 경신의, 신앙이 두터운
Godwards : ad, =GODWARD
Godwin : n, 남자이름
godwit : n, 흑꼬리도요
goer : n, 가는 사람(것)
goethe : n, (1749~1832)괴테(독일의 문호)
Goethean : a, n, 괴테의(에 관한), 괴테풍의, 괴테 숭배(연구)자
gofer : n, 얇은 버터케이크
gofer : n, (회사의)잡일 담당자, 잔심부름꾼
goffer : vt, n, (천등에)주름을 잡다, 구김살을 짓다, 주름, 구김살, 개더, 주름잡는 기구(다리미)
goffering : n, 주름잡기, 주름 장식
Gog and Magog : x, 곡과 마곡(사탕에 미혹되어 하늘 나라에 대항하는 두나라)
gogetter : n, 활동가, 수완가
gogetting : a, 수완 있는
goggle : vi, vt, n, (눈알을)희번덕거리다(기리기), 눈알을 굴리다(굴리기), 눈을 부릅뜨고 보다(보기), 부릅뜬 눈
goggle : a, 통방울눈의, 희번덕거리는
gogglebox : n, 텔레비젼
goggledive : n, 잠수 안경을 쓰고하는 잠수
goggleeyed : a, 퉁방울눈의, 희번덕거리는
goggler : n, 눈을 휘둥그렇게 뜨고 보는 사람
Gogh : x, Vincent van (1953~1990)고호(네덜란드의 후기 인상파의 화가)
goglet : n, 물을 식히는 질그릇병
gogo : a, 고고 댄스(곡)의, 활발한, 현대적인, 생기가 넘치는
gogo boot : x, 고고 부츠(무릎까지 닿는 여자용 부츠)
gogo conglomerate : x, 고고 콜글로머리트(성장 분야의 기업이나 벤처비즈니스를 대담하게 매수, 합병하여 급성장하는 기업)
gogo dance : x, 고고춤
gogo dancer : x, 고고 댄서
gogo fund : x, 주식의 단기 투자 자금)
gogol : n, Nikolai Vasilievich(1809~1852)러시아의 소설가
Goidelic : a, 게일족의, 게일말의, 고이델어군
going : n, 가기, 보행, 진행(속도), 출발, (도로의)상태, 진행중의
going : a, 진행(운전, 활동)중의, 현행의, in ~ order 고장없이, 건전하게, keep ~ ...을 계속하다, 유지하다
goingaway dress : n, (신부의)신혼 여행용 드레스
goingover : n, 철저한 조사, 호통, 때리기
going public : x, 주식 공개
goingson : n, 행위, 행실
goingtovisit : a, 외출의, 나들이의(옷등)
goitalone : a, 독립한, 자립한
goiter : n, 갑상선종
goitrogen : n, 고이트러젠, 갑상선종 물질
goitrous : a, 갑상선종(성)의
gokart : n, =GOCART
Golconda : n, 골콘다, 무진장의 부, 보물 더미
gold : n, 금, 황금, 금빛, 금화, 부, 금도금, heart of ~ 아름다운 마음(의 소유자), old ~ 낡은 금빛
gold : a, 금(빛)의, 금으로 만든
gold-tipped : x, 금빛 물부리가 달린(궐련 등)
gold amalgam : x, 금 아말감
gold basis : x, 금본위 기준
goldbeater : n, 금박공
goldbeater's skin : x, 금박공의 가죽(박 사이에 끼우는)
goldbeating : n, 금박 제조(기술)
gold bloc : x, 금블록(금본위국끼리의 화폐블록)
gold bug : n, 풍뎅이, 갑부
gold certificate : x, 금화 증권
gold clause : x, 금약관
gold coast : n, 황금 해안(현 Ghana공화국의 일부)
gold digger : n, 금광부, 황금광, 남의 돈을 옭아내는 여자
goldding : vt, vi, 감언이설로 돈을 우려먹다
gold dust : n, 사금
goldem : n, (유대 인조 인간), 자동 인형, 로봇, 얼간이
gold embargo : x, 금수출 금지
golden : a, 금빛의, 황금빛의, 누런빛의, 금의, 금으로 반든, 금이 가득찬, 귀중한, 가장 좋은, 훌륭한, 절호의(기회등), 전성의
Golden Access Passport : x, (맹인등)신체 장애자 우대증
golden age : x, 황금시대, (예술, 문학등의)황금시대, 전성기, 중년이후의 인생
golden age club : x, 노인 사교, 오락 클럽
Golden Age Passport : x, 노인 우대증(62세이상의 노인에게 주는 무료 입장 증명서)
goldenager : n, 초로의 은퇴한 사람
golden anniversary : x, 50주년 기념일
golden balls : x, 전당포 간판(금빛 공3개)
golden boy : x, 인기 있는 사람, 총아
Golden Bull : x, 금인칙서
golden calf : x, 금송아지
Golden Crescent : x, 이란, 아프가니스탄, 북부 파키스탄에 걸친 마약 생산, 거래지대
Golden Delicious : x, 골든 딜리셔스(미국 원산의 노란 사과)
golden disc : x, =GOLD RECORD
Golden Fleece : n, 금양모(Jason이 용으로부터 빼앗아 온)
Golden Gate : n, 금문만(샌프란시스코의 입구)
golden glow : n, 삼잎국화
golden goose : n, 황금알을 낳는 거위(동화속의)
golden handshake : x, 고액의 퇴직금(고령의 퇴직자에게 지급하는)
Golden Horde : x, 황금 군단(13세기에 유럽에 원정한 몽고의 군단)
Golden Horn : n, 골든 혼
golden jubilee : x, 50년 축전
golden key : n, 뇌물, 코 아래 진상
golden mean : n, 중용, 중도
golden nematode : x, 시스토 선층(감자, 토마토의 해충)
golden number : n, 황금수(서력 연수에 1을 더하여 19로 나눈 나머지수, 부활절의 날짜를 산출하는 데 씀
golden oldie : x, 그리운 옛 노래(스포츠, 영화등)
golden oriole : x, 유럽꾀꼬리
Golden Pages : x, 직업별 전화 번호부
golden palm : x, 황금의 종려
golden parachute : x, (회사의 중역등의)고액의 퇴직 수당 지불 보증 고용 계약
golden rain : x, 금련화류
golden retriever : x, 골든 리트리버(영국 원산의 새 사냥개)
goldenrod : n, 메역취속의 식물
golden rule : n, 황금률(마태복음의 산상수훈 중의 말, "무엇이든지 남에게 대접을 받고자 하는 대로 너희도 남을 대접하라")
golden saying : n, 금언
goldenseal : x, 히드라스티스(미국원산)
golden section : x, 황금 분할
golden shower : x, 사배나주엽나무, 상대방의 얼굴, 몸에 오줌을 깔기는 짓
Golden State : x, 미국 California주의 속칭
golden syrup : x, 골든 시럽(꿀 시럽)
golden thumb : x, 돈 잘 버는 사람
Golden Ttiangle : x, 황금의 삼각지대;고생산성 지역
golden wedding : n, (결혼 50년을 축하하는)금혼식
golden years : x, 노후
golden youth : x, 상류 계급의 젊은이
gold exchang standard : x, 금환 본위제
gold fever : x, 금광열, 황금열
goldfield : n, 채금지, 금광지대
goldfilled : a, 금을 입힌
goldfinch : n, 오색방울색, 황금방울색
goldfish : n, 금붕어
gold foil : x, 금박
gold handcuffs : x, (회사가 제공하는)우대조치
goldie : n, =GOLD RECORD
goldilocks : n, 금발의사람;미나리아재비의 일종
Golding : n, 골딩 William Gerald(영국의 소설가)노벨 문학상 수상
gold lace : x, 금 레이스
gold leaf : x, 금박
gold medal : x, 금메달
gold mine : x, 금광;부원, 돈벌이가 되는것
gold note : x, 금태환지폐
gold plate : vt, 금을 입히다
gold plate : x, 에 금을 입히다, 금도금하다
gold point : x, 정화 수송점
gold record : x, 황금의 레코드(싱글판으로 100만판매, LP앨범으로 50만 세트 팔린 레코드의가수, 그룹에게 주는 상
gold reserve : x, 정화준비
gold rush : x, 골든러시, 새 금광지로의 쇄도
gold size : x, 금박을 입히기 전에 칠하는 도료
goldsmith : n, 금 세공인
Goldsmith Oliver : n, (1930~1874)아일랜드 태생의 영국의 시인, 극작가, 소설가
gold standard : x, (통화의)금본위제
gold star : x, (학교에서 두등 표시로 주는)작은 금별, (전사자 가좃을 표시하는)금성장
gold star mother : x,  전사자의 어머니
gold stone : x, 사금석;황옥
Gold Strck : x, (영)국가적 행사 때 황금 막대를 받고 왕(여왕)을 모시는 궁내관;금 빛 막대
goldthread : x, 황령
goldwork : n, 금세공
golend eagle : x, 검독수리
golenmouthed : a, 웅변의, 구변이 좋은
golf : n, 골프
golf ball : n, 골프공
golf cart : x, 골프카트(골프백을 나르는 손수레)
golf club : n, 골프채, 골프클럽
golf course : n, 골프장, 골프코스
golfer : n, 골프를 치는 사람
golf links : x, =GOLF COURSE
golf window : n, 골프광의 아내
Golgiapparatus : x, 골지장치
Golgi body : x, 골지체
Golgi complex : x, 골지 복합체
Golgotha : n, 골고다(예수가 십자가에 못 박힌 곳), 예수의 십자가상
goliard : n, 편력시인
goliardery : n, (집합적)편력 시인의 라틴어 풍자시
Goliath : n, 골리앗(다윗에게 살해된 거인), 이동 기중기
golliwog : n, 기괴한 얼굴의 인형
golly : int, 저런, 어머나, 맹세코(놀람, 맹세등을 나타냄)
golong : n, 범인호송차
golosh : n, =OVERSHOE
goluptious : a, (익살)아주 맛있는
goma : n, 아편
gombah : n, (미)(마피아단의)친한 친구
gombeen : n, (아일)고리대금;터무니없는 고리
gombeenman : x, (아일)고리 대금업자
gombroom : n, 곰브룬(백색 반투명의 페르시아 도기)
gomer : n, 신참 사관
gomeral : n, (스코)바보, 얼간이
Gomorrah : n, =고모라시(천벌로 이웃도시 Sondom과 함께 멸망됨, 창세기 18, 19, 24)
gon : x, (연결형)성;생식
gonad : n, 생식선
gonadal : a, 
gonadotropin : n, 성선 자극 호르몬
Goncharov : x, 곤차로프(러시아의 소설가)
goncourtprize : n, 공쿠르상(매년 우수 문학 작품에 수여)
gondola : n, 곤돌라, 너벅선, (기구 따위의)조롱
gondolier : n, 곤돌라의 사공
gone : v, go의 과거분사
gone : a, 지나간, 가망 없는, 영락한, 희미한, 훌륭한, 일류의, far ~ (훨씬)앞선, 깊이 들어간(개입된), ~ on ...와 사랑하여
gone engineering : x, 유전자 공학
goner : n, 죽은 사람, 가망 없는 사람
gonfalon : n, (끝이 여러 가닥으로 갈라진)기
gong : n, 징, 그 소리, 접시 모야의 종
gong : vt, ...에게 징을 울려 신호하다, be ~ed (교통 위반으로)정지 명령을 받다
gonna : a ...할 예정인
gonococcus : n, 임균
gonocyte : n, 생식 모세포
gonogo : a, 계속하느냐 중지하느냐의 결정(시기)에 관한
gonophore : n, (히드로충류 등의)생식체
gonorrhea : n, 임질
gonsil : n, =GUNSEL
goo : n, 찐득거리는 것, 지나친 감상
goober : n, 땅콩
good : n, 좋은, 잘된, 훌륭한, 행복한, 아름다운, 선량한, 예의바른, 현명한, 친절한, 관대한, 능숙한, 유능한, 참된, 유효한(as~as (죽은 것)과 같은
good : n, 선, 선량함, 이익, 행복, 선량한 사람들, 화물, 상품, 동산, 재산, 천 come to ~좋은 열매를 맺사
good-bye : n, 안녕
good-day : n, (주로)날 동안의 인사
good cheer : x, 즐거운 잔치, 진수성찬
goodconditioned : a, 컨디션이 좋은
good conduct : x, =GOOD BEHAVIOR
Good Conduct Medal : x, 선행장
good deal : a, 다수, 다량
good debts : x, 회수가 확실한 대부금
good egg : x, 좋은 사람
good evening : x, 저녁인사
good faith : n, 성실, 성의
good feeling : x, 선의, 호의
good fellow : x, 착한 사람;친한 친구
goodfellowship : n, 친목, 정다운 우정
goodfornaught : a, =GOOD, FOR, NOTHING
goodfornothing : a, 건달(의), 밥벌레
Good Friday : n, 성 금요일(부활절전의 금요일, 예수 수난을 기념함)
good guy : x, 좋은 사람, 공정한 사람
good hair : x, 곱슬하지 않고 윤기 있는 머리털
goodhearted : a, 친절한
Good Hope : n, 희망봉(남아프리카 남단의 곶)
good humor : x, 좋은 기분
good humored : a, 명랑한 , 사근사근한
goodie : n, (영화 등의)주인공
goodiness : n, 너무 선인인체하기
goodish : a, 꽤 좋은, 나쁘지 않은
good Joe : 괜찮은 놈, 좋은 친구, 
good life : n, 평균 수명까지 살 가망이 있는 사람
goodliness : n, 상질, 고급, 우수;미모, 상당한 크기(양)
goodlooker : n, 미녀, 미남
goodlooking : a, 잘생긴, 아름다운
goodlooks : x, 잘생긴 얼굴, 미모
good luck : n, 행운
goodly : a, 용모가 단정한, 잘생긴
good make : x,  꾐에 잘 넘어가는 여자
goodman : n, 바깥 주인, 가장;남편
good money : n, 양화, 많은 급료
goodmorning : n, (오전 중의 인사)안녕히 가(계)십니다
good morrow : x, =GOOD MORNING
goodnature : x, 고운 성질(마음씨), 친절
goodnatured : a, 사람이 좋은, 온후한
goodneighbor : x, ( 라와 나라가)선린의, 우호적인
Good Neighbor Policy : x, 선린 정책(1993년 미국Roosevelt 대통령이 제창)
goodness : n, 좋음, 선량함, 미덕, 친절, 신
goodnews : x, 좋은 소식;복음(gospel);(미, 캐나다)바람직한 인물
good night : x, 안녕히 주무십시오
good offices : x, 알선, 주선, 진력, 소개;중재, 조정
good old : x, 싹싹한(허물없는)남부인
good people : x, 요정들
goods : a, n, 상품, 물품, 동산
good Samaritan : x, 착한 사마리아 사람, 친절한 사람
good sence : n, 상식, 양식, 분별
Good Shepherd : x, 선한목자(그리스도를 말함)
goodsize : a, 꽤 큰
good sort : 매력적인 여자
good speed : x, 행운, 성공(good luck)
goods train : n, 화물 열차
goods wagon : x, (영)철도화차
goods yard : x, 화물 터미널
goodtempered : a, 상냥한, 온순한
goodthing : x, 좋은 일;좋은 착상;행운;경구
goodtime : x, 좋은 일;좋은 착상;행운
goodtime Charlie : x, 방탕자, 오입쟁이
good turn : x, 선행, 친절한 행위, 호의
good use : n, (언어의) 표준 어법
goodwife : n,  주부, 안주인
goodwill : n, 호의, 동정, 영업권, 단골
good works : x, 자선행위, 선행
goody : n, 맛있는 것, 과자, 봉봉
goody : n, 아주머니(신분이 낮은 여자에 대하여 씀), 신분이 낮은 여자
goodygoody : a, 믿음이 깊은 체하는(사람), 유달리 잘난 체하는(사람)
gooey : a, 끈적끈적한, 들러붙는
goof : n, 바보
goof : vi, 바보 짓을 하다, 빈둥거리다
goof : vt, 실수하다, (마취약 따위로)멍청하게 만들다
goofball : n, 정신 안정제, 수면제
gooff : n, 착수, 개시
goofoff : n, 비겁한 자, 게으름뱅이, 농뗑이
goofy : a, 바보같은, 얼빠진
goofyfoot : n, (서핑)오른발을 앞으로 내고 타는 서퍼
googly : n, (크리켓)완곡구
googol : n, 10의 100제곱;천문학적 숫자
googoo : n, 정치개혁자
googoo eyes : x, 추파
gook : n, 오물, 때, 점액, 바보, 아시아인에 대한 멸칭
goon : n, 난폭자, (고용된)폭한, 얼간이
goony : a, 어리석은, 미련한
goose : n, 거위(의 암컷), 거위고기, 대형 다리미(손잡이가 거위목 비슷함), 바보, 얼간이, sound on the ~ (생각, 방침이)온건하여, (주의 등에)충실하여
gooseberry brsh : n, 구즈베리나무
gooseberry fool : x, 구즈베리를 흐물흐물하게 끓여 크림과 설탕을 탄것
goose bumps : x, =GOOSEFLESH
goose club : x, (영)크리스마스 때 쓸 거위를 사기 위한 적립금 조합;소노동 조합
goose egg : n, 거위알
goose flesh : n, (추위, 공포에 의한)소름
goosefoot : n, 명아주
goosegog : n, (영)=GOOSE BERRY
goose grass : x, 갈퀴덩굴
gooseherd : n, 거위 기르는 사람
gooseneck : n, 거위 목 모양의 연장 또는 관
gooseneck lamp : x, 목이 자유롭게 돌아가는 전기 스탠드
goose pimples : x, =GOOD FLESH
goose quill : x, 거위의 깃;깃펜
gooseskin : n, =GOOSEFLESH
goosey : a, 거위;바보(어린아이를 꾸짖는 말)
goozo : a, 머리가 돈, 정신 이상자
GOP : x, Grand Old Party 미국 공화당의 미칭
gopher : n, 들쥐(류)
gopher ball : x, 홈런을 칠 수 있는 좋은 볼
gopher snake : x, 미국 남부산의 독 없는 큰 뱀
Gopher State :  z, 미국 Minnesota wndml thrcld
gopher wood : x, Noah의 방주를 만든 나무
goral : n, 히말라야 영양
Gorbachec : n, 고르바초프(소련의 정치가;공산당 서기장)
gorblimey : int, (영)빌어먹을, 염병할
gorcock : n, 붉은뇌조의 수컷
Gordianknot : n, 아주 어려운 일, 어려운 문제 cut the ~ 용단으로 어려운 일을 해결하다(Alexamder 대왕이 단단하 매듭을 풀지 않고 칼로 끊어버렀다는 이야기에서)
Gordon : n, 고든(영국의 장군)
Gordon(setter) : x, 고든세터(스코틀랜드 원산의 털이 검은 중형의 사냥개
gore : n, 흘린(엉긴)피, 응혈
gore : n, vt, 삼각형의 헝겊 조각, (옷의)무, 삼각형의 토지, 무를 달다
gore : vt, (창, 뿔 따위로)찌르다, 꽂다
gorge : n, 골짜기, 삼킨 음식, 불쾌, 좁은통로(시내)를 막는 물건
gorge : vt, 게걸스레 먹다, 가득 채우다(들어 넣다) oneself 게걸스레 먹다
gorgein : ㅜ, 기둥몸과 대접받침과의 접합부
gorgeous : a, 호화스러운
gorget : n, (갑옷의)목가리개
Gorgetown : n, 조지타운, 미국 Washington, D, C의 한 주택 지구
gorgio : n, 집시 아닌 사람(집시용어)
Gorgon : n, 고곤(보는 사람을 돌로 변하게 했다는 세자매의 괴물), 지독한 추녀, 무서운 여자
gorgoneion : n, 고르고네이온
gorgonian : a, 고르곤의(같은), 대단히 무서운
gorgonize : vt, 노려보아돌로 변하게 하다
Gorgonzola : n, (이탈리아 고르곤졸라시산)치즈의 일종
gorhen : n, =MOORHEN
gorilla : n, 고릴라, 폭한
gork : n, (고령, 사고, 병 등으로)뇌 기능을 상실한 사람, 식물인간
gormand : vi, 많이(게걸스레) 먹다
gormandize : n, 많이 먹다, 폭식하다
gormandizer : n, 대식가
gormless : a, (영)얼띤, 아둔한
gorse : n, 가시금작화
gosh : int, 아이쿠, 큰일 났군, 기필코
goshawk : n, 참매(옛날 매 사냥에 쓴)
Goshen : n, 고센 땅, 기름진 땅, 낙토
gosho : n, 공항에서(예약없이)취소된 좌석이 나기를 기다리는 사람
gosling : n, 거위 새끼
goslow : a, (일부러)천천히 하는, 태업(전술)의
gospel : n, (예수의)복음, (기독교의)교리, 교의, 신조, 진리, 주의, 복음서
gospeler : n, 복음서 기자;순회 설교자
gospel oath : x, 성서에 의한 선서
gospelpusher : n, (미)설교자, 목사
gospel side : x, 복음서쪽
gospel truth : n, 복음서의 진리, 절대적인 진리
Gosplan : n, (소련의)국가 계획 위원회
gosport : n, (비행기내의)기내 통화관
gossamer : n, a, 작은 거미의 집, 섬세한 물건, 얇은 천, 섬세한, 가냘픈
gossip : n, 잡담(세상이야기, 한담)(을 하다), 수다(쟁이), 소문, 험담
gossip column : x, (신문, 잡지의)가십난
gossiping : a, 쑥덕공론하는, 수다쟁이
gossipmonger : n, 소문을 퍼뜨리는 사람
gossipry : n, 잡담, 한담
gossipy : a, (사람이)말하기를 좋아하는, 수다스러운
gossoon : n, 소년, 심부름하는 아이
gostop : n, (영)=STOP-GO
got : v, get의 과거(분사)
got-up : a, 꾸며낸, 인공적인, 모방한, 가짜의
goth : n, 고트 사람(3, 5세기경 로마 제국에 침입한 튜튼계 민족), 야만인
Gotham : n, (영국의)고텀 마을, 바보의 마을
Gothamite : n, (익살)뉴욕 시민
Gothic : a, 고딕 건축(양식)의, 고트족(말)의, 중세의, 야만적인
Gothically : n, 고딕식으로
Gothic arch : x, 고딕 아치(끝이 뾰족함)
Gothic architecture : x, 고딕 양식의 건축(12-16세기에 서구에 널리 유행한 끝이 뾰족한 아치형의 양식
Gothicism : n, 고딕식(취미);야만;고트 말의 어법
gothicize : vt, 고딕 양식으로 하다;중세풍으로 하다
Gothick : a, =Gothic5
gothickry : x, (영)(소설, 영화등의)괴기 취향(취미)
Gothic novel : x, 괴기, 공포 소설(18세기 후반 부터 19세기 초에 걸쳐 영국에서 유행
Gothic type : x, 고딕 활자체
gotomeeting : a, 외출용의
gotta : x, =(have(has))
gotten : v, get의 과거분사
gouache : n, 고무 수채화(법), 고무 수채화 재료
Gouda : n, 고다 치즈(네덜란드 원산)
gouge : n, 둥근 골(로 파다), 후벼 내다(out), 사기(꾼), 속이다
goulash : n, (송아지)고기와 야채의 (매운) 스튜요리
goulash commnuism : x, 굴라시 공산주의(소비 물자의 증산, 생활 수준 향상책을 강조
Gounod : n, (1818~1893)프랑스의 작곡가
gourami : n, 구라미(등목어과의 동남아시아산 식용, 관상용 담수어
gourd : n, 호리병박(으로 만든 용기)
gourde : n, 구르드(Haiti 화폐 단위;기호)
gourmand : n, 대식가, 미식가
gourmandise : n, 식도락;대식
gourmandism : n, 미식주의, 식도락
gourmet : n, 미식가, 식통
gout : n, 통풍, (특히, 피의)방울, 응혈
gout : n, 맛, 취미
gouty : a, 통풍의(에 걸린)
govern : vt, 통치(지배)하다, 관리하다, 제어(억제)하다
governable : a, 다스릴 수 있는, 지배(통제, 과리)할 수 있는
governance : n, 지배, 정치, 통치
governess : n, 여자 가정 교사, 여성 지사, 지사 부인
governess cart : x, (영)마주 앉는 좌석의)2륜 경마차
governing : a, 통치하는, 관리하는;지배(지도)적인
government : n, 통지, 지배, 정치, 정체, 정부, 내각, 지배
governmental : a, 정부의, 정치(상)의, 통치의;관영의
government bond : x, 국채
Government House : x,  (영국시민지 등의)총독 관저
government issue : x, 관급품;관급의, 정부 발행
government man : n, 관리, 국가 공무원, 정부 지지자
governmentoperated : a, 국영, 관영의
government paper : x, 정부 발행 유가 증권
government party : x, 여당, 정부당
government security : x, 정부 발향 유가 증권(등)
governor : n, 통치자, 지배자, 지사, 장관, 사령관, (은행, 협회 등의)회장, 총재, 두목, 주인어른, (배기, 속도 등의)조절기
governorelect : n, (취임전의)새 지사, 새 총독, 지사 당선자
governorgeneral : n, (식민지 등의)총독
governorship : n, 지사(장관, 총재 등)의 직(지위, 임기)
gown : n, (여자의)긴 겉옷, 야회복, 잠옷, 화장복, 가운(법관, 성직자, 대학교수, 학생 등의 제복, 대학생)
gownan : n, (스코)데이지
gownsman : n, 법관, 변호사, 성직자, 교수, 학생
Goya : n, Francisco(1746~1828)
goyaesque : a, 고야풍의(공상적이고 괴기한)
goyish : a, GOY의 (같은), 이교도의
GP : x, general practitioner
GPA : x, General Procurement Agency 물자 조달청
GPI : x, general paralysis of the insane 뇌매독
GPO : x, General Post Office
Gr, Br(it) : x, Great Britain
gr, wt, : x, gross weight
grab : vt, 움켜잡(쥐)다, 빼앗다
grab : n, 움켜잡(쥐)기, 잡아채기, 횡령, 집(어올리는) 기계
grab bag : x, 보물 찾기 주머니, 온갖 잡다한 것
grabber : n, 부여잡는 사람;강탈자;욕심꾸러기
grabble : vi, 손으로 더듬다, 엎드리다
grabby : a, 욕심 사나운, 탐욕스러운
Grabchus : n, 그라쿠스(고대 로마의 정치가, 사회 개혁가 형제)
graben : n, 지구
grabhook : n, 걸거나 잡기 위한 갈고랑
grace : n, 우미, 우아, 얌전함, 고상함, 은혜, 은고, 천혜, (신의)은총, 장점, 미덕, 애교, 매력, 특사, 유예, 연기, 식전, 장식음
grace : vt, 아름답게(우아하게)하다, 꾸미다, 영광을(품위를)더하다
grace cup : x, 건배(의 잔), 축배;(출발전)이별의 술잔
graceful : a, 우미(우아)한(하게)
graceless : a, 버릇없는, 무례한, 야비한
grace note : n, 장식음
grace period : x, 유예기간
gracile : a, 가느다란, 연약한야리고 예쁘장한
gracilis : n, 박근
gracilty : n, 연약함;가냘픈 아름다움
gracious : a, 품위있는, 정중한, 상냥한
graciously : ad, 우아하게, 상냥하게
grackle : n, 찌르레기 무리의 새
grad : n, 졸업생
gradate : vt, vi, (빛깔을)바림하다. 차차 다른 빛깔로 변(하게 )하다
gradation : n, 등급 매기기, 순위, 단계, 순서, 변화, 모음 전환
gradational : a, 순서가 있는, 단계적인
grade : n, 계급, 단계, 정도, 도수, (국민, 중학교)학년, 물매, 경사, 개량 잡종
grade : vt, 등급을 정하다(매기다), 경사를 완만하게 하다
grade : vi, (...의) 등급이다, 서서히 변화하다
Grade A : x, 제1급의, 최고급의
grade creep : x, (공무원의)자동적 승진, 연공에 따른 승격
grade crossing : x, (철도와 도로 등의)수평 건널목, 평면 교차
graded school : n, =ELEMENTARY SCHOOL
gradely : a, 멋진, 휼륭한, 완전한, 유망한
grademake : n, vt, 품질(등급)표시(를 하다)
grade point : x, (미)(숫자로 나타낸)성적 평점
grade point average : x, (미)성적의 평균점
grader : n, 등급을 매기는 사람(물건)
grade school : x, (미)(6년제 또는 8년제의)국민학교
grade separation : n, 입체 교차
gradient : n, (통로 등의)물매, 언덕, 경사진 곳, (온고 기압의)변화율
gradienter : n, 측사계, 미각계
gradin : n, 낮은 층계(좌석)의 한 층
gradual : a, 점차(점진, 순차)적인, 서서히 하는
gradualism : n, 점진주의
gradualist : n, 점진주의자
gradually : ad, 차차, 차츰, 점차로
Gradual Psalm : x, 성전에 올라가는 노래(성서 시편 제 120-134의 15편)
graduand : n, (영)(대학의)졸업(학위 취득)예정자
graduate : vt, 등급(눈금)을 매기다, 학위를 수여하다, (대학을)졸업하다
graduate : vi, 학위를 받다, (대학을)졸업하다, (학교종류에 관계 없이)졸업하다, 자격을 얻다, 점차로 변하다(옮기다)
graduate : n, 학사, 졸업생
graduate : a, 졸업한
graduated : a, 눈금을 새긴
graduated deterrence : x, (전략 핵무기 사용의)단계적 억지 전략
graduated length method : x, 점차적 길이 변경법(기술의 향상에 따라 스키를 긴 것으로 점차 바꾸어 가는 스키 지도법)
graduated payment mortage : x, (미)(주택 융자의)경사 상환 방식 저당
graduate nurse : n, (양성소 졸업의)유자격 간호사
graduate school : n, 대학원
graduation : n, 졸업(식), 눈금, 등급(매기기)
graduator : n, 도수(눈금)를 매기는 사람
gradus : n, (라틴시의)운율 사전, 연습곡집
Graeae : n, 그라이아이(the Gorgons를 지키는 3자매;세 사람이 눈 하나와 이 하나 밖에 없음
Graecism : n, =GRECISM
Graeco- : x, (연결형)=GRECO-
Graeize : v, =GRECIZE
Graf : n, 독일, 오스트리아, 스웨덴의)백작
graffiti : n, GRAFFITO의 복수
graffiti art : x, (보도, 벽, 공중 변소 등에 하는 낙서 예술
graffito : n, (벽, 기둥에 긁어 그린)그림(글), 낙서
graft : n, vt, vi, 접목(하다), 눈접(붙이다), 식피(식육(하다)), 독직(하다)
graftage : n, 접목
grafter : n, 수회자
grafting : n, 접목법
graham : a, 정맥하지 않은, 헌맥 가루로 만든
grail : n, 잔, 성배(예수가 최후의 만찬 때 쓴 잔, Arthur왕의 원탁기사들이 이것을 찾아 다녔음)
grain : n, 낟알, 곡물, 곡식, 곡초, 미량, 그레인(형량단위=0, 0648g), 나뭇결, 돌결, (가죽의 털을 뽑은)껄걸한 면, (나뭇결에 비유한)특성, 성미, 성질
grain : vt, (낟)알로 만들다, 나뭇결 모양으로하다
grain alcohol : n, 에틴알콜, 주정
grain belt : x, 곡창 지대(미국에서는 Middle West의 대농업 지역을 가리킴)
grained : a, 나뭇결(돌결) 무늬로 칠하는 사람
grain elevator : n, 곡물 창고
grainer : n, 나뭇결(돌결)이 있는;나뭇결(돌결)무늬로 칠한;거죽이 도톨도톨한;털을 없앤
grainfield : 곡식밭, 
graining : n, 결무늬로 칠하기(나무결, 돌결 비슷하게)종이 면을 도톨도톨하게 하기
grain leather : x, 털 쪽을 겉으로 하여 다듬은 가죽
grains : n, (보통 단수 취급)작살
grainsick : n, 혹위, 확장
grain side : x, (짐승 가죽의)털을 있는 쪽
grain sorghum : x, 수수(낟알을 씀)
grainy : a, 낟알모양의;낟알이 많은;나뭇결 같은
gram : n, 그램
grama : n, 미국 서부 및 서남부에 많은 목초
gramarye : n, 마술, 주술
gram atom : x, 그램 원자
gramatomic weight : x, =GRAM ATOM
gram calotie : x, 그램 칼로리
gramcentimeter :  ㅜ, 그램센티미터(일의 중력 단위)
gram equivalent : x, 그램다량
gramercy : int, 정말 고마워!;야단났구나!
gramicidin : n, ) 그라미시딘(항생물질의 하나
graminaceous : a, 풀의;목초가 많은;벼과의
graminivorous :  ㅁ, 풀을 먹는, 초식성
gramma : n, =GRAMA
grammalog : n, 단일 기호로 나타내는 말
grammar : n, 문법, 문법책, 문전, 초보, 원리 bad~ 잘못된 어법, comparattive~ 비교 문법
grammarian : n, 문법가, 문법 교사
grammarless : a, 문법이 없는;문법을 모르는, 배우지 못한
grammar school : n, 초급중학, 대학진학 예비과정으로 public school에 준하는 중등학교, 고전 문법 학교
grammatcal : a, 문법(상)의, 문법적인
grammatcal chang : x, 문법적 변화;베르너의 법칙
grammatcal gendeg : x, 문법상의 성
grammaticality : n, 문법성
grammatical meaning : x, 문법에 맞추다;문법상의 문제를 논하다.
grammaticism : n, 문법적 항목, 문법상의 원칙
grammaticize : vt, vi, 문법에 맞추다;문법상의 문제를 논하다
gramme : n, =GRAM
grammer : n, 체중이, , , 그램인 사람(주로 아기)
grammolecular : a, 그램 분자의
grammolecular weight : x, GRAM MOLECULE
grammolecule : n, 그램 분자, 몰(mol)
Grammy : n, (미)그래미상(레코드대상)
Gramnegative : a, 그램 음성의(세균)
gramophone : n, (영)축음기, 유성기
Grampian : ㅜ, 그램피언(1975년 신설된 스코틀랜드 동부의 주;주도 Aberdeen)
Grampositive : a, 그램 양성의 (세균)
grampus : n, 범고래, 돌고래과의 일종, 코고는 사람, 숨결이 거친 사람
Grams method : x, 그램 염색법(염색하여 세균을 양성과 음성으로 분류 식별하는 법
gran : n, 할머니
Granada :  ㅜ, 그라나다, 스페인 남부의 주, 그 주도
granadero : n, (멕시코의) 데모 진압 기동대
granadilla : n, 시계풀;그 열매
granary : n, 곡창(지대)
Gran Chaco : n, 그란차코(아르헨티나, 볼리비아, 파라과이 3국에 걸친 아열대 대평원)
grand : a, 웅대(장려)한, 장엄한, 위대(훌륭)한, 거룩한, 풍채가 당당한, 거만한, 중대한, 큰, 주되는, 전부의, 굉장한, 멋진
grandad : n, =GRANDDAD
grandam : n, 조모;할머니
grandaunt : n, 종조모, 대고모
Grand Banks : x, 그랜드뱅크(Newfoundland남동부 근해의 얕은 바다로 세계 4대 어장의 하나
Grand Canal : x, 대운하(Venice 주요 수로, 중곡 천진에서 항주에 이르는 세계 최장의 수로)
Grand Canyon : n, 애리조나주 북부의 대협곡
Grand Canyon State : x, 미국 Arizoa주의 속칭
grandchild : n, 손자, 손녀
grand cross : x, 대십자상
granddad : n, 할아버지
granddaughter : n, 손녀
grandducal : a, 대공(국)의, 제정 러시아 황자의
grand duchess : x, 대공비(대공의 처(미망인))
grand Duchy : n, 대공국
grand Duke : n, 대공, (제정 러시아의)황태자
grande dame : x, 귀부인
grandee : n, 대공(스페인, 포르투갈의 최고 귀족), 귀인, 고관
grandetoilette : n, 정장
grandeur : n, 웅대, 장엄, 화려, 성대, 장관, 위대, 고귀
grandfather : n, 조부, 조상
grandfather(s)clock : n, 큰 괘종시계
grand finale : n, 대단원
grand finish : x, 대접변(백열전)의 결승
grandiflora : x, 꽃 송이가 큰 장미
grandiloquence : n, 호언 장담
grandiloquent : a, 과장된, 호언장담하는
grand inquest : =GRAND JURY
grandiose : a, 장대(웅대)한, 굉장한, 어마어마한
grandiosity : n, 웅장함, 당당함, 과장, 떠벌림
grand juror : x, 대배심원
grand jury : x, 대배심
Grand Lama : x, =DALAI LAMA
grandlarceny : n, 중절도(죄)
Grand Lodge : x, FREEMASON등 비밀 결사의 총본부
grandly : ad, 웅장하게, 웅대하게, 화려하게, 호기있게, 당당하게, 오만하게, 으쓱거리며, 성대히, 장중하게, 숭고하게
grandma : n, 할머니
grand mal : n, (간질병의)대발작
grand march : x,  (무도회 개회때 전원이 벌이은)원형 대행진
Grand Master : x, 기사 단장;Freemason등의 단장
Grand Monarch : x, 대왕(루이 14세의 별명)
grand monde : n, 상류 사회, 사교계
grandmother : n, vt, 조모, 어하다
grandmother('s) clock : 
grandmotherly : a, 할머니다운, 친절한, 지나치게 친절한
Grand National : x, (영국 Liverpool에서 해마다 3월에 열리는)대장애물 경마
grandnephew : n, 조카(딸)의 아들, 형제 자매의 손자, 증손
grandness : n, 웅장, 장려함, 장대, 웅대, 호기, 오만, 위대, 당당함, 위대한 업적, 공적
grandniece : n, 조카(딸의)딸, 형제 자매의 손녀, 증손녀
Grand Old Man : x, W, E, Gladstone, Winston Churchill의 별명, 장로, 중진
Grand Old Party : ㅌ, 미국 공화당의 속칭(G, O, P)
grandopera : n, 대가극(회화의 부분이 모두 가곡으로 꾸며진)
grandpa : n, 할아버지
grandparent : n, 조부(모)
grand piano : n, 그랜드 피아노
grandplan : x, 대계획, 웅장한 전략
grand play : x, 기교를 부려 박수 갈채를 노리는 연기, 연극적인 제스처
grand prix : n, 그랑프리, 대상, (파리의)대경마, 장거리 자동차 경주
grand prize : x, 대상, 그랑프리
grand rounds : x, 병례검토회(입원중인 특정 환자에 대한)
grand scale : a, 대형의, 대규모의, 다대한, 정력적인
grand seigneur : n, 귀족
grandsire : n, 조부
grand slam : x, (트럼프 등의)압승, 만루 홈런, (한 시즌의 각종 큰 경기에서)우스하기, 완전성공
grand slammer : n, 만루 홈런
grandson : n, 손자
grand staircase : n, (현관의)큰 계단
grandstand : n, (경마장, 경기장 따위의)정면 관람석
grandstrategy : x, (소련의)세계 제패 전략(서방측에서 본 표션)
grandstyle : x, 장엄체(Milton등의 시)
grand total : n, 총계
grand tour : n, 대여행(영국 청년 귀족들이 하던 유력 수학 여행)
grand touring car : x, =GRAN TURISMO
granduncle : n, 종조부(조부모의 형제)
grand vizier : n, (회교 국가의)수상
grange : n, (건물과)농장, 농장의 집(헛간 등을 포함), 호농의 저택, (소비자와 직결하는) 농가 공제 조합(의 지부)
granger : n, 농민, 농가 공제 조합(지부)원
grangerism : n, Grange주의(방식);다른 책 그림을 오려 책에 따붙이기
grangerize : vt, (책에)다른 책에서 오려낸 그림을 따 붙이다, (책에서)그림등을 오려내다
grani- : x, (연결형)(낟알, 씨)의 뜻;granivorous
graniferous : a, 낟알(낟알 모양의 열매)을 맺는
granite : n, 쑥돌, 화강암, bite on ~ 헛수고를 하다
Granite City : x, 스코틀랜드 Averdeen시의 속칭
Granite State : x, 미국 New Hampshire주의 속칭
graniteware : n, 화강암 무늬의 도기(에나멜 철기)
granitic : a, 화강암의, 화강암질의
granitoid : a, 화강암 모양(구조)의
granivore : a, 곡식을 먹는 동물(특히 조류)
granivorous : a, 곡식을 먹는
grannularity : n, 낟알 모양, 입도
granny, -nie : n, a, 할머니, 노파, 수선쟁이, 공연히 남의 걱정을 하는 사람, 선매듭(옷고름 매듭 같이 끈의 옭맨 두 끝이 끈의 원 방향ㅇ과 자를 이루는 매듭), 할머니의;할머니 옷 스타일의, 기장이 길고 낙낙한
granny annex(flat) : x, (본채에 붙은)노인 전용의 딴채
granny dress : x, 그래니 드레스(목에서 발목까지 닿는 기장이 길고 낙낙한 젊은 여성복)
granny glasses : x, 할머니 안경(젊은이들이 쓰는 둥근 금테 안경)
grano- : x, (연결형)(화강암(질)의;알맹이 모양의)뜻
granola : n, 그라놀라(귀리에 건포도나 붉은 설탕을 섞은 건강 식품)
granolith : n, 인조 화강 콘크리트
granolithic : a, 인조 화강 콘크리트의
grant : vt, 승낙(청허)하다, 허가하다, 수여하다, 양도하다, 하사하다, 내리다, 인정하다, ...라고 하다
grant : n, 허가, 인가, 양도, 하사, 교부, 교부금
Grant : n, Ulysses Simpsom(1822~1885)미국의 군인, 정치가(남북전쟁의 북군 총사령관, 제 18대 대통령(1869~1877)
grantable : a, 허가의
grant aid : x, 무상 원조
grantee : n, 피수여자, 양수인
granter : n, 허용하는 사람;수여자;양도자
grantinaid : n, 보조금, 교부금
grantor : n, 양도인, 수여자, 교부자
grantsman : n, (대학 교수등으로서 재단 등에서)(연구)보조금을 타내는 데 능숙한 사람
granturismo : n, 그란투리스모, GT카(장거리, 고속 주행용의 고성능 자동차)
granular : a, 낟알의, 낟알 모양의;과립 모양의
granular snow : x, 싸락눈
granulate : vt, vi, 낟알 모양으로 만들다(되다), (표면 따위)껄껄하게 되다(만들다), (상처에)새살이 나오다
granulated : a, 낟알로된, 낟알 모양의, 낟알이 나서 도톨도톨한, 거죽이 껄껄한, 새살을 이룬, 과립 모양의
granulated sugar : x, 그래뉴당
granulation : n, 낟알이 되기, 낟알 모양을 이루기, 껄껄해지기, 낟알이 있는 면;새살(이 나기), 과립
granulative : a, 알맹이 모양의, (표면이) 껄끄러운, 육아(형성의)
granulator, -later : n, 낟알로 만드는 기계, 조립기
granule : n, 미립, 고운알
granulocyte : n, 과립성 백혈구, 과립구
granuloma : n, 육아종
granulose : a, =GRANULAR
grape : n, 포도(나무, 알)
grape brandy : x, 포도(주)로 만든 브랜디
grape cure : x, (주로 결핵의)포도 요법(포도를 먹어 낫게 하려는 낡은 요법)
grapefruit : n, 그레이프프루츠, 그 나무
grapefruit league : x, 메이저 리그 개막전의 연습 시합
grape hyacinth : x, 무스카리(나리과)
grape juice : n, 포도 주스
grape rot : x, (포도의)두창병
grapery : n, 포도원
grapeshot : n, 포도탄
grapestone : n, 포도씨
grape sugar : n, 포도당
grapevine : n, 포도 덩굴(나무), 비밀등을 전달하는 특수 경로, 정보망, 데마, 소문
graph : n, vt, 도표, 그래프, 도식, 그립, 그래프(도표, 도식)로 나타내다, 도시하다
graph : n, vt, 젤라틴판(으로 인쇄하다)
graph : x, (연결형)-을 쓰는(그리는, 기록하는)기구의 뜻, -을 쓴것(그림)의 뜻
grapheme : n, 서기소(알파벳 문자)
graphemics : n, 서기소론
grapher : x, (연결형)(쓰는 사람, 그리는 사람, 기록자)의 뜻
graphic : a, 필사의, 문자(그림)의, 도표(그래프)로 나타낸, 생생한
graphicacy : n, 그래픽 아트의 재능(기술), 도식(선화)을 그리는 기능
graphic arts : x, 그래프 아트(일정한 평면에 문자, 그림등을 표시, 장식, 인쇄하는 기술이나 예술의 총칭)
graphicate : a, 그래픽 아트의 재능(기술)이 있는
graphic design : x, 그래픽 아트를 응용하는 상업 디자인
graphic formula : n, 도식, 구조식
graphics : n, 제도법, 도학;도식(그래프)산법;그래픽스(컴퓨터의 출력을 브라운관에 표시하여 다시 그것을 light pen등으로 조작하는기술)=GRAPHIC ARTS
graphite : n, 석묵, 흑연
graphite fiber : x, 그래파이트 파이버(섬유)
graphitic : a, 석묵의, 흑연의;석묵질(성)의
graphitic reactor : x, 흑연형 원자로(carbon reactor라고도 함)
grapho- : x, (연결형)(글자쓰기, 그리기)의 뜻
graphologist : n, 필적학자
graphology : n, 필적학, 필적 관상법
graphomania : n, 서광(글씨를 쓰고 싶어하는 병)
graphomaniac : n, (쓰지 않고 못 견디는)서광 환자
graphonomy : n, 문자학, 서자학
graphoscope : n, 그래포스코프(화면에 표시된 데이터를 light pen등으로 수정할 수 있는 수상기)
graphotherapy : n, 필적진단(법);필적 요법(필적을 바꾸게 하여 치료하는 심리 요법)
graphotype : n, 백악 볼록
graph paper : n, 방안지, 모눈종이, 그래프 용지
graphy : x, 구별적 발음 부호 대용문자, 철자의 변형
graphy : x, (연결형)-화풍, 화법, 서풍, 서법, 기록법의 뜻, -지, -기의 뜻
grapnel : n, 네 갈고리 닻;쇠갈퀴, 쇠갈고리에 줄을 단 연장
grappa : n, 그랍파(포도 짜는 기계 속의 찌꺼기로 증류한 술)
grapping : n, 걸어 잡는 도구, 갈고랑 쇠, 드잡이
grapple : vt, 꽉 쥐다(잡다), 붙잡다
grapple : vi, (갈고리로)고정하다, 맞붙어 싸우다, 접전하다
grapple : n, 드잡이, 격투
grapple graound : x, 투묘지, 정박지
grappler : n, 격투자;레슬링 선수;손
grappling : n, 갈퀴를 쓰기;맞잡고 싸우기, 드잡이, 격투, 접전;=GRAPPLING IRON
grappling iron(hook) : x, (적선 등을 걸어 잡아당기는)쇠갈고리
grapy : a, 포도(모양)의, 포도 비슷한, (말이)포도창에 걸린
GRAS : vt, Generally Recognized as Safe 미국 식품 의약국의 합격증
graser : n, 감마선 레이저
grasp : vt, 잡다, 쥐다, 이해하다, 잡으려 하다, 달려들다
grasp : n, 쥠, 지배(력), 이해(력), 손잡이, 자루
graspable : a, 
grasping : a, 남욕스러운, 잡는, 쥐는
grass : n, 풀, 목초, 잔디, 목초지, 포아풀과의 풀, 풀 돋는 계절, 봄
grass : n, 풀로 덫다, 목초를 먹이다, 풀(지면) 위에 펴다, 때려 눕히다
grassblade : n, 풀잎
grass carp : x, 초어(잉어과)
grass character : x, (한자의)초서
grass cloth : x, 모시, 라미천
grass court : x, 잔디를 심은 테니스 코트
grass cutter : x, 풀베는 사람, 풀메는 인부;풀(잔디)베는 기계;강한 땅볼
grasseater : n, (뇌물을 요구하지는 않으나 주면 받는)수회(부패)경관
grass green : x, (싱싱한)풀빛, 연두색
grassgreen : a, 풀빛의, 연두색의
grassgrown : a, 풀이 나 있는, 풀로 덮인
grass hand : n, (한자의)초서, 임시 식자공
grasshopper : n, 메뚜기, 촹충(따위), (비무장의)소형 정찰기
grassiness : n, 풀이 무성함
grassland : n, 목초지
grassless : a, 풀이 없는
grasslike : a, 
grass mask : x, 마리화나 흡연용 마스크
grassplot : n, 잔디
grassroots : a, 풀 뿌리, 기초, 농목 지대(의), 농민의, 민중의 get down to the ~ 문제의 근본에 대해 논급하다
grass shears : x, 풀 깎는 큰 가위
grass skiing : x, 풀밭(잔디)스키
grass snake : x, (영국에 흔한)독 없는 뱀
grass style : x, 초서;묵화법
Grasstex : n, 그래스텍스(테니스 코트 표면재의 일종;상표명)
grass tree : x, 백합과의 상록 관목(오스트레일리아산)
grass widow : n, 이혼한 여자, 별거 중인 아내
grass widower : n, 이혼한 남자, 별거 중인 남편
grasswork : n, 갱 밖의 작업
grassy : a, 풀이 무성한, 풀 같은, 풀의
grassygreen : a, 연초록색의
grate : n, (난로의)쇠살판, 화상
grate : vt, (치즈 따위를 강판으로)갈다, 으깨어 빻다, 삐걱거리게 하다
grate : vt, 서로 갈리다, 삐걱거리다, 불쾌감을 주다
Grated : a, 일반용의
grateful : a, 감사히 여기는, 고마운, 기쁜, 즐거운
gratefully : ad, 감사하여, 기꺼이
gratefulness : n, 고맙게 여김, 감사(한 마음)
grater : n, 문지르는(가는)사람, 강판
graticule : n, (현미경 등의 계수판 위의)계수선, (방안지의)격자선, (지도, 해도의)경위선망
gratification : n, 만족(감), 기쁨, 만족 시키는 것, 보수
gratified : a, 만족한, 기뻐하는
gratifing : a, 만족 시키는, 기쁜
gratify : vt, 만족 시키다, 기쁘게 하다
gratin : n, 그라탱(빵가루를 입혀서 굽는 요리)
Grating : x, 모든 연령층에 맞는 영화로 판정된 것
grating : n, 격자(문)
grating : a, 삐걱거리는, 서로 갈리는, 귀에 거슬리는
gratis : ad, 무료로(의)
gratitude : n, 감사(하는 마음)
gratuitous : a, 무료의, 공짜의, 필요 없는, 이유(까닭)없는, 무사의
gratuity : n, 사례금, 팁(tip), (제대하는 군인에의)하사금
gratulant : a, 기쁨(만족)을 나타내는
gratulate : a, vt, vi, -을 축하하다, 기꺼이 맞이하다, 기쁨을 말하다
gratulation : n, =CONGRATULATION
gratulatory : a, 축하의, 축사하는
graupel : n, 싸락눈
gravamen : n, 불평, 소송의 요점
grave : n, 무덤, beyond the ~ 저승에서, make (a person) turn in his ~ (아무로 하여금) 죽어서도 눈을 못 감게 하다
grave : a, 중대한, 중요한, 위험이 따르고 있는, 심각한, 심상치 않은, 근엄한, 의젓한, 위엄있는, 엄숙한, 근심스러운, 수심을 띤, (빛깔이)수수한, 침침한, 억음의
grave : vt, 조각하다, 새기다, (마음에)새기다, 명심하다
grave : vt, 부착물을 태워버리거나 긁어내고 타르 등을 바르다
grave : a, ad, 느린, 느리게;장엄한, 장엄하게
grave clothes : x, 시체에 입히는 옷, 수의
gravedigger : n, 무덤 파는 일꾼
grave goods : n, 분묘의 부장품
gravel : n, vt, 자갈(을 깔다), 결사, 난처하게 하다, 괴롭히다
gravelblind : a, 반소경의
graveless : a, 무덤이 없는;매장할 수 없는
gravelly : a, 자갈이 많은
gravel pit : n, 자갈 채취장
gravelstone : n, 자갈, 조약돌, 신사
gravel walk : n, 자갈길
graven : x, gave의 과거 분사
graven : a, 조각된, 감명 깊은
graven image : n, 조상, 우상
gravenstein : n, 그라벤슈타인종의 사과(독일종)
graver : n, 조각사, (동판용)조각칼
grave robber : x, 묘지 도굴자
Graves : n, (프랑스 보르도 지방의)그라부산, (백)포도주
Graves' disease : x, 그레이브즈(바제도)병
gravestone : n, 묘석
graveyard : n, 묘지
Graveyard school : x, 묘지파(18세기 중엽의 영국 서정시인들의 한파)
graveyard shift : x, (3교대제에서)밥 12시 부터 오전 8시까지의 근무; 그 근로자들
graveyard watch : x, 자정부터 오전 4시(8시)까지의 당직, =GRAVEYARD SHIFT
gravid : a, 임신하고(있는)
gravidity : n, 임신
gravimeter : n, 중력계
gravimetric, -rical : a, 중량 측정의, 중량에 의해 측정된
gravimetric analsis : x, 중량 분석
gravimetry : n, 중량(밀도)측정
graving dock : x, (배 밑바닥 청소, 수리용)건독
graving tool : x, 조각용 도구;동판 조각칼
gravisphere : n, 인력권
gravitate : vt, 인력에 끌리다, 침강(하강)하다, 끌리다
gravitate : n, 인력(작용), 중력
gravitation : n, 인력(작용), 중력
gravitational : a, 중력의, 인력(작용)의
gravitational astronomy : x, 천체 역학
gravitational collapse : x, 중력 붕괴(천체가 중력 작용으로 수축해 가는 현상)
gravitational wave : x, 중력파
gravitative : a, 중력의, 작용을 받기 쉬운
graviton : n, 그래비톤, 중력 양자
gravity : n, 중력, 지구 인력, 중량, 진심, 엄숙, 중대, 저음
gravity battery : x, 중력 전지
gravity dam : x, 중력댐
gravity device : x, 거꾸로 매달리는 건강 촉진기
gravity fault : x, 중력 단층
gravity gradient : x, 중력 경도법(인공 위성의 지구에 대한 기울기를 지구 중력으로 일정하게 하는 방법)
gravity meter : x, =GRAVIMETER
gravity wave : x, (유체의)중력파, =GRAVITATIONAL WAVE
gravure : x, =PHOTOGRAVURE
gravy : n, 고깃국물, 부정 이득
gravy boat : x, (배모양의)그레이브 그릇
gravy train : n, 놀고 먹을 수 있는 지위(수입)
gray : n, 회색(의), 박명, 황혼, (얼굴이)창백한, 백발의, 음침한, 늙은, 원숙한
Gray : n, 그레이(영국의 시인)
Gray's Inn : x, 그레이즈인 법학원
gray area : x, (양극 사이의)중간 영역, 이도저도 아닌(애매한)부분(상황), =GREY AREA
grayback : x, (남북 전쟁 당시의)남군 군인, GRAY WHALE, 도요의 일종, 이
graybeard : n, 반백의 수염이 잇는 사람, 노인;노련한 사람, 현인
graybeard : n, 노인
gray cells : x, 뇌, 뇌수;두뇌, 지능, 지성
graycollar : a, 수리, 보수 작업에 종사하는
gray crow : x, =GRAYBACK
gray eminence : n, 흑막(적인 인물)
grayfish : n, 돔발상어(시장 용어)
Gray Friar : x, 프란체스코회 수도사
gray goose : x, =GREYLAG
grayhaired : a, 백발의, 노년의
gray hairs : n, 노년
grayhead : n, 백발의 노인;말향 고래의 늙은 수컷
grayheaded : a, 백발의, 백발이 섞인;늙은, 노련한, 오래된
grayhound : x, =GREYHOUND
graying : n, 노인화;고령화;노화
grayish : a, 회색빛이 나는
graylag : n, 기러기의 일종
Gray Line : x, 미국의 대규모 관광버스 회사
grayling : n, 살기, 뱀눈나비과의 나비(굴뚝나비 따위)
grayly : ad, 회색(쥐색)으로;어스레하게, 음울하게
graymail : n, (소추중의 피의자에 의한)정부 기밀의 폭로를 비치는 협박
gray mare : x, 내주장하는 아내, 내주장하는 여자
gray market : n, 회색시장(구하기 힘든 물품을 비싸게 파는 합법적 암시장)
gray matter : n, (뇌의)회백질, 지력
gray mullet : x, 숭어
grayness : n, 어스레함;회색, 백발이 섞임
grayout : n, 일시적 시력 상실(대뇌 혈류 감소로 부분적 의식 장애, 시력 장애)
Gray Panther : x, 그레이팬서(노인의 권리 확대를 꾀하는 운동 단체의 일원)
gray power : x, 노인 파워
gray sister : x, 프란체스코회 수녀
gray squirrel : x, 회색 청서(북미 원산)
graystone : n, 회색 화산암
Gray Thomas : x, (1716~1771)영국의 시인
graywacke : n, 경사암
graywacker : n, 중수도용수(정화 처리로 재잉용되는 부엌, 욕실 등으로부터의 배수)
gray whale : x, 러바스트고래(태평샹산)
gray wolf : x, =TIMBER WOLF
gray zone : x, 이도 저도 아닌(상태), 애매한 (범위), 회색 지대(의)(어느 초강대국의 세력하에 있는 지 애매한 지역)
graze : vi, n, 풀을 먹이다, 목축, 목초
graze : vi, n, 스치다, 스치기, (지나가면서)약간 닿다(닿음), 스쳐 벗기다(벗어지다), 찰과상
grazer : n, 방목 가축;방목자
grazery : n, 목축업
grazier : n, 목축업자, 목축업
grazing : n, 방목, 목축, 목장, 목초지
grazing land : x, 방목지
grazioso : a, ad, 우아한(하게)
GRB : x, gammaray burst감마선 폭발
GRE : x, graduate record examination미국 대학원 진학 희망자를 대상으로 한 시험
grease : n, (짐승의)기름, 그리스, 뇌물
grease : vt, ...에 기름을 바르다(으로 더럽히다), ...에 증회하다
greaseback : n, 국경을 넘어 미국에 밀입국하는 멕시코 사람
greaseball : n, 라틴계 외국인;멕시코 사람
greasebox : n, (차축의)윤활유(그리스)통
greasebush : n, =GREASEWOOD
grease cup : x, 그리스컵(기계에 붙어 있는)
grease gun : x, 윤활유 주입기, 그리스 치개
grease monkey : x, (특히 자동차, 비행기의)수리공, 정비공
grease paint : n, 도란(배우의 메이크업용), 무대화장
grease payment : x, 뇌물 주기, 중회
greaseproof : a, 기름이 안배는, 납지
greaser : n, 기름치는 사람(기구);(기선의)기관사, (자동차)정비공, (자동차, 오토바이등)폭주주의 젊은이;알랑알랑하는 사람, 멕시코 사람, 프페인게 미국 사람
grease trap : x, 하수도의 기름 막는 장치
greasewood : n, 명아주과 관목(미국 서부 알칼리성 지대산;차조기과의 다년초)
greasily : ad, 기름지게, 기름기 있게;미끈미끈하게;알랑알랑하여
greasiness : n, 
greasy : a, 기름을 바른(으로 더럽힌), 기름기 많은, 미끈미끈한, 진창의, 알랑거리는
greasy grind : x, 어려운(하기 싫은)일(공부);열심히 일(공부)하는 사람
greasy pole : x, 기름 바른 장대(기어 오르거나 걷는 놀이 기구)
greasy spoon : n, 싸구려 식당, 변두리의 스넥
great : a, 큰, 훌륭한, 위대한, 대단한, 주된, 고귀한, 마음이 넓은, 근사한, 즐거운, 잘 하는, 큼직한, 어마어마한, 임신한
great ape : x, 대형 유인원(고릴라, 침팬지 등)
Great Assize : x, 최후의 심판
great auk : x, 큰바다오리(19세기에 절멸)
greataunt : n, =GRANDAUNT
Great Awakening : x, (1734년경 미국에서 일어나)신앙 부흥 운동
Great Barrier Ree : n, 오스트레일리아 북동부의 Queensland 해안과 병행하는 큰 산호초
Great Basin : x, 미국 서부의 Nevade, Utah, California, Oregon, Idaho주에 걸친 큰 분지
Great Bear : n, 큰 곰자리, 북두칠성
Great Beyond : x, 사후 세계, 내세
Great Britain : n, 대브리튼(England, Scotland, Wales의 총칭)
great calorie : x, 물 1kg을 1℃높이는데 필요한 열량(식품의 영양가를 표시하는 데도 씀)
great chair : x, 안락 의자
Great Charter : x, 대헌장, 마그나 카르타
great circle : n, (구면의)대권
greatcircle course(route) : x, 대권 코스(지구상의 2점간의 최단 거리)
greatcircle sailing : x, 대권 항법
greatcoat : n, 무거운 외투
great council : x, (노르만 왕조 시대의 왕정청의)대회의, 시의회
Great Dane : n, 덴마크종의 큰 개
Great Day : x, 최후의 심판날
Great Depression : x, (1929년 미국에서 비롯한)대공황
Great Divide : n, 로키 산맥
Great Dog : n, 큰개자리
Greaten : vt, vi, 크게 하다(되다), 위대하게 하다(되다), 증대하다, 확대하다(되다)
Greater : n, 대(대도시를 그 교외를 포함시키어 부를 때)
Greater Britain : n, 영연방과 그 전 속령을 포함함
Greater London : 대런던(1965년 이후, 구 London에 구 Middlesex주 및 구 Essex, Kent, Hertfordshire, Surrey 각주의 일부를 병합시킨 행정 지구로서 현재의 London과 같은 뜻)
Greater Manchester : n, 영국 서부의 주(1974년)
Greater New York : n, 대뉴욕(종래의 New York에다가 Bronx, Brooklyn, Queens, Richmond를 합친 것)
greatest common divisor(divisor) : n, 최대 공약수
great fee : x, 국왕에게서 직접 받은 영지
Great Fire : x, (1666년의)런던 대화재
great go : x, (Cambridge대학의)B, A학위를 따기 위한 최종 시험
greatgrandchild : n, 증손(증조부, 증조모)
greatgranddaughter : n, 증손녀
greatgrandfather : n, 증조부
greatgrandmother : n, 증조모
greatgrandparent : n, 증조모(부)
greatgrandson : n, 증손자
great gross : x, 대그로스.12그로스
great gun : x, 거물, 유력자
great guns : x, (바람등이)맹렬하게, 심하게, 윙윙;(사람이)굉장한 속도로, 열심히;이크~, 야단났다, 아뿔싸~
greathearted : a, 고결한, 관대한, 용감한
greathorned owl : x, 수리부엉이(아메리카산)
Great Inquest : x, 최후의 심판
Great Lakes : n, 5대호
great laurel : x, 북미 동부 원산의 활엽의 석남
Great Leap Forward : x, (중공의)대약진 정책(모택동에 의한 1958년-61년의 경제 공업화 정책)
greatly : ad, (보통 동사, 과거를 강조하여)크게, 심히, 매우;훨씬, 위대하게;숭고(고결)하게, 관대하게
Great Mogul : (인도의)무갈 제국의 황제;거물
greatnephew : n, =GRANDNEPHEW
greatness : n, 큼, 거대함, 다대함, 광대함;대량, 위대, 웅대, 중대, 저명, 탁월, 고귀;활달
greatniece : n, =GRANDNIECE
Great Plains : n, (로키산맥 동쪽의)대평원
Great Power : n, 강국, 열강, 대국
greatpowerism : n, 강대국주의
greatpower politics : x, 강대국간의 외교
great primer : x, 18포인트 활자
Great Proletarian Cultural Revolution : x, (중공의)프롤레타리아 문화 대혁명
Great Rebellion : x, 대반란, 청교도 혁명
Great Russian : x, 대러시아인(소련의 유럽북부, 중부 지방에 사는 주요 러시아 민족);대러시아어(유럽 러시아의 중부, 북동부에서 사용)
Great Salt Lake : n, 미국 Utah 주에 있는 얕은 함수호
great seal : n, 국새
Great Smoky Mountains, Great Smokies : n, 그레이트 스모키 산맥
Great Society : x, 위대한 사회
Great Spirit : x, 아메리칸 인디언의 주신
great tit : x, 박새
great toe : x, 엄지발가락
greatuncle : n, =GRANDUNCLE
Great Wall of China : n, (중국의)만리장성
Great War : n, (제1차)세계 대전
great wheel : x, 시계의 제1톱니바퀴
Great White Father(Chief) : x, (아메리칸 인디언이 말하는)미국 대통령;대권력자
Great White Way : x, 불야성(New York의 극장가 Broadway의 속칭)
greave : n, (갑옷의)정강이 받이
greaved : a, 정강이받이를 댄
greaves : n, 굳기름 찌끼(개, 물고기의 먹이)
grebe : n, 농병아리
Grecian : a, (건축, 얼굴 모습 따위가)그리스식의, 그리스 사람(학자)
Grecian bend : x, (Milo의 비너스를 본떠서 1870년대에 여성들간에 유행한)상체를 약간 숙이고 서는(걷는)자세
Grecian gift : x, =GREEK GIFT
Grecian knot : x, 옛 그리스식을 모방한 머리 스타일
Grecian nose : x, 그리스 코(콧등의 선이 이마로부터 일직선)
Grecian slippers : x, 그리션 슬리퍼(운두가 낮고 부드러운)
Grecism, Graecism : n, 그리스식(정신), 그리스 어법
Grecize, Graecize : vt, vi, 그리스풍(식)으로 하다(되다);그리스 어법(습관)등을 좇다
Greco-, Graeco- : x, (연결형)(그리스(의))의 뜻
GrecoRoman : a, 그리스와 로마의, (레슬링)그레코로만형
GrecoRoman wrestling : x, 그레코로만형 레슬링
Greece : n, 그리스그리스, 헬라, 희랍
greed : n, 탐욕, 욕심
greedily : ad, 욕심내어, 탐욕을 부려;게걸스럽게
greediness : n, 탐욕
greedy : a, 탐욕스러운, 열망하는, 걸신들린, 게걸스러운
greedygree : n, =GRISGRIS
greedyguts : n, 대식가
Greek : a, 그시스의, 그리스 사람(어)의, 사기꾼 It is ~ to me 도무지 알 수 없다
Greek alphabet : x, 그리스어 알파벳, 그리스 문자
Greek Catholic : x, 그리스 정교신자(로마교회의 교리를 믿으면서 그리스 정교회의 의식, 형식을 따르는 그리스 사람)
Greek Church : x, =GREEK ORTHODOX CHURCH
Greek cross : x, 그리스 십자가
Greek Fathers : x, 그리스어로 저술을 한 초대 그리스교의 교부들
Greek fire : x, 그리스 화약(적함의 화공등에 쓰였음)
Greek fret : x, 뇌문
Greek gift : x, 사람을 해치기 위한 선물
Greekless : a, 그리스어를 모르는 
Greekletter fraternity(sorority) : x, 그리스 문자 클럽(그리스 문자로 이름을 붙인 학생 사교 단체)
Greek Orthodox Church : x, 그리스정교회
Greek Revival : x, 그리스 부흥(19세기 전반기의 건축양식;고대 그리스 디자인의 모방이 많음)
green : a, 초록색의, 안색이 나쁜, (샘, 공포 등으로)얼굴이 창백한, 푸른 풀로 덮인, (과일등이)익지 않은, 풋내기의, 숫된, 속기 쉬운, 신선한
green : n, 녹색, 녹색 안료, 공유의 풀밭, 초원, 녹색의 물건, 야채, 청춘, 젊음, 골프장
green : vi, vt, 녹색으로 하다(되다), 속이다
green(s)keeper : n, 골프장 관리인
greenass : a, 미숙한, 어린, 풋내기의, 신출내기의
greenback : n, (뒷면이 녹색인)미국 지폐
Greenback Party : x, 그린백당(통화의 팽창 정책을 주장하여 1874년에 농민층을 중심으로 결성된 정당)
green ban : x, GREENBELT에서의 건설 사업에 대한 취로 거부;자연(유적등)을 파괴하는 사업에의 취로 거부
greenbelt : n, (도시 주변의)녹지대
Green Beret : x, 특전 부대
greenblind : a, 녹색맹의
green blindness : x, 녹색 색맹
green book : x, 그린북(영국, 이탈리아 등의 정부 간행물, 공문서)
greenbrier : x, 청미래 덩굴
green card : x, (특히 멕시코인 등 외국인 노동자에게 발부하는 미국에의)입국 허가증, 국제 자동차 사고 상해 보험증
green carder : n, GREEN CARD의 소지자(특히 멕시코인)
green charge : x, 혼합이 불완전한 화약
green cheese : x, 생치즈;샐비어 잎으로 물들인 치즈;유장 치즈
green Christmas : x, 눈이 오지 않는 크리스마스
green cloth : x, 테이블보로 쓰는 녹색 천, 도박대, (영국 왕실의)가정국(지출을 관장)
green corn : n, 설 여문 옥수수(요리용)
green crop : x, 덜 여문 채 먹는 작물, 푸성귀, 야채
Green Cross Code : x, 국민 학생용 교통 안전 규칙
green currency : x, 녹섹 통화(EC 가맹국의 농산물 가격 보호를 위해 1969년에 창설)
green deck : x, 초원
green dragon : x, 천남성의 일종(북미산);암페타민(바르비투르)정(캡슐)
green drake : x, 하루살이
Greene : n, 그린(영국의 작가)
green earth : x, 녹사, 녹토(안료)
greener : n, (특히 외국인의)무경험 직공, 풋내기 직공
Green Erin : x, =GREEN ISLE
greenery : n, 푸른 잎, 푸른 나무
green eye : x, 질투의 눈
greeneyed : a, 초록빛 눈의, 질투에 불타는
green fat : x, 바다거북의 기름(진미)
green fee : x, 골프장 사용료
green feed(fodder) : x, (마소의)꼴
greenfield : a, 전원(미개발)지역의, 녹지대의(에 관한)
greenfinch : n, 방울새
green fingers : x, =GREEN THUMB
green fly : x, =APHIS
green food : x, 채소, 야채
greengage : n, 양자두의 일종
greengill : n, 녹색 아가미의 굴
green glass : x, (병만드는)녹색 유리
green goods : x, 위조 지폐;청과, 야채
green goose : x, (4개월 미만의)새끼거위
greengrocer(y) : n, 청과물상(점)
greenheart : n, 녹심목(남미산);그 재목(배, 교량용)
greenhorn : n, 풋내기
green hornet : x, (단시간에 해결해야 할)군사상의 난문제
greenhouse : n, 온실
greenhouse effect : x, (탄산가스에 의한 지구 대기의)온실 효과
greenie : n, 암페타민(각성제)
greening : n, 청사과;회춘, 재생;녹화, (연백 재배 채소에)해쬐기
greenish : a, 초록빛이 도는
Green Isle : n, 초록의 섬(아일랜드의 미칭)
greenkeeper : n, (골프)골프장 관리인
Green King : x, 녹색왕(강세 달러의 별명)
Greenland : n, 북미 동북쪽의 세계 최대의 섬(덴마크령)
Greenlander : n, 그린란드 사람
greenlet : n, =VIREO
green light : n, 청 신호, (정식)허가
greenlining : n, 특정 경계 지역 지정의 철회 운동, 차별화 철폐운동(차별하는 금융 기관으로부터 예금을 모두 꺼내는 방법 등)
green linnet : x, =GREENFINCH
green lobby : x, 환경 보호 단체(총칭);환경 보호 운동 진정단
green lung : x, (도시내의)나무가 있는 구역, 녹지, 공원
greenly : ad, 초록빛으로, 새롭게, 신선하게, 싱싱하게;원기있게, 미숙하게;어리석게
greenmail : n, 주식의 매점(주식을 매점한 후 주식값을 올려 다시 높은 값으로 되 파는 것);그 행위
green man : x, =JACK IN THE GREEN, 골포장 관리인
green manure : n, 녹비
green meat : x, 야채
green men : n, 우주인, 화성인
green mold : x, 푸른곰팡이, 누룩곰팡이;푸른 곰팡이병
green money : x, 지폐
green monkey : x, 사바나원숭이(녹회색의 긴 꼬리원숭이;서아프리카산)
green monkey disease : x, =MARBURG DISEASE
Green Mountains : n, 그린산맥
Green Mountain State : x, vermont 주의 속칭
greenness : n, 초록색;신선함;미숙, 풋내기임
greenness : n, 위황병
green onion : x, 골파(샐러드, 양념용)
Green Panther :  ㅌ, 전투적인(떠들썩한, 성가신)환경 보호 운동가
Green Paper : n, 녹서(정부의 심의용 시안 문서)
green paper : n, 양고추, 피망(조미료)
Green Party : x, 녹색당(원자력 발전 반대, 환경 보호등을 주장)
Greenpeace : n, 그린피스(핵실험, 포경 반대, 환경 보호를 주장하는 국제 단체)
green pepper : x, 양고추, 피망
green pound : x, 그린 파운드, 녹색 파운드
green power : x, 금력, 재력
green revolution : n, 품종 개량에 의한 식량 증산
greenroom : n, (극장의)배우 휴게실, talk ~ 내막 이야기를 한다
greensand : n, 녹사
greenshank : n, 청다리도요
greensick : a, 위황병에 걸린
green snake : x, 초록뱀(무독;북미산)
green soap : x, 녹색 비누(특히 피부병용)
greenstick fracture : x, 골절의 일종(뼈의 한쪽이 부러져 다른 쪽으로 구부러짐)
greenstone : n, 녹암;녹옥
green stuff : x, 돈, (달러)지폐
greenstuff : n, 푸성귀, 야채
greensward : n, 잔디
green table : x, 도박대;=COUNCIL BOARD
green tea : n, 녹차
green thumb : x, 원예의 재능
green time :  ㅌ, 청신호 시간대(일련의 신호가 모두 청색이 되는 시간)
green turtle : x, 바다 거북(주로 수프용)
green vitriol : x, 녹반
green wave : x, (서핑에서)단절된 데가 없는 긴파도
greenway : n, 그린웨이(큰 공원을 연결하는 보행자, 자전거 전용 도로;산책로)
greenweed : n, 금작화류(염료)
Greenwich : n, 그리니치(런던 남도부 교외, 원래 왕립 천문대가 있었으나 1948년 Hurstmonceux로 옮김)
Greenwich (Mean(Civil)time : n, 그리니치 표준시
Greenwich Village : x, 뉴욕에 있는 예술가, 작가가 많은 주택 지구
greenwood : n, (한여름의)푸른 숲, 녹림
greeny : a, 녹색을 띤
greenyard : n, 잔디밭, 공설 우리(임자 불명의 말등을 가둠)
greet : vt, 인사하다, 들어오다, (눈, 귀 따위에)들어오다, 보이다, 들리다
greeter : n, 인사, 환영
greeting : n, 인사, 환영(의 말), 인사말, 인사장
greeting card : n, 인사장, 축하카드
gregariness : n, 군거(사교)성
gregarious : a, 군거(집단)성의, 사교적인
gregarly : ad, 군거(군생)하여;집단적으로
Gregorian : a, n, 로마 교황, 그레고리안(그레고리오)성가
Gregorian calendar : x, 그레고리오력, 신력(로마 교황 Gregory XIII 제정(1582)
Gregorian chant : x, 그레고리오 성가
Gregorian telescope : x, 그레고리오식(반사)망원경
Gregory : n, 남자이름, 그레고리우스, 그레고리오(1세부터 16세까지의 역대 로마 교황의 한 사람)
gregory powder : x, 그레고리 완하제
greige : a, n, (방직기에서 꺼내어)아직 표백, 염색하지 않은(천), 그레이지색(그레이와 베이지의 중간 색)의
gremial : n, (미사 등에서 신부가 무릎에 걸치는)비단 무릎 덮개
gremlin : n, (비행기에 장난을 한다는)작은 마귀
gremmie, my : n, 파도타기의 신출내기
Grenada : n, 그러네이다(서인도제도 동부의 독립국;수도
Grenadan : n, 그러네이다 사람
grenade : n, 수류탄, 소화탄, 치루탄
grenadier : n, 척탄병, 키가 큰(당당한) 보병, 근위 보병 제1연대의 병사
grenadin : n, 송아지, 칠면조의 프리캉도
grenadine : n, 얇은 사의 일종, 석류 시럽
grenadine : n, 석류 시럽, 양흥, 붉은 색 염료
Grendel : n, 그렌델
Grenfell factory : n, 공상자 고용 공장
Grenoble : n, 그르노블(프랑스 남동부의 도시)
Gresham : n, 그레셤(영국의 금융가)
Gresham's law : n, 그레셤의 법칙(악화는 양화를 구축한다)
gressorial : a, 보행성의(새, 곤충등)
Gretchen : n, 여자 이름, goethe작 Faust제1부의 여주인공
Gretna	Green : n, 스코틀랜드 남부의 촌(혼인법이 간단해서 잉글랜드에서 눈맞아 도망친 남녀는 흔히 이곳에서 결혼했음)
grew : v, grow의 과거
grewsome : n, a, =GRUESOME
grey : n, a, =GRAY
grey area : x, 정식 원호 대상은 아니나 실업률이 높은 지역, =GRAY AREA
greybeard : n, =GRAY BEARD
greycing : n, =GREYHOUND RACING
Grey Friar : x, =GRAY FRIAR
greyheaded : a, =GRAYHEADED
greyhound : n, 그레이하운드(몸, 다리가 길고 빠른 사냥개)
greyhound racing : x, 그레이하운드 경주(전기 장치로 뛰는 모형 토끼를 그레이하운드로 하여금 쫓게 하는 내기 놀이)
greyish : a, =GRAYISH
greylag : n, 기러기(유럽산)
greyling : n, =GRAYLING
grey market : x, =GRAY MARKEY
gribble : n, 바다이(바다 속의 목재를 좀먹는 작은 갑각류)
grid : n, (쇠)격자, 섯쇠, 그리드(다극 진공관내의 격자관)
GRID : n, (gay related immunodeficiency disease)동성애와 관련된 면역 부전증(AIDS(후천성 면역 결핍증)의 처음 명칭)
grid bias : x, 그리드 바이어스
grid circuit : x, 그리드 회로
grid condenser : x, 그리드 콘덴서
grid current : x, 그리드 전류
grid declination : x, 격자 편각
gridder : n, 미식 축구 선수
griddle : n, vt, (과자를)철판(번철)(에 굽다)
griddle cake : n, 핫케이크
gride : vt, n, 맞스치다, 삐걱거리다, 그소리
gridiron : n, (고기 등을 굽는)석쇠, 격자 모양의 것, 도로망, 무대 천장의 창살 모양의 대들보, 미식축구장
grid leak : n, 그리드 리크(고저 항기의 하나)
gridlock : n, (교차점 등의)전면적 교통정체(어느 방향으로도 움직이지 못하는)
grid variation : x, 그리드 편차(진정 자오선과 자기 자오선의 교각)
grief : n, 비탄(의 씨), 재난, 불운, come to ~ 재난을 당하다, 실패하다
griefless : a, 
griefstricken : a, 비탄에 잠긴
grief therapy : a, 비애 요법(배우자나 자녀를 여윈 사람에 대한 정신적 지원 요법)
Grieg : n, , Envard(1843~1907)노르웨이의 작곡가
grievance : n, 불만, 불평거리
grievance committee : x, (노동 조합의)고충 처리 위원회
grieve : vt, vi, 슬퍼하다, 괴로워하다, 괴롭히다, 몹시 슬퍼하다, 마음 아파하다, 가슴 아파하다
grieve : n, 관리자, 농장 관리인
grieved : a, 슬퍼하는, 슬픈
griever : n, 슬퍼하는 사람, 비탄에 잠긴 사람, GRIEVANCE COMMITTEE의 근로 자측 위원
grievness : n, 괴로움
grievous : a, 괴로운, 쓰라린, 심한, 슬픈, 비통한, 애처로운
griff : n, =GRIFFIN
griff : n, 정보, 뉴스
griffin : n, 독수리 머리와 날개에 사자 몸을 한 괴물
griffin : n, =GRIFFON
griffin : n, (도박의)귀뜀;암시;정보
griffon : n, 독수리의 머리, 날개에 사자의 몸통을 가진 괴수, 엄중한 감시인, =GRIFFON VULTURE
griffon : n, 그리폰(포인터의 개량종)
griffon vulture : x, 흰목대머리수리
grift : n, vt, vi, 사기(도박), 협잡(한돈), 사기치다
grifter : n, 야바위꾼, 사기 도박꾼;떠돌이, 부랑자
grig : n, 작은 뱀장어, 귀뚜라미, 여치
Grig : n, 남자이름
grigri : n, =GRIS-GRIS
grill : n, 석쇠(gridiron), 고기(생선)구이 요리
grill : vt, 굽다, 쬐다, 뜨거운 열로 괴롭히다, 엄하게 심문하다
grill : vi, 구워지다, 쬐어지다
grillage : n, 귀를 지정(약한 지반 위 건축에 쓰는 나무를 토대)
grille : n, (창 따위의)쇠격자, 쇠창살
grilled : a, 창살이 있는;구운, 그을은
grillroom : n, 그릴(즉석 불고기 식당)
grillwork : n, GRILLE모양으로 만든것
grilse : n, (바다에서 강으로 올라온)연어 새끼
grim : a, 엄한, 불굴의, (얼굴이)무서운, 험상궂은, 잔인한 hold on like ~ death 단단히 달라붙어서 떨어지지 않다
grimace : n, 찡그린 얼굴(을 하다), 짐짓(점잔을 빼며) 찌푸린 상을 하다
grimalkin : n, 고양이, 늙은 고양이(암코양이), 심술궂은 할멈
grime : n, 때, 그을음, 검댕, 더럼, 더럽히다, 때묻히다
griminess : n, 때묻음, 더러움
grimly : ad, 잔인하게;엄하게, 무섭게, 험악하게, 으스스하게
Grimm : x, (1786~1859) 독일의 언어학자, 동화작가 형제
Grimm's law : n, 그림의 법칙(Jakob Grimm이 발견한 인도유렵어의 자음 전환의 법치)
grimness : n, 잔인;엄격함;무서움, 혐악함, 으스스함
grimy : a, 때묻은, 때(그을음)으로 더러워진, 때묻은, 더러운
grin : vi, n, 씩(싱긋)웃다(웃음), (고통, 노여움, 웃음 따위로)이빨을 드러내다(드러냄)
grinandbearit : a, (고통, 실망등을)씩 웃고 참는(견디는), 참을성 있는
grind : vt, (맷돌로)타다, 가루로 만들다, (맷돌, 핸들 따위를)돌리다, 닦다, 갈다, 갈아서 닳게 하다, 문지르다, 착취하다, 주입시키다, 바드득거리다
grind : vi, 맷돌질하다, 가루를 타다, (가루로)갈리다, 가루가 되다, 닦아(갈아)지다, 삐걱거리다, 부지런히 일하다, 끈기 있게 공부하다
grind : n, (맷돌로)타기, 뺄 으깨기, 힘드는 일, 억척스럽게 공부하기(하는 사람)
grinder : n, (맷돌을)가는 사람, (칼 따위를)가는 사람, 맷돌 위짝, 어금니, 구치, (수험생의)가정교사, 연마기, 그라인더
grinder's asthma(phthisis, rot) : x, 연마공 천식(가루로 인한 만성 섬유성 폐렴)
grindery : n, 연장을 가는 곳, 연마소, 구두 만드는 기구
grinding : a, (맷돌로)타는, 가는, 삐걱거리는, 힘드는, 지루한, 압제의, 매우 아픈
grinding : a, 제분, 타기, 갈기, 주입식 교수
grinding organ : x, =BARREL ORGAN
grinding wheel : x, 회전 숫돌, 바퀴 숫돌;연마 공장
grindstone : n, 회전 숫돌, have(keep, put) one's nose to the ~ 꾸준히 일하다
gringo : n, (경멸)(중남미에서)외국인, 미국(영국)인
grinningly : ad, 이빨을 드러내는, 싱긋 웃는
griot : n, 그리오(서아프리카의 구비 전승 시인;역사 구송자)
grip : n, 잡기, 쥐는(잡는) 기계, 손잡이, 핸들, (비밀 결사원의)암호적인 악수, 소형 여행가방, 핸드백
grip : vt, 마음을 사로잡다, 이해하다
grip : vi, 고착하다
grip brake : x, 제동기의 일종
gripe : vt, 잡다, 쥐어짜다, (흔히)가슴 아프게 하다, 배를 아프게 하다, 괴롭히다
gripe : vi, 잡다, 배앓이로 고생하다, 우는 소리(불평)하다
gripe : n, 잡기, 제어, 배앓이
gripe session : x, 불평 토론회
gripe water : x, (어린이의)배 아픈 데 목는 물약;구풍제
gripman : n, 케이블카 운전사
grippe : n, 유행성 감기, 인플루엔자, 독감
gripper : n, GRIP하는 사람(도구);대형 스냅 단추, 그리퍼
gripping : a, 주의(흥미)를 끄는, 매력있는
gripsack : n, 여행 가방
gript : v, GRIP의 과거, 과거 분사
gripy : a, 독감에 걸린
gripy, gripey : a, (배가)쥐어뜯듯이 아픈
grisaille : n, 그리자이유(회색 단색 화법);그 화법(의 그림)(유리창등)
Griselda : n, 여자이름;그리젤다(중세 문학에 나오는 정숙한 여자)
griseous : a, 청색이 도는 회색의;회색을 띤
grisette : n, (프랑스의)여점원, 여직공
grisgris : n, (아프리카 원주민의)부적
griskin : n, 돼지 옆구리살
grisly : a, 무서운, 무시무시한
grison : n, 그리슨(족제비의 일종;중남미산)
grist : n, 제분용 곡식, 곡식가루, (다)량, (다)수 bring ~ to one's mill 돈벌이가 되다, 수지가 맞다
grist : n, 실, 로프 등의 굵기
gristle : n, 연골
gristly : a, 연골질의, 연골과 같은
gristmill : n, 제분소
grit : n, (기계에 장애가 되는)잔 모래, 용기
grit : vi, 중덜거리다, 이를 갈다
grith : n, (옛날에 교회, 왕권 등으로 보장된)안전, 평화;안전한 장소
gritless : a, 모래알이 없는;고장이 없는, 용기 없는
grits : n, 거칠게 탄 곡식, 탄 옥수수(가루)
gritstone : n, 사암, 천연 숫돌
gritty : a, 잔 모래가 들어 있는 , 용감한
grivation : n, =GRIDVARIATION
grivet : n, 긴꼬리원숭이(동북 아프리카산)
grizzle : vi, (어린이가)칭얼거리다
grizzle : n, a, vi, vt, 회색, 회색머리(가발, 말), 회색의, 회색이 되다, 회색으로 만들다
grizzled : vi, =GRIZZLY
grizzly : a, 회색의
grizzly bear : n, (북미의)큰 곰
grm, : x, gram(s)
gro, : x, gross
groan : vi, n, 으르렁거리다, 신음하다, 그 소리, 괴로워하다, 열망하다 ~ inwardly 남몰래 번식하다
groaner : n, 신음하는 사람, 장례식 등에 문상객을 가장하여 끼어드는 도둑;프로레슬링 선수
groaningly : ad, 신음하면서
groat : n, 엣 영국의 4펜스 은화, (아주)조금, not care a ~ 조금도 개의치 않다
groats(grouts) : n, 탄(간) 밀, 귀리의 알곡
groaty : a, =GROTTY
grobian : n, 촌뜨기
grocer : n, 식료품상
grocer's itch : x, 곡물, 건과류에 들어 있는 진드기 때문에 생기는 습진
grocery : n, 식료품점, 식료품류
groceryman : n, =GROCER
groceteria : n, 셀프서비스 식료품점
grockle : n, 국외자, 비회원;낯선(달갑지 안흔)사람
grog : n, 물 탄 화주, 독한 술
grog blossom : x, 주부코, 빨간 코, 딸기코
groggery : n, 선술집
groggily : ad, 비틀거리며
grogginess : n, 비틀거림, 갈지자 걸음;휘청휘청함
groggy : a, 비틀(휘청)거리는, 그로기가 된, 곤드레만드레 취한
groghound : n, 술꾼
grogram : n, 견모 교직물의 일종
grogshop : n, =GROGGERY, 싸구려 술집
groin : n, 샅, 고간, 그로인, 궁릉(아치형 선)
groining : n, 궁륭식으로 하기, (집합적)(교차)궁륭
Grolier : n, 그롤리어식 (호화) 장정의
Grolier binding(design) : x, 그롤리어식 장정(디자인)(그는 금실로 엮어 만든 장식)
GROM : n, (graphic read only memory)COMPUTER GRAPHICS용 판독 전용 메모리
grommet : n, (꿰는 구멍 가장자리의)덧테쇠, 밧줄고리
gromwell : n, 지치, 개지치
Gromyko : n, 그로미코(소련의 정치가, 외교관)
groom : n, 마부, 신랑
groom : vt, 손질을 하다, 몸차림시키다, (-에게)입후보의 준비를 해주다
groomer : n, 
groomsman : n, (결혼식의)신랑 들러리
groove : n, (나무, 금속에 판)가는 홈, (레코드의)홈, 정해진 순서, 상궤
grooved : a, 홈이 있는, 홈이 팬
grooving plane : x, 개탕대패
grooving saw : x, 개탕톱
groovy : a, 흠이 있는, 틀에 박힌, (연주 따위가)멋진
grop : n, (미)고프(dry fruits, nuts등을 섞어 굳힌 휴대 식품)
grope : vi, 더듬(어서 찾아내)다, 암중모색 하다, 찾다, ~ one's way 손으로 더듬어 나아가다
groper : n, =GROUPER
groping : a, 손으로 더듬는, 암중 모색하는
gropingly : ad, 손으로 더듬어, 암중 모색하듯이
grosbeak : n, 콩새류
groschen : n, 오스트리아의 그로셴 청동화, (독일의)10페니히화;(옛 독일의)그로셴 소은화
grosgrain : n, 그로그레인(비단, 인견등의 골진 천), 그 리본
gross : a, 조악(조잡)한, (지나치게)뚱뚱한, 투박한, 거친, 울창한, 짙은, 굉장한, 총량의, 전체의
gross : n, 그로스(12다스, 144개)
gross average : x, 공동 해손
gross domestic product : x, 국내 총샌산(GDP)
grossly : ad, 크게, 심히;조잡하게, 상스럽게;일괄적으로
gross national product : n, 국민 총생산
grossness : n, 엄청남, 조잡;외설, 과대, 비대, 농후, 우둔
grossout : n, a, 구역질나는(불쾌한)사람(것), 지겨운, 지긋지긋한, 불쾌한
grossout session : x, 욕 시합
gross profit : x, 매상 총이익, 총수익
gross ton : x, 영국톤(2, 240파운드)
gross tonnage : x, (선박의)총 톤수
gross weight : x, 총중량;전비 중량
grot : n, =GROTTO
grotesque : a, 그로테스크 무늬의, 기괴한, 터무니 없는, 우스운
grotesque : n, (그림, 조각 따위의)괴기미, 그로테스크풍, 고딕체(활자)
grotesquerie, -ry : n, 그로테스크한 성격(언동);(집합적)그로테스크한 것
groth company : x, 고도 성장 회사
Grotius : n, 그로티우스(네델란드 법학자;국제법의 시조)
grotoed : a, 동굴의
grotto : n, 동굴, 암굴
grotty : a, 꾀죄죄한, 불품없는, 초라한, 불쾌한
grouch : n, 불유쾌, 까다로운 사람
grouch : vi, 토라지다, 불평을 말하다
ground : n, 지면, 토지, 땅, 흙, 지역, 운동장, 마당, 정원, 물밑, 바다밑, 앙금찌끼, 기초, 근거, (그림의)바탕(칠하기), (피륙의)바탕빛, 어스, 접지, 이유, 동기, 입장, 지반, 의견
ground : vt, vi, 세우다, 수립하다, 입각시키다, -의  기초를 두다, 초보(기초)를 가르치다, (무기를)땅에 놓다, 접지(어스)하다, 좌초시키다, 비행을 허락치 않다, 좌초하다
ground : x, grind의 과거(분사)
groundage : n, 정박세, 입항세
ground angling : x, (찌없는)바닥 낚시질
ground ash : x, 어린 물푸레 나무;그 지팡이
ground bait : x, (물고기를)모으는 밑밥
groundbait : vt, 물속에 밑밥을 미끼로 뿌리다
ground ball : x, 땅볼
ground bass : x, 기초 저음
ground beam : x, =GROUNDSEL;침목
ground box : x, 회양목(화단가에 심는)
groundbreaker : n, 창시자, 개척자
groundbreaking : n, 기공
groundcherry : n, 꽈리
ground cloth : x, 무대 바닥에 까는 방수천, =GROUNDSHEET
ground coat : x, (페인트의)초벌칠, (금속을 칠할 때의)에나멜의 최초의 칠
ground color : x, (유화의)바탕색
ground connection : x, 접지, 어스
ground control : n, (비행장의)지상 관제(관)
groundcontrolled approach : x, (무전에 의한)지상 관제 접근
groundcontrolled interception : n, 지상 조작 적기 요격법
ground cover : x, 지피(식물), 지표 식피
ground crew : n, (비행장의)지상 근무원, 지상 정비원
ground detector : x, 검루기
grounded : a, 기초를 둔, 근거있는
ground effect machine : n, 지면 효과기, 호버크라프트
grounder : n, 땅볼
groundfish : n, 해저에 사는 물고기
groundfishing : n, =GROUND ANGLING
ground floor : n, 일층, 유리한 입장
ground fog : x, 땅 안개(땅이 차져서 생김)
ground frost : x, 지표의 서리;언 지면, (식물이 피해를 입는)지표 빙결 온도
ground game : x, (집합적)엽수
ground glass : n, 젖빛 유리
ground hog : n, (북미의)마못, 철도의 제동수
Groundhog('s) Day : x, (이날 마못이 굴에서 나와 자기 그림자를 보면 겨울잠으로 되돌아간다는 전설에서)성촉절의날(2월2일)
ground ice : x, 물밑 얼음, 저빙
grounding : n, 좌초;배를 육상에 올리기(배밑의 검사나 수리를 위해), (자수, 염색등의)바탕(빛), 기초 교육(지식), 근저, 접지, 어스, 기초 공사, 비행(운전(등))금지
ground ivy : x, 덩굴광대수염, 병꽃풀
ground keeper : x, =GROUNDKEEPER
groundkeeper : n, (공원, 구장의)관리인, 정비원
ground lanlord : x, 지주
ground launched : a, (미사일 등이)지상 발사의
ground launched cruise missile : x, 지상 발사 순항 미사일(GLCM)
groundless : a, 근거 없는
groundling : n, 지상 동물, 물밑바닥에 사는 물고기, 저속한 관객(독자), 입석 관람객
ground log : x, (흐름이 빠른 얕은 바다에서의)대지 선속 측정의
ground loop : n, (이착륙 때 일어나는 급격한)이상 선회
groundly : ad, 충분한 근거를 가지고
groundman : n, (크리켓등의)구장 관리인(보통 직업 선수가 함)
ground marker : x, 조명탄(목표 지역을 비추기 위해 낙하산 없이 떨어뜨리는)
groundmass : 석기, 기질
groundness : n, 
ground note : x, 기음;주음
groundnut : n, 땅콩
groundout : n, 땅볼로 아웃됨
ground pig : n, (고슴도치 비슷한 아프리카산의)설치류의 일종
groundpine : n, 석송(크리스마스 장식용)
ground plan : n, (건물의)평면도, 기초계획, 원안
ground plane : x, (투사도의)기준 평면;지반면
ground plate : X, =GROUNDSILL, (침목아래의)상판, 접지용 금속판
groundplot : n, 집터, 대지;=GROUND PLAN
ground pollution : x, 토양 오염
groundprox : n, (ground proximity warning system)대지 접근 경보 장치
ground rations : x, 성교
ground ray : x, =GROUND WAVE
ground rent : n, 지대
ground rule : n, 야구장에 따른 규칙, (사회 등의)기본적인 규칙
ground sea : x, =GROUND SWELL
groundsel : n, 토대, 기초
groundsel : n, 개쑥갓(약용)
groundsheet : x, (텐트속에 까는)방수 깔개
groundsill : x, =GROUNDSEL
groundsman : x, =GROUNDKEEPER
ground speed : n, (비행기의)대지 속도
ground squirrel : n, (북미산의)얼룩 다람쥐
ground staff : N, =GROUND CREW, (경기장등의)관리인, 정비원
ground state : x, 기저 상태
ground station : x, 지상국, 추적소
groundstrafe : x, =STRAFE
ground stroke : x, 그라운드 스트로크(공이 바운드한 것을 치기)
ground swell : n, (지진, 폭풍우 따위로 인한)큰 파도
ground tackle : x, 정박 용구(닻, 닻줄 등의 총칭)
groundtoair : a, 지대공의
groundtoground : a, 지대지의
ground troops : x, 지상 부대
ground water : n, 지하수
ground wave : x, 지상파
ground wire : n, 어스(선), 접지(선)
groundwork : n, 기초, 토대, (자수, 그림 등의)바탕(색)
ground zero : n, (정확한)폭격 지점, (원폭의)폭발 직하 지점
group : n, 무리, 비행 대대, 비행 연대
group : vi, vt, 모으(이)다, 분류하다
group captain : n, 공군 대령
group dynamics : x, 집단 역학
grouper : n, (따뜻한)해안의)능성어과의 물고기
group grope : x, 혼음 파티;집단 접촉
groupie : x, 록그룹 등의 뒤를 쫓아다니는 여자 팬
grouping : n, 모으는 일, 배치, 그룹
group insurance : x, 단체 보험
group marriage : n, (미개 인종의) 집단 결혼, 잡혼
group medicine : =GROUP PRACTICE
group mind : n, 군중 심리
Group of 77 : n, 77개국 그룹(UN의 무역개발 회의(UNCTAD)의 회원인 발전 도상국 그룹)
Group of Seven : n, G, 7 선진 7개국 그룹
group practice : x, (여러 전문의의)집단 의료;(여러 환자에 대한)집단 검진
group psychology : x, 군중 심리학
group sex : x, 집단 성교
group theory : x, 군론
group therapy : n, 집단 요법
groupthink : n, 집단사고(전문가들에 의한 합동 토의)
groupuscule : n, 소집단
group velocity : x, (파동의)군속도
group work : x, 집단(사회)사업
grouse : n, 뇌조(류)
grouse : n, vi, 불평(하다)
grout : n, vt, 묽은 모르타르(시멘트)(를 부어 넣다)
grout : vt, vi, (돼지가 흙등을)주둥이로 파헤치다
grouty : a, 심기가 나쁜, 심술궂은, 진흙탕의, 더러운;거친, 조잡한
grove : n, 작은 숲
grovel : vi, 기다, 엎드리다, - in the dust 땅에 머리를 대다, 아첨하다
groveler : n, 넓죽 엎드리는 사람, 비굴한 사람
groveling : a, 넓죽 엎드리는, 비굴한, 천박한
grovy : a, 작은 숲으로 덮인, 나무가 많은
grow : vi, 성장하다, 자라다, 나다, 크다, 늘다, 강해지다, 점점 더해지다, 점차로  -하게 되다
grow : vt, 생(성)장시키다, 자라게 하다, 재배하다, -on(upon) 점점 증대하다, -out of -을 버리다, -에서 탈피하다
growable : a, 성장하는, 발육하는
grower : n, (꽃, 과일, 야채등의)재배자;(가축 등의)사육자, -하게 자라는 식물
growing : a, 성장하는, 증대하는
growing : n, 성장, 발육, 생성
growingon : n, (종묘의)육성;(병아리 등의)사육
growing pains : n, 성장기 신경통(청소년의 급격한 성장에 의한 수족 신경통), (신계획, 사업 등의) 발전도상의 곤란
growing point : x, 생장점
growing season : x, 식물의 생장(번성)기
growl : vi, (맹수가)짖다, 으르렁 거리다, (천둥이)울리다, 불평을 터트리다, 으르렁거리는(짖는)소리, (천둥 따위의)우르르 소리
growler : n, 으르렁거리는 사람(것, 동물), 딱딱거리는 사람, (선박에 위험한)작은 빙산, 그라울러(전자 장치의 일종);(전자식)확성기, 인터폰
growling : a, 으르렁(딱딱)거리는
grown : v, grow의 과거분사
grownup : n, a, 어른(이 된)
growth : n, 성장, 생장, 발육, 발달, 증대, 재배, 생장(발생)물, 산물
growth center : x, (sensitivity training등을하는)능력 개발 센터)
growth hormone : n, 성장 호르몬
growth industry : x, 성장 산업
growth stock : n, 성장주
groychy : a, 지르퉁한, 성난
groyne : x, =GROIN
GRP : x, gross rating pint종합 시청률
grub : vt, 파 일으키다, (그루터기를) 파내다, 애써서 찾아내다
grub : n, 구더기, 굼벵이, 단정치 못한 사람, 삼류문인
grub ax : x, (나무 뿌리를 파내는)곡괭이
grubber : n, 나무 그루터기(뿌리)를 파내는 사람(도구), 부지런히 일하는(공부하는)사람, 수전노
grubby : a, 더러운, 벌레가 끓는 음식
grub hoe : x, 그루터기 파내는 괭이
grub hook : x, 그루터기 파내는 갈고리
grubsaw : n, 돌켜는 톱
grub screw : x, 그러브 나사(한족 끝에 드라이버용 홈이 있는 대가리 없는 나사)
grubstake : vt, (탐광자에게)이익 분배를 조건으로 금품을 주다
grubstaker : n, 
Grub Street : vt, (옛 런던의)가난뱅이 문인 거리, 삼류 문인들
grubstrret, G- : a, 삼류 문인의, 저급 소설의
grudge : vt, 아까워 하다, 주기 싫어하다, 샘내다, 싫어하다
grudge : n, 원한, 유한, bear a - against -에 대해 원한을 품다
grudging : a, 인색한, 마지못해서 하는
grudgly : ad, 마지 못해, 울며 겨자 먹기로
gruel : n, 묽은 죽, 엄벌, get one's ~ 호된 벌을 받다
grueling : a, n, 녹초로 만드는, 엄한, 엄벌, 혼냄
gruesome : a, 무시무시한, 무서운, 소름이 끼치는 듯한
gruff : a, 쉰 목소리의, 거친, 난폭한
gruffish : a, (목소리가)좀쉰, 좀 거친
gruffly : ad, 
gruffness : n, 
gruffy : a, =GRUFF
grum : a, 성미가 까다로운, 무뚝뚝한, 뾰로통한
grumble : vi, vt, 불평하다, 투덜거리다, 우르르 울리다
grumble : n, 불평, 넋두리, (우레 따위의)울림
grumbler : n, 불평가
grumbling : a, 투덜거리는, 불평을 늘어 놓는;늘 쑤시고 아픈
grumbly : a, 투덜거리는, 불평을 말하는
grumdism : x, 지나친 인습 존중;세상에 대한 체면에 구애됨
Grumdy : x, 세상(의 귀찮은 소문) What willmrs, ~say? 세상에선 무어라고들 할까
grume : n, (피의)엉긴 덩어리, 응혈;진득진득한 덩어리
grummet : n, =GROMMET
grumose : a, (뿌리가)과립이 모여된
grumous : a, 응혈성의;엉긴, 진한
grump : n, vi, 불평가, 심기나쁨, 저기압, 불평하다, 툴툴거리다;뿌루퉁해지다
grumpy : a, 성미 까다로운, 심술난
grunge, grunch : a, n, 맛없는(보잘것없는, 지저분한, 따분한)(것)(사람)
grungy : a, =GRUNGE
grunion : n, 색줄멸
grunt : vi, n, (돼지처럼)꿀꿀 거리다(거리는 소리), 불평의 소리
grunt : n, 해병대원, 보병
gruntandgroan : a, (레슬러가 신음소리를 내어)구경거리 효과를 노리는
grunter : n, 툴툴(꿀꿀)거리는 사람(동물), 돼지;벤자리과의 물고기
gruntingly : ad, 
gruntle : vi, vt, =GRUNT, 기쁘게하다, 만족시키다
gruntled : a, 만족하고 있는, 기쁜(disgruntled의 역성어)
gruntling : n, 새끼 돼지
Gruyere : n, (스위스산의)그뤼에르 치즈
gryphon : n, =GRIFFIN
grysbok : n, 영양의 일종(남아프리카산)
gs, : x, guineas
GS, G, S, , g, s : x, General Secretary;General Service;General Staff;Girl Scouts;ground speed
GSO, G, S, O, : x, GeneralStaff Officer
Gspot : n, 지 스폿(여성의 성기의 일부;여성을 흥분시키는 자리)
GSTDN : x, ground space tracking and data network우주 추적 데이터 통신망 지상국
Gstring : n, G선(바이올린의 최저음선), (스트리퍼의)음부를 가리는 천조각
Gsuit : n, 재중력복
GT : x, glass tube, grand touring
gt, : x, gilt;great;gutta
Gt, : x, Great
Gt, Br(it) : x, Great Britain
GTD : x, guanosine triphosphate 구아노신 3인산
gtd, : x, guaranteed
gtt, : x, guttae
GU : x, genitourinary;Guam
gu, : x, guinea
guabbins : n, (영)허접쓰레기, 잡동사니;시시한 것;간단한 장치;거시기, 어리석은 사람
guacamole : n, 아보카도를 으깨어 토마토, 양파, 야념을 더한 멕시코 소스, (멕시코, 남미의)아보카도가 든 샐러드
guacharo : n, 쏙독새의 일종
guaco : n, 열대 아메리카산 국화과 식물(만능약, 특히 배독, 간헐열에 씀
Guadalcanal : n, 과달카날(태평양 Solomon제도의 섬)
guaiacol : n, 유창목;유창목 기름(약용)
Guam : n, 괌섬(남태평양 북서 마리아나제도 남단의 미국령)
guana : n, 큰도마뱀(열대지방의)
guanaco : n, (집합적)야생 라마(남미 안데스 산맥산)
guanethidine : n, 구아니딘(사람의 오줌이 함유된 아미노 요소)
guanine : n, 구아닌(DAN, RNA를 구성하는 푸린 염기의 하나)
guano : n, 구아노(바다새의 똥, 비료)
guanosine : n, 구아노신(구아닌의 리보뉴클레오시)
Guantanamo Bay : x, 관타나모만(쿠바 남동부의 만;미국 햐군 기지가 있음)
guar : x, guarantee(d);guarantor;guaranty
Guarani : n, 과라니 족(볼리비아, 파라과이, 남부 브라질에 사는 민족)
guarantee : n, vt, 보증, 보장(guaranty), 담보, 보증인, 보증하다
guaranteed annual wage : x, 연간 보장임금
guaranteed fund : x, 보증기금
guarantee income : x, NEGATIVE INCOME TAX
guarantor : n, 보증인
guaranty : n, 보증, 담보
guard : n, 경계, 망꾼, 파수병, 보호(호위)자, 수위(대), 근위대, 방위물(용구)보호물, (칼의)날밑, (차의)흙받기, 난로의 불어리, (총의)방아쇠울, (권투의)방어 자세, 차장
guard : vt, 망보다, 감시하다, 지키다, 방위하다, (언어 따위에)주의(조심)하다
guard's van : x, =CABOOSE
guardant : a, (동물이)정면을 향한
guard boat : n, 순회 경비병, 감시선
guard book : x, 종잇장을 철해 넣을 수 있게 된 스크랩북;종이끼우개
guard cell : x, 공변세포
guard chain : n, (시계 따위의)사슬줄
guard duty : n, 보초 근무, 위병근무
guarded : a, 조심성 있는, 신중한
guarder : n, 지키는 사람, 수호자
guard hair : x 보호 털(솜털을 덮는 거친털)
guardhouse : n, 위병소, 영창, 유치장
guardian : n, a, 보호자, 수호자, 관리인, 후견인, 보호하는
guardian angel : x, (개인, 사회, 지방의)수호천사, 수호실;크게 원조를 해주는 사람
guardianship : n, 보호
guardless : a, 지키는 사람이 없는, 무방위의;칼고등이가 없는
guardrail : n, , 난간
guard ring : x, 결혼 반지가 빠지지 않도록 그위쪽에 끼는 반지
guardroom : n, =GUARDHOUSE
guardship : n, 경비(감시함)
guardsman : n, (영)근위병;(미)주병
guard tent : x, 위병소(천막)
Guarnerius : n, 과르네리우스(이탈리아의 Guarneri집안 사람이 17-18세기에 만든 바이올린)
Guat : x, =Guatemala
Guatemala : n, 중미의 공화국
Guatemalan : a, 과테말라의;과테말라 사람의
guava : n, 물레나물과의 과수(열대 아메라카산)
guayule : n, 멕시코, 텍사스산 엉거시과 관목(고무 채취)
gubernatorial : a, 지사(장관, 총독 등)의
guck : n, 미끌미끌한 것;연니;찌꺼기
gudgeon : n, (유럽산)담수어의 일종(쉽게 잡히므로, 낚싯밥으로 쓰임)잘속는 사람
Guelf : n, (12-15세기의 이탈리아의)교황당원
Guelph : n, =GUELF
Guenevere : n, 여자이름
guerder rose : x, 불두화나무
guerdon : n, 보답
guerdon pin : x, =WRIST PIN
guerilla : n, 게릴라병(전)(의), 비정규병(의)
guernsey : n, 영국 해협상의 영국령 섬, Jersey 종 비슷한 큰 젖소, 청색 털실의(어린이용)스웨터
guerrilla : n, 게릴라병(전)(의), 비정규병(의)
guerrilla theater : x, (반전, 반체제적인)게릴라 연극, 가두 연극)
guess : n, vi, 추측(하다), 알아맞히다, 생각하다
guess hitter : x, 짐작만으로 치는 타자
guessrope : x, =GUEST ROPE
guesstimate : x, 짐작으로 견적하다
guesswork : n, 어림짐작
guest : n, 손님, 빈객, 내방자, 숙박인 the ~ of honor 주빈, paying ~ 하숙인
guestchamber : x, =GUEST ROOM
guesthouse : n, 영빈관, 고급 하숙집
guestimate : vt, n, =GUESSTIMATE
guestnight : n, (영)(클럽, 학교 등에서)손님을 접대하는 밤
guest room : x, 객실(여관, 하숙의);손님용침실
guest rope : x, (뱃전에 대는 보트를 위한)손잡이 줄;밧줄로 끌리는 배가 좌우로 빗나가지 않게 맨 둘째 줄
guest worker : x, =GASTARBEITER
Guevara : n, 게바라(아르헨티나 태생의 쿠바의 혁명가)
Guevarism : n, 게바라주의
guff : n, (미)허튼소리, 넌센스
guffaw : n, vt, 너털웃음(을 웃다)
Guiana : n, 남아메리카 북동부의 가이아나 공화국, 수리남 공화국, 프랑스령 기아나의 세 나라
guichet : n, 매표구, 개찰구
guidance : n, 안내, 지도, 지휘, (우주선, 미사일 등의)유도
guide : n, 안내자, 가이드, 지도자, 지휘자, 정찰대, 소녀단, 길잡이, 안내, 도표
guide : vt, 안내하다, 이끌다, 지도(지배)하다, 움직이다, 재촉하다
guideboard : n, 길 안내판
guidebook : n, 편람, (여행)안내서
guided : a, 안내를 받은;유도된
guided missile : x, 유도탄(미사일)
guide dog : n, 맹도견
guided tour : x, 안내원이 딸린(관광)여행
guided wave : x, 유도된 전파
guideless : a, 안내자(지도자)가 없는;지도가 없는
guideline : n, (도화지, 타이프용지 등의)희미한 윤곽선;(극장의)막 오르내리는 줄
guide number : x, 노출 계수(섬광 촬영때 노출을 산출하는 수치)
guidepost : n, 이정표, 지도 기준
guider : n, 안내하는 것(사람);지도자
guide rail : x, (문, 창문의) 가이드 레일
guide rope : x, (기구, 비행선의)유도삭, 조절 밧줄
guideway : n, 홈
guide word : x, 책의 페이지 윗부분에 인쇄된)찾아보기 말, 색인어
guidon : n, 삼각기(의 기수), (신호용)작은 기, 부(중, 연)대기
guild : n, 길드(중세의 동업 조합), (오늘날의)조합, 협회
guilder : n, 네델란드의 은화
guildhall : n, 길드회의소, 시청
guildsman : n, 길드 조합원
guild socialism : x, 길드 사회주의(제1차 대전 전의 영국 사회주의 사상
guile : n, 교활, 간지, 배신, 간교한 책략
guileful : a, 간사한, 교활한
guileless : a, 교활하지 않은, 정직한
guillemot : n, 바다 오리류(auk의 무리)
guilloche : n, 새끼 무늬
guillotine : n, vt, 길로틴, 단두대, 토론 종결, 길로틴으로 목을 자르다
guilt : n, 죄, 비행
guiltless : a, 죄없는, 모르는, 경험 없는, 갖지않은, be ~ of (위트)가 없다
guilty : a, 죄의식에 사로잡힌 상태
guilty : a, 죄가 있는, 죄를 범한, 죄에 해당하는 , 죄가 있는 듯한, 죄에 대한 가책(의식)을 느끼는
guilty big : x, (미)정신과 치료를 받는
guimpe : n, 옷 밑에 입는 블라우스
guinea : n, 기니금화
Guinea : n, 기니(아프리카 서해안 지방), 기니 공화국
Guinea Bissau : n, 기니비사우(서아프리카의 공화국)
Guinea corr : x, 팥수수(durra)
guinea fowl : n, 뿔닭
guinea grains : x, 아프리카산 생강과 식물의 씨(향료, 건위제)
guinea hen : n, 뿔닭의 암컷
Guineaman : n, 기니 무역선(상인), 노예선
guinea pig : n, 기니피그, 모르모트(속칭), 실험재료, 실험대, 명목상의 회장(사장)
guinea worm :  ㅌ, 기니벌레(사람, 말의 발에 기생하여 종양을 일으킴)
Guinevere : n, Arthur왕의 비
guisable : a, 인도(지도, 안내)할 수 있는
guise : n, 외관, 태도, 모습, 가면, 구실, 옷차림, 복장, in(under) the ~ of ...으로 모습을 바꿔서, ...을 가장하여, ...을 구실삼아
guitar : n, 기타
gulag : n, 강제노동수용소
Gulag Archiplago : x, (A, Solzhenitsyn의 소설 제목에서)수용소(소련의 사상, 정치범, 수용소망)
gular : n, 목(throat)의, 인후의
gulch : n, 협곡
gulch : n, 붉은 색
gulden : n, =GUILDER
gulf : n, 만, 심연, 깊은 구멍, 소용돌이, 화방수, 큰 간격
Gulf States : n, 멕시코만 연안의 다섯주(Florida, Alabama, Missisippi, Louisiana, Texas)
Gulf Stream : n, 멕시코 만류
Gulfweed : n, 모자반과의 해초
gull : n, 갈매기
gull : vt, n, 속이다, 속기 쉬운 사람
Gullah : n, (South Carolina, Georgia 두주의 연안 지방에 사는)걸라족의 토인, 걸라족이 쓰는 영어 방언
gullerry : n, 갈매기의 집단 서식처
gullet : n, 식도, 목구멍, 수로
gullibility : n, 잘 속음
gullible : a, 속기 쉬운
gullish : a, 바보 같은, 멍청한
Gulliver's Travels : n, 걸리버 여행기(Jonathan Swift작의 풍자 소설)
gullwing : a, 걸윙식의(문)(갈매기 날개형으로 위로 젖혀지게 되어 있는)
gully : n, 작은 골짜기, 도랑, 배수구
gullydrain : n, 하수관
gullyhole : n, 쇠창살 뚜껑 있는 도로상의 하수 빠지는 구멍
gullytrap : n, 하수 빠지는 곳의 방취판
gulp : vt, vi, 꿀떡꿀떡 마시다, 꿀꺽 삼켜버리다, 억제하다, 참다
gulp : n, 꿀꺽 삼킴, 한모금(의 양), 한 입 가득
gulper : n, GULP하는 사람, 풍선장어(심해어)
gulpingiy : ad, 꿀걱꿀걱, 쭉
gum : n, 고무, 생고무, 탄성고무, 고무나무, 유칼리나무, 덧신, 고무장화, 고무풀, 껌
gum : vt, 고무를 바르다(로 굳히다), 속이다
gum : vi, , 고무를 분비하다, 고무질이되다, 달라붙다
gum : n, 잇몸
GUM : x, (소련의)국영 백화점
gum ammoniac : x, 암모니아 고무
gum arabic : n, 아라비아 고무
gumbo : n, 오크라(나무, 열매), 오카라 열매를 넣은 수프
gumboil : n, 치은 궤양
gum boots : n, 고무 장화
gumdrop : n, (미)(젤리모양의)캔디
gum elastic : x, 탄성 고무, 고무
gum foot : n, (미)(사복)형사
gum gragon : x, =TRAGACANTH
gumma : n, (제3기매독의)고무종
gummatous : a, 고무종의
gumminess : n, 고무질, 점착성
gumming : n, 고무를 냄;(과실나무의)병적 수액 분비
gummite : n, 구마이트, 고무석(황갈색 또는 적갈색의 고무 모양의 역청 우라늄광
gummous : a, 고무(질)의, 고무 모양의;고무용의
gummy : a, 고무질의, 고무 같은, (나무가)고무 수지를 내는
gummy : a, 입빨없는, 잇몸을 드러낸
gump : n, (미)얼간이, 멍청이
gumption : n, 진취의 기상, 적극성, 양식, 판단력, 빈틈 없음
gum resin : x, 고무수지(고무와 수지의 혼합물)
gumshoes : n, =OVERSHOES
gum tree : x, 고무나무(특히)유칼리 나무
gumwood : n, 고무나무 재목, 유칼리재
gun : n, 대포, 소총, 평사포, 피스톨, 발포, 호포, 도둑, 직업적인 살인자 blow great ~s (바람이)세차게 불다
gunboat : n, 포함
gunboat diplomacy : x, 포함 외교(소국에 대한 무력 외교)
gun captain : x, 포술장
gun carriage : x, 포차, 포가
guncotton : n, 면화약
gundeck : n, 포열갑판
gundog : n, 총사냥개
gundown : 총격;총살, 사살;n, 
gunfight : vi, 총질하다, 총격전을 벌이다
gunfint : n, (수발총의)부싯돌
gunfire : n, 포화, 포격;발포
gunharpoon : n, 포경포로 발사하는 큰 작살
gun ho : x, (함께 일하다)의뜻에서
gunhouse : n, 포탑
gunk : n, 끈적끈적한것(오물), 화장품, 놈, 녀석
gunlayer : n, (영)대포조준수
gunlock : n, 방아쇠
gunman : n, 총잡이
gun metal : n, 포금
gun moll : x, (미)총잡이의 정부
gunned : a, (의) 포를 갖춘
Gunn effect : n, 영국 태생의 물리학자 J.B.Gunn 의 이름에서
gunnel : n, =GUNWALE
gunner : n, 포수, 포술장교, 총 사냥꾼
gunnery : n, 포술
gunnery sergeant : x, 특무 상사
gunning : n, 사격;총사냥, 총렵
gunny : n, 굵은삼베, 즈크 자루
gunnysack : n, 굵은 삼베(즈크)자루(감자, 석탄을 넣는)
gunpoint : n, 총끝, at ~ 권총을 들이대고
gunport : n, (군함의)포문, 총안
gunpowder : n, 화약
Gunpowder Plot : n, 화약 음모 사건(1605년 11월 5일 영국 국회의 폭파를 음모한 Guy Fawkes를 주범으로 하는 천주교도의 음모
gunpower : n, 포격 위력
gunpower tea : x, 잎이 총탄 모양으로 말린 고급 녹차
gun room : x, 총기실
gunrunner : n, 총포 화약의 밀수입
gunrunning : n, 총포 화약의 밀수입
gunsandbutter : a, 대포와 버터의;군사, 경제 양립
gunsbeforebutter : a, (경제보다)군사 우선의
gunsel : n, 멍청이, 배반자
gun ship : x, 포술 연습함
gunship : n, 무장 헬리곱터(지상군을 근접 지원하는)
gunshot : n, 포격, 착탄거리
gunshy : a, (말이나 사냥개가)총성을 무서워하는;(일반적으로)겁이 많은
gunsight : n, 사격 조준기
gunslinger : a, n, (미)권총을 가진(악한)
gunsmith : n, 총포상인, 총포공
gunstock : n, 개머리, 총상
gunter : n, 건터 계산자, (미)정밀(정확)하게
Gunter : n, 건서 (1901-70 미국의 저널리스트)
Gunter's chain : x, 건터 측량용 사슬(길이 66피트)
gunwale : n, (갑판의)현연, (보트 등의)뱃전의 위 끝
gunyah : n, (오스)토인의 오막살이
gup : n, 허튼이야기;추문
guppy : n, 이 물고기를 처음으로 영국에 소개한 영국인 이름에서
gurdwara : n, (시크교도의)신정, 기도소
gurgitation : n, 큰 물결 같이 오르내림;뒤끓음
gurgle : vi, 콸콸 흘러나오다, (새나 사람이)까르륵 목을 울리다
gurglet : n, =GOGLET
gurglingly : ad, 꼴꼴(꽐꽐)소리를 내며
gurjun : n, 거전(동인도, 필리핀산 거목;balsam을 채취함)
Gurkha : n, 구르카 사람(인도 Nepal에 사는 용맹한 종족)
gurnard : n, 성대
guru : x, 힌두교의 도사, 정신적인 지도자
Gus : n, 남자 이름
gush : vi, vt, n, 용솟음(치다), 분출 하다(시키다), (감정 따위의)복받침, (감정의)과시
Gush Emunim : n, 구시에무님(이슬라엘의 종교적 극우 조직)
gusher : n, 분출하는 유정, 감정가
gushing : a, 솟아나오는, 분출하는
gushy : a, 분출하는, 감상적인
gusset : n, 갑옷의 겨드랑 밑에대는 쇠마늘, 삼각천, 덧붙이는 천
gussey : vt, 모양내다, 차리다
gust : n 일진의 바람, 돌풍, (소리, 불, 감정따위의)돌발
gustation : n, 맛보기, 상미, 미각
gustative : a, =GUSTATORY
gustatory : a, 미각의
Gustavus : n, 구스타브 2세(1594-1632 스웨덴 왕)
gusto : n, 취미, 좋아함, 기호, 마음으로 부터의 기쁨
gusty : a, , (스코)맛있는
gusty : a, 바랍이 거센, 사납게 불어대는 바람의
gusty : a, 용감한, 기세 좋은
gut : n, 장, 창자, 내장, 내용, 용기, 인내, (바이올린, 라켓 따위의)장선, 거트, 좁은 통로
gut : vt, ...의 내장을(창자를)끄집어내다, (집 따위)안의 물건을 약탈하다
gutbucket : n, 분방하고 거친 재즈, (손으로 만든)저음 바이올린의 일종
gut course : x, (미)학점을 따기 쉬운 과목
Gutenberg : n, 독일의 활판인쇄 발명가Johannes(1400~1468)
Gutenberg Bible : n, 구텐베르크 성서(1456년 이전에 인쇄된 라틴어 성서)
gutfighter : n, 만만찮은(벅찬)적(상대)
gutless : a, 무기력한, 패기자 없는, 실질이 없는
gutta : n, 방울, 점적, (도리아식 건축의)물방울 장식
gutta : n, 구타(GUTTA-PERCHA의 주성분인 탄수화물)
guttapercha : n, 구타페르카(고무의 일종)
guttate : a, 물방울모양의, 반점이 있는
guttation : n, (식물 표면의)배수(현상), 일액
gutter : n, 홈통, (인도, 차도 사이의) 얕은 도랑(배수구), 수로, 빈민가, 좌, 우양페이지의 여백
gutter : vt, vi, 도랑을 만들다(이 되다), (자국을 남기며)흐르다, 촛농이 흘러내리다
guttering : n, 홈통;홈통 재료
gutterman : n, 길가의 싸구려 장수
gutter press : n, (선정적인)저급신문
guttersnipe : n, 최하층계급의 사람, 부랑아
gutter stick : x, (페이지를 구분하기 위하여 놓는)판 사이의 나뭇 조각
guttiform : a, 물방울 모양의
guttle : vt, vi, 게걸스럽게 먹다
guttural : a, n, 목구멍의, 후음(의)
gutturalize : vt, 목구멍으로 발음하다;후음화하다
gutty : n, (골프용)GUTTA-PERCHA제공
gutty : a, 원기 완성한, 용기 있는;도전적인
guy : n, vt, 버팀밧줄(로 안정시키다)
guy : n, (화약사건의주모자)Guy Fawkes의 기괴한상(11월5일 이상을 태우는 풍습이 있음), 괴상한 옷차림을 한 사람, 놈, 녀석, 친구
guy : vt, 놀리다, 괴롭히다
Guy : n, 남자이름
Guyana : n 남미의 독립국(수도 Georgetown)
Guyaness : a, 가이아나의
Guy Fawkes : n, 가이 포크스(1570-1606 화약 음모 사건의 주모자)
Guy Fawkes Day : x, (영)화약 음모 사건 기념일(11월5일)
guyot : n, (스위스의 지리학자명에서)기요(정상이 평탄한 바다 속의 산)
guzzle : vt, 폭음하다
GVH disease : x, 대숙주성 이식편병
GVH reaction : x, 대숙주 이식편 반응(이식된 장기와 체내 면역 세포간의 반응)
gwine : v, (미)GO의 현재분사
Gwne : n, 여자 이름
Gwnedolem : n, 여자이름
Gwnet : n, 궤트(영국 웨일스 남동부의주;1974년 신설;주도)
Gwoman : n, (미국의)FBI여자 수사관
Gwynedd : n, 귀네드(영국 웨일스 북서부의 주;1974년에 신설)
Gy, Sgt, , Gy Set : x, gunnery sergeant
gybe : vi, 반대쪽 뱃전으로 이동하다
gyle : n, (발효중인)엿기름 물;1회분의 맥주 양조량;발효통
gym : n, =gymnasium
gymkhana : n, 라켓 코트의 뜻에서(원래 영)경기장, (운동, 승마)경기 대회;자동차 장애물 경기
gymn- : x, (연결형)나체의 뜻
gymnasiarch : n, (옛그리스)운동가 양성 책임자
gymnasiast : n, (독일의)김나지움 학생;체육 교사, 체육가
gymnasium : n, 체육관, 체조장, (독일의)고등학교
gymnast : n, 체조교사
gymnastic : a, 체조의, 체육의
gymnastics : n, 체조, 훈련
gymnono : (연결형)=GYMN, 
gymnosophist : n, 인도의 벌거벗은 고행자;신비가;수도자(미)나체주의자
gymnosophy : n, 나행, 나체주의
gymnosperm : n, 나자식물
gymnospermous :  ㅁ, 겉씨의, 겉씨가 있는
gymp : n, =GIMP
gym shoe : x, 고무창의 즈크 운동화
gym slip : x, (소매가 없고 무릎까지 오는)여학생 옷(교복의 일부)
gym suit : x, 체육복
gyn(a)ec : x, (연결형)여성의, 암컷의뜻
gyn(a)ecocracy : n, 여인 정치;내 주장
gyn(a)ecocrat : n, 여인 정치론자
gyn(a)ecocratic : n, 여인 정치의;내창주의
gyn(a)ecologic : a, 부인과 의학의
gyn(a)ecology : n, 부인과 의학
gyn(a)ecomastia : n, (남성의)여성화 유방
gyn(a)ecopathy : n, 부인병
gyn(a)ephobia : n, 여성공포증
gyn, , gynecol : x, =gynecology
gyn- : x, (연결형)여성의, 암컷;여성생식기
gynaeceum : n, (옛 그리스)규방
gynandromrph : n, 자웅 모자이크
gynandrous : a, 암수 꽃술 착생의, 자응 합체의
gynarchy : n, 여권 정치, 여인천하
gyneceum : n, =GYNAECEUM
gynecium : n, =GYNOECIUM
gyneo- : x, (연결형)=GYN-
gyniatrics : n, 부인병 치료법
gyno- : x, (연결형)=GYN-
gynocracy : n, =GYN(A)ECORACY
gynoecium : n, 꽃의 자성기;(집합적)암술군
gynophore : n, 과병, 씨방자루
gynous : x, (연결형)여성의;한 자성기를 가진
gyny : x, (연결형)-GYNOUS에 대응하는 명사를 만듦
gyp : vi, vt, 속이다, 속여서 빼앗다
gyp : n, 사기꾼, 사기
gyp artist : x, (교묘한)협잡꾼, 사기꾼
gyp joint : x, 사기 도박장;바가지 씌우는 가게
gypper : n, 협잡꾼
gyppo, gypo : n, 날품팔이, 단기 작업, 삯일, 날품팔이꾼의 고용주
gyppy tummy : x, 열대지방여행자가 겪는 배탈
gyproom : n, (영)식기실(사환이 관리하는)
gyps : n, 석고, 깁스
gyps : x, gypsum
gypseous : a, 석고(질)의, 석고를 함유한, 서고 비슷한
gyp sheet : x, (미)커닝 페이퍼
gypsigerous : a, 석고를 함유한
gypsography : n, 석고 조각(술)
gypsophila : n, 광대나물, 안개꽃
gypsous : a, =GYPSEOUS
gypsum : n, 석고, 깁스
Gypsy : n, 집시(유랑민족), 집시어, 집시같은 사람, 방랑벽이 있는 사람, 바람끼 있는 여자
gypsy cab : x, (미)(콜택시의 면허로)몰래 거리에서 영업하는 택시
gypsy hat : x, 집시 모자(챙이 넓고턱 아래서 매는 여자, 어린이용)
gypsy leave : x, 무단 퇴거(무전 취식 등)
gypsy moth : n, 매미나방
gypsy rose : x, 체꽃
gypsy table : n, (세 다리의)작은 원탁
gypsy van : x, 집시가 유랑 생활에 사용하는 포장마차
gyral : a, 선회하는;대뇌회전의
gyrase : n, 자이레이스(DNA의  이중 나선을 수퍼코일화하는 효소
gyrate : vi, n, 회전하다의 뜻, 나선형의;소용돌이 꼴의
gyration : n, 선회, 회전;(고둥의)나선
gyratory : a, 선회의, 선회(회전)운동을 하는
gyratory crusher : x, 선동 분쇄기
gyre : n, 나선형, 소용돌이꼴
gyrene : n, (미)해병대원(원래는 멸시적)
gyrfalcon : n, 큰매(특히 아이슬랜드 등의)
gyri : n, GYRUS의 복수형
gyro : n, =GYROCOMPASS;GYROSCOPE
gyro : n, 지로, 이로(쇠고기 등을 마늘로 양념하여 빵에 얹어 먹는 그리스식 샌드위치)
Gyro : n, 국제적 봉사단체 Gyro Inernation의 회원
gyro : x, (연결형)바퀴;회전의 뜻
gyrocompass : n, 자이로컴퍼스, 회전 나침의
gyrocopter : n, 자이로콥터(헬리콥터 비슷한 1인승 프로펠라기)
gyrodyne : n, 자이로다인(헬리콥터와 오토자이로의 중간적인 항공기)
gyrograph : n, 회전수 측정 기록기
gyro horizon : x, 인공 수평기(동요하는 물체 위에서 수평면을 얻는 장치)
gyroidal : a, 나선형으로 배열된
gyromagnetic : a, 회전 자기의;(컴퍼스가)자이로 자기 방식의
gyropilot : n, 자동 조종 장치
gyroplane : n, 자이로 플레인(회전익을 가진 항공기의 일종)
gyroscope : n, 회전의
gyroscopic : a, 회전의의, 회전 운동의
gyrose : a, 물결 모양의, 주름이 있는, 굽이치는
gyrostabilizer : n (선박, 비행기의)자이로식 동요방지 장치
gyrostat : n, 자이로스코프의 일종(선회 운동 실험용)
gyrostatic : a, 자이로스탯의;강체선회 운동론의
gyrostatics : n, (단수 취급)강체 선회 운동론
gyrovague : n, 수도원을 순방하는 수도자
gyrus : n, 회, 뇌회
gyttja : n, 해니
gyve : n, v, 차꼬(를 채우다)
gyve : n, (미)마리화난(담배)
