L : n, 알파벳 열두번째 문자
L.A.C. : x, leading aircraftsman
L.Z.LZ : x, landing zone
la : n, (음계의) 라
laager : n, vt, vi, 마차 환상 배치 진영(을 치다), 야영하다
lab : n, a, =LABORATORY
LAB : x, Labor Advisory Board 노동 자문위원회
labconceived baby : =TESTTUBE BABY
labefaction : n, 동요(shake), 쇠약, 몰락(downfall)
label : n, vt, 이름을 붙이다, 꼬리표(를 붙이다), ...라고 부르다
labellum : n, (난초과 식물의 순형 화판), 입술꽃잎
labia : n, LIBIUM의 복수
labial : a, 순음의, 입술모양의, 순음
labial : n, 순음
labialization : n, 
labialize : vt, 순음화하다
labia majora : n, 대음순
labia minora : n, 소음순
labiate : a, n, 입술모양의, 차조기과 식물
labile : a, 불안정한, 변화를 일으키기쉬운
labio : n, 입술
labiodental : n, a, 순치음, 순치음의
labium : n, 순상부, 음순
labor : n, 노동, 근로, 노력, 수고, 진통, hard ~ 중노동, in ~ 분만중에, ~ of love 좋아서 하는 일
labor : vi, vt, 일하다, 애써 만들다, 진통으로 괴로워하다, (배가) 몹시 흔들리다, 난항하다
laboratorial : a, 실험실의
laboratory : n, 실험실
Labor Bank : x, (노동조합이 경영하는)노동은행
labor camp : x, 강제노동수용소
Labor Day : x, 노동절(9월 첫째 월요일, 미국, 캐나다 이외에은 5월 1일)
Labor Department : x, 노동성
labored : a, (문장 등)고심한 흔적이 있는, 무리한, 억지로 갖다 붙인, 부자연스러운, (동작, 호흡등이)하기 어려운, 괴로운, 힘드는(hard), 느릿느릿한
labored : a, 공들인, (문체 따위) 고심한, 힘드는, 부자연스런
laborer : n, 노동자
Labor Exchange : x, 직업소개소
labor force : x, 종업원 총수
laboring : a, 노동하는
laborintensive : a, 노동 집약형의
laborious : a, 힘드는, 부지런한
laboriously : ad, 힘드는, 부지런한
laborism : n, 노동당(노동 조합)의 주의(정책)
laborite : n, 노동자 옹호 단체의 일원, 노동자 옹호 정당원, 노동당원(지지자)
labormanagement : n, a, 노사, 노사의
labor market : x, 노동시장
labor offensive : x, 노동공세
labor relations : x, 노사관계
laborsaving : a, 노동 절약의(이 되는)
laborsome : a, 힘드는
labor turnover : x, 노동자 이동수
labor union : x, 노동조합
Labourite : n, 노동당원
labra : n, LAVRUM의 복수
Labrador : n, 북아메리카 북동부의 반도
labradorite : n, 조회장석
labret : n, 입술장식
labrum : n, 입술, 입술 모양의 것, 상순(labium에 대하여)
laburnum : n, 콩과의 낙엽교목의 하나(부활절의 장식용)
labware : n, 실험실 기기
labyrinth : n, 	Daedalus가 설계한 미궁, 미로, 미궁, 복잡한관계
labyrinthine : n, 미로의(과 같은)
lac : n, 무수, 10만
lac : n, 랙(인도의 깍지진디가 분비하는 나무진 같은 물질, 도료 원료)
laccolith : n, 병반, 라콜리스(떡 모양의 암체)
lace : n, 끈, 장식, 레이스(가슴 장식, 테이블보, 커튼 등에 쓰임), 몰, (코피 등에 탄) 소량의 진 술(따위), gold ~ 금몰, ~ boots 편상화
lace : v, 끈으로 죄다(장식하다), ...에 끈을 꿰다, 줄무늬로 하다, (소량을) 가미하다
lace : vi, 끈으로 매다(죄어지다), 매질하다, 비난하다
lacecurtain : a, (노동자 계급에 대하여)중산 계급의, 중산 계급지향의, 젠체하는, 허세부리는
laced : a, 끈이 달린(으로 졸라맨), 레이스로 장식된, 알코올을 가미한
Lacedaemon : n, 라케아이몬(Zeus의 아들), =SPARTA
Lacedaemonian : a, n, =SPARTAN
lacerable : a, 찢을 수 있는, 잘 찢어지는
lacerate : vt, n, (근육 따위를)찢어발기다, (마음을)괴롭히다
lacerated : a, 찢어진, (잎 등이 가장자리에)거치가 있는
laceration : n, 고뇌, 잡아찢음
lacertian : a, n, =LACERTILIAN
lacertilian : n, 도마뱀 무리의(동물)
laceup : a, n, (구두가)끈으로 묶는, 편상화, 부츠
lacewing : n, 풀잠자리
lacework : n, 레이스(세공)
laches : n, 의무불이행
lachrymal : a, 눈물의, 눈물을 분비하는, ~ duct 누선
lachrymal : n, 눈물단지
lachrymation : n, 눈물을 흘림, 눈물을 흘리고 옴
lachrymator : n, 최루 가스, 최루탄
lachrymatory : a, 눈물의, 눈물을 자아내는, 최루의, ~ gas(shell)최루가스(탄)
lachrymatory : n, 눈물단지(장례식에 온 사람들의 눈물을 받았다는 목이 가는 조그마한 단지)
lachrymose : a, 슬픈, 슬픔을 자아내는, 비통한, 눈물을 잘 흘리는
lacing : n, 끈목, 줄무늬, 매질
laciniate : a, 가장자리에 술이 달린, 톱니 모양의, 들쭉날쭉한
lack : n, 결핍, 부족, by(for, from, through)~ of ...의 결핍 때문에
lack : vi, vt, (...이) 결핍되다, 모자라다
lackadaisical : a, 감상적인, 생각에 잠긴
lackadaisically : ad, 감상적인, 생각에 잠긴
lackaday : int, 아 슬프다(alas)
lacker : n, v, =LACQUER
lackey : n, 종자, 하인, 종, 추종자
lackey : vt, vi, 따르다, 빌붙다
lacking : a, prep, ...이 결핍된
lackinoffice : n, 관직을 구하는 사람, 엽관배
lackland : a, n, 땅이 없는, 영토를 잃은, 땅이 없는(영토를 잃은 사람), 결지왕(영국왕Jhon의 별명)
lackluster : n, a, 광택없음, (눈, 보석 등) 흐리터분한
Lacombe : n, 라콤종(의 돼지)(캐나다 Alberta주 Lacombe시험장에서 만들어 낸 흰 돼지)
Laconia : n, 라코니아(그리스 남부의 옛 나라, 수도 Sparta)
Laconian : a, n, =SPARTAN
laconic : a, 간결한
laconical : a, 간결한
laconically : ad, 간결한
laconicism : n, 간결
laconism : n, (표현의) 간결함, 간결한 어구
lacquer : n, vt, 래커(옻)(을 칠하다), 칠기
lacrimal : a, n, =LACHRYMAL
lacrimator : n, 최루 물질, 최루약, 최루 가스
lacrimatory : a, =LACHRYMATORY
lacrosse : n, 라크로스, 구기
lactary : a, 젖의(같은)
lactase : n, 락타아제(유당 분해 효소)
lactate : n, 유산염
lactate : vt, 유화하다
lactate : vi, 젖을 내다, 젖을 빨리다
lactation : n, 유산염, 유화하다, 젖을내다, 젖을 빨리다
lacteal : a, 젖(모양)의
lacteal : n, 유미관
lacteous : a, 젖의(같은), 유백색의
lactescence : n, 유상화, 젖빛, 유즙액(분비)
lactescent : a, 젖 모양의, 유백색의, 젖을 내는(분비하는), 유즙액을 분비하는
lactic : a, 젖의, 젖에
lactic acid : x, 유산
lactiferous : a, 젖(젖 같은 액체)를 내는
lacto : n, 젖, 우유
lacto : v, =LACT
lactobacillus : n, 유산균
lactoferrin : n, 락토페린(포유류의 모유에 있는 단백질의 하나)
lactoflavin : n, 락토플라빈(riboflavin)
lactometer : n, 검유기
lactoovovegetarian : n, 유란 채식주의자(계란, 유제품을 먹는 채식주의자)
lactoscope : n, 검유기, 유지계
lactose : n, 락토오스
lacuna : n, 탈루, 탈문, 공백, 결함, 작은 구멍, 우묵 팬 곳, (뼈 따위의)소와
lacunal : a, 
lacunar : n, 격자 무늬로 된 반자
lacunary : a, 
lacustrine : a, 호수의
lacy : a, lace 같은
lad : n, 소년, 젊은이, (친근감을 주어)녀석
ladder : n, 사닥다리, (출세의) 연줄, kick down the ~ 출세의 발판이었던 친구를(직업을)차 버리다
ladderback : a, (의자의)등받이에 사다리꼴 가로대를 댄
ladderproof : a, (스타킹의)세로 올이 풀리지 않는
laddertron : n, 래더트론(하전 입자 가속 장치의 하나)
ladder truck : n, (소방, 구조용) 사닥다리차
laddie : n, 젊은이, 총각, 자네(old chap)
lade : vt, 싣다, 퍼내다
laden : v, lade의 과거분사
laden : a, (무거운 짐이) 실린
ladies' (lady's) man : x, 여성에게 곰살궂은 남자
ladies'tresses : n, 타래난초의 일종
lading : n, 적재, 뱃짐, 짐싣기, 선적, 뱃짐
ladiry : vt, 귀부인으로 만들다, 귀부인 대우를 하다, Lady의 칭호로 부르다
ladle : n, vt, 국자(로 푸다, 퍼내다)
ladleful : n, 한 국자 가득(한 양)
Ladoga : n, 라도가호(소련 북서부에 있는 유럽 최대의 호수)
lady : n, 숙녀, 귀부인, (신분에 관계 없이)기품있는 여성, (성명에 붙여) ...부인, ...양, 성모마리아, 여자 변소, my ~ 마님
lady's maid : x, 시녀, 몸종
lady's thumb : x, 여뀌속의 잡초
lady'tresses : n, 타래난초의 일종
lady('s)slipper : n, 개불알꽃속의 식물
lady('s)smock : n, 황새냉이(의 무리)
ladybird : n, 무당벌레
ladybug : n, 무당벌레
lady chair : x, (두사람의 팔로 만든) 손가마
Lady Day : x, 성모 수태 고지절(3월 25일, quarter days의 하나)
ladyfinger : n, 가늘고 긴카스테라
ladyfy : vt, =LADIFY
ladyhelp : n, (가족대우의) 가정부
ladyhood : n, 귀부인(숙녀)의 신분(품위), (집합적)귀부인들, 숙녀들
ladyinwaiting : n, 시녀, 궁녀
ladykiller : n, 색한, 탕아, 호남자
ladykin : n, 작은 귀부인, 작은 숙녀(little lady), 아가씨
ladylike : a, 귀부인 같은, 우아한, 부드럽고 온화한
ladylove : n, 애인, 연인
ladysfinger : n, 콩과의 식물(가축 사료)
ladyship : n, (Lady칭호가 있는 이에 대한 경칭으로)영부인, 영양, 부인
ladyssmock : n, 황새냉이 무리의 잡초
laetrile : n, 라에트릴(살구, 복숭아 씨에서 얻는 제암제)
laevulose : n, =LEVULOSE
Lafayette : n, 남자 이름, 라파예트 Marquis de ~(17571834)(프랑스의 군인, 정치가, 미국이 독립전쟁에 종군하였고 프랑스 대혁명 때에도 활약)
LAFTA : x, Latin American Free Trade Association 라틴 아메리카 자유 무역 연합
lag : vi, 뒤떨어지다, 느릿느릿 걷다
lag : n, 뒤떨어짐, 시간의 착오, 지연
lagan : n, 부표가 달린 투하 화물(조난 때의)
Lageos : n, 레이저스(미국이 1976년에 쏘아 올린 측지 위성)
lager : n, 라거비어, 저장 맥주(저온으로 냉장하여 익게 함)
lager (beer) : n, 저장맥주(일종의 약한 맥주)
laggard : a, n, 늦은, 느림보, 느린
laggardly : a, 꾸물꾸물(꾸물대는)
lagger : n, 꾸물거리는 사람, 지행 지표(lagging indicator(index))
lagging : n, (보일러 등의) 단열용 피복시공
lagn(i)appe : n, 경품
lagomorph : n, 토끼목 표유 동물의 총칭
lagoon : n, 늪, 호, 못(강, 호수 등으로 통하는), 초호(환초에 둘러싸인 얕은 바다)
laic : a, n, (성직자에 대해서) 속인의, 일반의, 평신도
laical : ad, 속인처럼, 세속적으로
laicism : n, 세속주의, 비성직권주의(정치를 비성직자의 지배 하에 두는 사상)
laicize : vt, 환속(속화)시키다, 속인에게 맡기다, (공직 등을)속인에게 개방하다
laid : v, lay의 과거(분사)
laid : a, ~ up 저장의, 집에 틀어박힌, 몸져 누워 있는
laidback : a, (음악(연주)등이)한가롭고 평온한, 느긋한, 무감동적인
laidoff : a, 일시 해고된
laid paper : x, 투문있는 종이
lain : v, lie2 과거분사
lair : n, a, 야수의 (소)굴, 숨는 장소, 쉬는 장소, 침상, ~ed up 야한 몸차림
laird : n, (대)지주
laisser faire : x, 자유 방임주의
laity : n, (성직에 대해서) 속인, 풋내기
Laius : n, 라이오스(Thebes의 왕, Oedipus의 아버지)
lake : n, 호수, 못
lake : n, 레이크, 다홍색
Lake District : x, 호반지방
lake dweller : x, (유사 이전의) 호상 생활자
lake dwelling : x, (특히 유사 이전의)호상 생활
lakefront : n, 호반, 호안
lakeland : n, 호수 지방
lakelet : n, 작은 호수
Lake Poets : x, 호반시인(호반 지방에 살았던 Coleridge, Wordsworth 들)
lakeside : n, 호반
Lake State : x, 미국주의별칭
lake trout : x, (미국 5대호 산)송어의일종
Lakoda : n, 라코다(물개의 모피)
laky : n, a, 호수의, 호수 모양의, 호수가 많은, 진홍색의
Lallan : a, n, 스코틀랜드 저지(Lowlands)의, 스코틀랜드 저지의 사투리
lallapalooza : n, 월등히 우수한(기발한) 것(사람), 모범으로 삼을 만한 걸작
lallation : n, r음을 l음으로(l음을 r음내지 w음으로)잘못 발음하기, 어린이의(같은) 불완전한 말투(발음)
lallygag : vi, 게으름 피우다, (남이 보는 앞에서)껴안고 애무하다
lam : vi, vt, 도망가다, be on the ~ 도망중이다
lama : n, (티베트, 몽고의) 라마승, Grand(Dalai)L 대라마, 달라이라마
Lamaism : n, 라마교, 라마교도
Lamarck : n, 라마르크(17441829)(프랑스의 생물학자, 진화론자)
Lamasery : n, 라마 사원
Lamaze : n, 라마스(법)의, 라마스법(무통 분만법의)
Lamazetechnique : x, 라마스 법(무통 분만법의 하나)
lamb : n, 새끼양, 순한사람, 새끼양 고기, 풋내기, like a ~ 순하게, the L (of God) 예수
Lamb : n, 램(17751834)(영국의 수필가, 비평가, 필명 Elia)
lamb : vt, vi, (새끼양을) 낳다
lambaste : vt, 후려갈기다
lambda : n, 그리스어 알파벳 열한째 글자
lambdacism : n, (l)음의 사용 과다
lambdoid : a, 람다형의, 삼각형의
lambdology : n, 람다 바이러스학
lambency : n, 어른거리는, 경묘한, 부드러운
lambent : a, 어른거리는, 경묘한, 부드러운
lambert : n, 람베르트(휘도의 cgs 단위)
Lambert : n, 남자 이름, 램베스, 런던 남부의 자치구, Canterbury 대주교의 런던 궁전
lambert : n, 람베르트
lambing : n, (양의)분만, (양의)출산 돌보기
lambkin : n, 새끼양
lamblike : a, 새깨 양 같은, 유순한, 온화한, 부드러운, 순진한
lambrequin : n, 투구 두건, (문, 창 따위의 윗 부분의)드림 천
lambskin : n, 새끼양가죽
lambsquarters : n, pl, 명아주류
lame : a, 절름발이의, (논설, 변명 따위가) 불충분한, 앞뒤가 맞지 않는, go(walk)~ 발을 절다
lame : vt, 절름발이로 만들다
lamebrain : n, 바보, 얼간이
lamebrained : a, 어리석은, 둔한
lame duck : x, 불구자, 파산자, 잔여 임기에 있는 재선 낙선의원, 부서진 비행기
lamell : n, 
lamella : n, 얇은판자, 앎은층
lamellate : a, LAMELLA로 만든
lamellibranch : n, 판새류의 조개
lamelliform : a, 박판(박편, 비늘)모양의
lamely : ad, 절름발이의, 불충분한, 앞뒤가 맞지 않는
lament : vi, vt, 슬퍼하다, 한탄하다, the ~ed 고인
lament : n, 비탄, 비가
lamentable : a, 슬픈, 통탄할
lamentably : ad, 슬픈, 통탄할
lamentation : n, 슬픔, 비탄
lamented : a, 애도를 받는, 애석히 여겨지는(고인에 대한 습관적 표현, 애석한, 한탄스러운
lamia : n, 여자 괴물(상반신은 사람, 하반신은 뱀), 요부, 마녀, 흡혈귀
lamina : n, 얇은판자, 얇은층
laminal : a, 얇은판자로 된, 얇은층을 이룬 ~ flow(공기, 물의)층류
laminar : a, 엷은 판(조각, 층)을 이루는, 엷은 조각으로 된, 층류의
laminate : vt, vi, 얇은판자로 만들다(가 되다)
laminate : a, n, 얇은 판자 모양의, 엽상 플라스틱, 합판제품
laminated : a, 엷은 판(조각)모양의, 엷은 판(층)오로 된, 엷은 판이 겹쳐서 된
lamination : n, 얇은판자로 만들다
Lammas : n, 라마스, 수확제, (옛날 8월 1일에 행하여졌음, 베드로의 쇠사슬의 기념일(8월 1일)
Lammas : n, 추수절
lamming : n, 구타, 흑평, 욕설
lamp : n, 램프, 등불, (These books) smell of the ~, (이책들은) 애써 쓴 형적이 뚜렷하다
lampblack : x, 유연(흑색 안료, 인쇄 잉크 등의 원료)
lampburner : n, 램프의 심지끝
lamp chimney : x, 등피
lampchimney : n, 램프의 등피
lamp holder : x, (전등의)소켓
lampion : n, (색유리로 된 장식용)작은 램프
lamplight : n, 등불
lamplighter : n, (가로등의) 점등부
lampoon : n, 풍자문, 풍자시
lampoon : vt, 풍자하다
lamppost : n, 가로등 기둥
lamprey : n, 칠성장어
lamp shade : x, 램프의 갓
lampshade : n, (램프, 전등)갓, 램프셰이드(원자폭탄의 폭발 고도와 폭심지의 측정장치)
lampstand : n, 램프 스탠드
lampwick : n, 램프의 심지
LAN : n, local area network 기업내 정보 통신망
lanac : n, (착륙시의)항공기 유도 레이더 시스템
lanai : n, 베란다(하와이말)
lanate : a, 양모 모양의, 양모(부드러운 털)로 덮인
Lancashire : n, 잉글랜드 북서부의 주(면직 공업 중심지)
Lancaster : n, 영국왕가
Lancaster : n, 랭커스터 왕가(13991461 년간의 영국 왕조), 랭커스터(랭커셔 주의 옛 주도)
Lancastrian : n, a, 영국왕가
lance : a, vt, 창(으로찌르다), 창기병, lancet(으로 절개하다)
Lance : n, 남자 이름(Lancelot, Launcelot)
lance corporal : x, 병장
lancefish : n, 양미리
lance jack : x, 병장
lancelet : n, 활유어
Lancelot : n 남자 이름(Lance, Arthur왕 전설의 원탁 기사 중 가장 훌륭한 용사, 왕비 Guinevere의 연인)
lanceolate : a, 창끝모양의, (잎이)피침형인
lancer : n, 창기병
lance sergeant : x, 중사 근무 하사
lancet : n, 랜싯
lancinate : vt, 찌르다
lancination : n, 찌르기, 찢기, 찌르는 듯한 아픔, 심한 아픔
lancwood : n, (열대 아메리카산의) 강인한 교목의 일종(창 자루, 낚싯대감으로 쓰임)
land : n, 뭍, 육지, 지면, 토지, 땅, 소유지, 국가, 국토, by ~ 육로로, go on the ~ 농부가 되다, in the ~ of the living 이 세상에서
land : vt, 상륙시키다, 하차시키다, (상, 일자리 등을) 얻다, ...에 빠지게 하다
land : vi, 상륙하다, 빠지다
Land's End : x, 영국 Cornwall 주 서단의 꽃
land agent : x, 토지 매매 중개업자, 토지 관리인
landau : n, 4륜 포장마차, 자동차의 일종
landaulet : n, 소형잰도 마차, 랜도형 자동차(coupe의 일종)
landbased : a, 지상 기지 소속(발진)의 (미사일 등)
land breeze : x, 육연풍
landcarriage : n, 육운, 육상 운수
landed : a, 토지를 갖고 있는, 소유지의
lander : n, 자, 착륙선
landfall : n, 육지 접근, 육지가 처음으로 보임, 처음으로 보인 육지
landfill : n, 매립, 매립지(쓰레기)
land force : x, 육군, 육상부대
landform : n, 지세, 지형(지면의 고저, 기복의 상태)
land freeze : x, 토지 (매매) 동결
landgirl : n, (제2차 대전 중의) 임시 여자 농장 노동자
landgrabber : n, 토지횡령자
land grant : x, (정부의)무상 토지 불하(학도, 철도 부지를 위한)
landgrave : n, (중세 독일의) 변경백
landgravine : n, LANDGRAVE부인, 여자 LANDGRAVE
landholder : n, 지주, 차지인
landholding : a, 토지 보유의
landhunger : n, a, 토지 소유, 토지 소유의
landhungry : a, 토지 소유욕이 강한, 토지 소유(영토 확장)열에 들뜬
landing : n, 상륙, 착륙
landing beam : x, 착륙 유도 전파
landing craft : x, 상륙정
landing field : x, 비행장
landing flap : x, 착륙 조작 보조익
landing force : x, 상륙부대
landing gear : x, 착륙(착수)장치
landingground : n, =LANDING FIELD
landing mat : x, 착륙용 매트(1mx4m 가량의 강철망, 이것을 이어서 임시 착륙 활주로를 만듦)
landing net : x, 사내끼
landing party : x, 상륙부대
landingplace : n, 상륙장, 양륙장, 부두, 층계참
landing stage : x, 선창
landing strip : x, 활주로
landing vehicle : x, 착륙선
landjobber : n, 토지 투기업자, 토지 거간꾼
landlady : n, 여자지주, 여관의 여주인
land law : x, 토지법
landler : n, 랜틀러(남부 독일, 오스트리아 고지의 3박자의 농촌 춤, 그 곡)
landless : a, 토지가 없는, 토지를 가지지 않은, 토지가 없는 사람들, 육지가 없는
landline : n, (전신의)지상 통신선, 육지선(땅과 바다(하늘)의 경계), 지평선
landlocked : a, 육지로 둘러싸인
landloper : n, 부랑자, 방랑자, 떠돌이
landlord : n, 지주, (여관, 하숙의)주인, 바깥 주인
landlubber : n, 뭍에사는사람, 신출내기
landman : n, 시골뜨기, 농사꾼, =LANDSMAN
landmark : n, 경계표, (토지의)표지, 목표, 획기적 사건
land mine : x, 지뢰
landocracy : n, 지주계급, 땅주인들
landocrat : n, 지주 계급의 사람
land office : x, (정부의) 토지 관리 사무소
landowner : n, 지주
landowning : n, a, 토지 소유, 지주(로서)의
landplane : n, (수상 비행기에 대하여)육상 비행기
land planning : x, 국토계획
landpoor : a, 수익성이 없는 땅을 가져 가난한, 땅은 많아도 가난한(비싼 세금등으로 인하여)
land reform : x, 토지개혁
Landsat : n, 랜드샛(미국의 지구 자원 탐사 위성)
landscape : n, vt, vi, 풍경화, 조망, 정원을 꾸미다
landscape architecture : x, 조원, 정원 꾸미기
landscape gardener : x, 저원가, 정원사
landscape gardening : x, 조원, 정원 꾸미기
landscape painting : x, 풍경화법
landscaper : n, 원정, 정원사, 조경사(landscape gardener)
landscapist : n,  풍경화가(landscape painter)
landservice : n, 육군 병역, 육상 근무
landsick : a, (배가)육지에 너무 접근하여 행동하기 힘든
landslide : n, 사태, 산사태, (선거에서의) 압도적 승리, 대승리
landslip : n, 사태, 산사태
landsman : n, 육상 생활자
Landsturm : n, (독일, 스위스의)전시의 국민군 소집, 국가 총 동원, 국민군
landswell : n, (해안 가까이의)놀, 너울
Landtag : n, (독일, 오스트리아의)주의회
land tax : x, 지조
landtax : n, 지세, 지조
landtoland : a, (미사일이) 지대지의
landwaiter : n, 수출입세 담당 세관원, (세관의)하역(양륙) 감시인
landward : ad, a, 육지쪽으로
landwash : n, (해변의)고조선, (해변에 부딪는)파도의 철썩임
Landwehr : n, 예비군(독일, 스위스, 오스트리아의)
lane : n, 작은길, 시골길, 골목길, 차선, (선박, 항공기의) 규정항로
langlauf : n, 장거리 경주
langley : n, 랭글리(태양 복사의 단위)
langouste : n, 닭새우(spiny lobster)
langoustine : n, (북대서양산의)잔 새우
langsyne : n, (노래에서는, 종종)오래전(에)
language : n, 언어, 국어, 어법, 말, 욕, use ~ to ...에게 욕하다
language laboratory : x, 어학실습실
langue : n, (체계로서의) 언어
langue d'oc : x, 중세 남프랑스 방언(지금의 프로방스 방언에 해당)
langue d'oil : x, 중세 북프랑스 방언(지금의 프랑스 말의 모체)
languid : a, 느른한, 귀찮은, 무기력한, 불경기의
languidly : ad, 느른한, 귀찮은, 무기력한, 불경기의
languish : vi, 약해지다, 그리워하다, 고생하다, 번민하다
languishing : a, 쇠약해 가는, 번민하는, 감상적인, 계속되는, 꼬리를 끄는
languishment : n, 약해지다, 그리워하다, 고생하다
languor : n, 무기력, 우울, 시름
languorous : a, 무기력, 우울, 시름
langur : n, 랑구르(몸이 여윈 인도산 원숭이)
laniard : n, =LANYARD
laniary : n, a, 송곳니(의), 물어뜯는데 적합한
laniferous : a, (양털 모양의)털이 있는
Lanital : n, 라니탈(카세인에서 만든 인조 양모)
lank : a, 야윈, 호리호리한, (털, 풀잎 등이) 곱슬곱슬하지 않은
lanky : a, 몹시 홀쭉한
lanner : n, 래너 매(북유럽산, 늑히 매사냥용의 암매, 수컷은 lanneret)
lanolin : n, 라놀린, 양털 기름, 양모지
lansign : n, 어떤 사물을 가리키는 말, 문자, 음(등)
Lansing : n, 랜싱(미국(Michigan 주의 주도)
lansquenet : n, 용병(1617세기 경 독일 등의), 카드놀이의 일종
lantana : n, 란타나(관상용)
lantern : n, 초롱, 칸델라, 환등, (등대 꼭대기의)등화실, (채광을 위한)정탑, 환등
lanternjawed : a, 턱이긴
lantern slide : x, 슬라이드
lantern slide : n, (환등용) 슬라이드
lanthanide : n, 란탄족
lanthanum : n, 란탄(희토류 금속 원소, 기호 La)
lanuginous : a, 솜털의, 솜털이 난
LANWAIR : n, 육해공항(철도역, 버스 터미널, 항구, 공항을 유기적으로 결합한 거대 시설)
lanyard : n, (선구의) 죔줄, (수부가 주머니칼을 목에 늘이는)끈
Lao : n, 라오족, 라오말(태국 북부에서 라오스에 걸쳐 쓰이는 말, 타이어에 가까움
Laocoon : n, 라오콘(Troy의 Apollo신전 사제, 그리스군의 목마의 계략을 알아냈으므로 두 아들과 함께 Athena가 보낸 해사에 감겨 죽었음)
Laodicean : a, n, (종교, 정치에) 무관심한 (사람), 열의없는 (사람)
Laos : n, 인도지나 북서부의 공화국(수도는 Vientiane)
Laotian : n, a, (의)
Laotse : n, 노자
Laotzu : n, 노자(중국의 철학자)
lap : n, 무릎, (스커트 등의) 무릎부분, (옷의) 처진 부분, 아랫자락, 기르는 환경, (실의) 한번감기, 겹침, in Fortune's ~ 운이 좋아
lap : n, vt, 접어겹치(어지)다, 싸다, 소중히 하다, 한바퀴 돌다
lap : n, vt, 핥다, (개)죽, ~ up (남의 말이나 아첨따위를) 곧이 듣다, 기꺼이 듣다
laparo : n, 복부, 옆구리
laparoscope : n, 복강경(직접 보고 수술하기 위하여 복벽에 삽임하는 광학기계)
laparoscopy : n, 복강경 검사(법), 복강경을 쓰는 수술
laparotomy : n, 개복술
lapboard : n, 무릎에 올려 높는 테이블 대용의 평판
lap dog : x, 애완견(발바리, 스피츠, 스파니엘 따위)
lapdog : n, (무릎에 올려 놓고 귀여워하는)애완용의 작은 개
lapel : n, 접어젖힌 옷깃
lapelled : a, 접은 옷깃의, 접은 옷깃이 달린
lapful : n, vt, 무릎(앞치마)에 가득
lapidarian : a, =LAPIDARY
lapidarist : n, =LAPIDARY
lapidary : n, 보석(연마)공
lapidate : vt, 돌팔매질하다, 돌을 던져서 죽이다
lapidify : vt, vi, 돌이 되게 하다(되다), 석화하다(petrify)
lapidist : n, 보석공, 보석통
lapillus : n, 화산력
lapin : n, 토끼, 거세한 토끼, 토끼의 모피
lapis : n, 청금석, 군청(청금석에서 빼내는 안료), 군청색, 유리색(deep blue)
lapis lazuli : x, 유리
Lapland : n, Scandinavia 북부지방
Laplander : n, 라플란드 사람
Lapp : n, a, 라플란드 사람(Laplander), 라플란드 말, =LAPPISH
Lapp : n, a, (의)
lappet : n, 주름
Lappish : a, n, 라플란드(Lapland)(사람)의, 라플란드 말
lap robe : x, (차 탈때의) 무릎덮개
lapsable : a, LAPSE하기 쉬운
lapse : n, 경과, 추이, 실수, 잘못, 폐지, moral ~ 도덕상의 과오
lapse : vi, 모르는 사이에 빠지다(타락하다), 소멸하다
lapsed : a, 지나간, 없어진, 타락한, 신앙을 잃은, (관습 등이)쇠퇴한, 폐지된, (권리, 재산이)남의 손으로 넘어간, 실효한
lapstone : n, (제화공이 무릎에 끼고 가죽을 두드리는)무릎돌
lapstone : n, (제화공이 무릎에 끼고) 가죽을 두두리는 받침돌
lapstrake : a, n, (보트가)겹판으로 만든, 겹판 보트
lapsus : n, 잘못
lapsus linquae : n, 잘못 말함
lap time : x, 한 바퀴 도는 시간, 일주시간
laptop : n, (컴퓨터) 무릎에 얹어 놓을 크기의 퍼스널 컴퓨터
Laputa : n, 라퓨터 섬(비현실적인 공상에 잠긴 인간들이 사는 떠있는 섬, Swift 작)
Laputan : n, a, 라퓨터 섬 사람, 공상가, 라퓨터섬 사람의, 공상적인, 터무니없는, 불합리한(absurd)
lapwing : n, 댕기 물떼새
lapwing : n, 댕기 물떼새
larboard : n, a, 좌현(의)
larcenist : n, 절도범(사람), 도둑
larcenous : a, 절도죄
larceny : n, 절도죄, 절도 (행위)
larch : n, 낙엽송
lard : n, 돼지기름, 돼지기름을 바르다
lard : n, vt, 돼지기름, 돼지기름을바르다
lardaceous : a, 라드(모양)의, 유전분질을 함유하는, 전분양 변성의
larder : n, 식료저장실
lardhead : n, 바보, 얼간이, 멍청이
lard oil : x, 라드기름(기계, 등화용)
lardoon : n, 돼지고기나 베이컨의 가느다란 조각(살코기 사이에 끼우는)
lardy : a, 라드의, 라드질의, (돼지)기름이 많은
lardydardy : a, 야한, 뺀들뺀들한, 잘난 체하는, 아니꼬운
lares : n, 가정의 수호신
lares and penates : x, 집안의 수호신, 터주, 가보, 가재
large : a, 큰, 다수의, 관대한, 막연히, as ~ as life 실물 크기의, be ~ of limb 손발이 큰
large : n, at ~ 상세히, 충분히, 널리, 일반적으로, 막연히, in (the) ~ 대규모로
large : ad, 크게, 대대적으로, 자세히, 과대하게
largeeyed : a, (눈을 크레 뜨고)깜짝 놀란(wideeyed)
largehanded : a, 손이 큰
largehearted : a, 도량이 큰
largely : ad, 크게, 주로, 풍부하게, 아낌없이, 너그러이
largeminded : a, 도량이 큰, 관용하는, 관대한(tolerant)
largeness : n, 큰, 다수의, 관대한, 막연히
largerthanlife : a, 과장된, 실물보다 큰, 전설적인
largescale : a, 대규모의, (지도 따위의)비율이 큰
largescale integration : x, 고밀도 직접회로
largesouled : a, =LARGEHEARTED
largess(e) : n, 부조, 선물
largestatured : a, (삼림이)교목과 관목으로 이루어진
larghetto : a, ad, n, 좀 느린(느리게), 좀 느린 곡
largish : a, 좀큰, 큼직한
largo : a, ad, n, 매우 느린(느리게), 완서곡
lariat : n, vt,  =LASSO
lark : n, vt, 종다리, 희롱거리다, 농담하다
larksome : a, 장난에 마음이 쏠린, (마음이)들뜬
larkspur : n, 참제비 고깔속
larky : a, 장난치는, 까부는, 농담을 좋아하는
larn : vt, vi, ...을 공부하다, 배우다(learn), ...을 가르치다, 깨닫게 하다, 공부하다, 배우다
Larousse : n, 라루스 Pierre Athanase~(181775)(프랑스의 문법학자, 사전 편찬가)
larrigan : n, 래리건(벌목인부 등이 시는 무릎에 차는 장화)
larrikin : n, a, 깡패, 불량자, 불량 소년, 난폭한, 불량기 있는
larrup : vt, 때리다
larry : n, a, 엉터리(싸구려)상품, (사지않고)구경만 하는 손님, 바닥이 개폐되는 광차, 열등한, 이류의, 가짜의(물품)
Larry : n, 남자 이름(Laurence, Lawrence의 애칭)
larva : n, 유충, 유생
larval : a, 애벌레의, 미숙한
larvicide : n, vt, 유충을 죽이는 약제, 살충제, 살충제로 처리하다
laryng : n, 후두(larynx)
laryngeal : a, 후두(부)의, 후두 치료용의
larynges : n, LARYNX의 복수
laryngitis : n, 후두염
laryngophone : n, 목에 대는 송화기
laryngoscope : n, 후두경
laryngoscopy : n, 후두경 검사(법)
laryngotomy : n, 후두절개(술)
larynx : n, 후두
lasagna : n, 라자냐(이탈리아의 면류 요리의 일종)
lascar : n, 동인도 제도의 뱃사람
lascivious : a, 음탕한, 선정적인
lasciviously : ad, 음탕한, 선정적인
lase : vi, vt, 레이저 광선을 발하다(쬐다)
laser : n, 레이저
lash : n, 챗열, 채찍질, (파도의) 충격, 비꼼, 빈정댐, 비난, 속눈섭
lash : vt, vi, 채찍질하다, (바람, 파도가) 부딪치다, 빈정대다, 세차게 움직이다, 흔들다, 묶다, ~ out (말이) 걷어차다
lashed : a, 속눈썹이 있는, 속눈썹이 ...한
lashing : n, 채찍질, 질책, 묶음, 밧줄
lashless : a, 속눈썹이 없는
lashup : n, (다급한) 임시변통
Laski : n, 래스키(18931950)(영국의 사회주의자, 경제학자, 저술가)
Lasparaginase : n, 엘 아스라파기나아제(백혈병 치료용 효소)
lasque : a, 얇고 모양이 좋지 않은
lass : n, 젊은 여자, 소녀, 애인
lassie : n, 계집애, 소녀
lassie : n, 소녀, 애인
lassitude : n, 나른함, 권태, 피로, 마음이 안 내킴
lassitude : n, 무기력, 느른함
lasso : n, 던지는 올가미, 올가미 바(끝이 고리로 된 긴 밧줄)
lasso : n, vt, (던지다) 올가미(로 잡다)
last : a, 최후의, 지난번의, 최근의, 결코 ...할 것 같지 않은, 최상의, for the ~ time 그것을 마지막으로
last : ad, 최후에(로), 오전, 지난 번, 최근, ~ but not least 마지막으로 중요한 것을 말하지만, ~ of all 마지막으로
last : n, 최후, 죽음, 최후(최근)의 것, at ~ 드디어, 결국, at long ~ 간신히, till(to)the ~ 최후까지
last : vt, vi, 지속하다, 계속되다, (상하지 않고) 견뎌내다, 오래가다, ~ out 지탱(유지)하다
last : n, 지속력, 끈기
last : a, ad, n, 구두 골, stick to one's ~ 본분을 지키다, 쓸데 없는 일에 참견하지 않다
lastditch : a, 최후까지 버티는, 막판에 다다른, 사력을 다한, 필사적인, 완강한
Lastex : n, 고무와 면의 혼방 섬유
lastly : ad, 최후에(로)
lastmentioned : n, 맨 마지막으로 든(말한), (대명사적)맨 마지막으로 든 것
lastminute : a, 막바지에서의
last name : x, 성
Las Vegas : x, 미국 nevada주 동남부의 도시(도박으로 유명)
lat : n, 라트(Lstvia의 옛 화폐단위, =100santimi), 1라트 은화
Latakia : n, 라타키아(터키산의 고급 담배)
latch : n, vt, 고리쇠, on the ~ (자물쇠를 채우지 않고) 걸쇠만 걸고, ~ on to ...에 꼭 달라 붙다, ...을 손에 넣다
latcheron : n, (치른치른 들러붙어)떨어지지 않는 사람
latchet : n, 구두끈
latchkey : n, 걸쇠의 열쇠
latchkey child : x, 맞벌이 부부의 아이(열세를 가지고 밖에서 놀므로)
latchstring : n, vt, (밖에서 잡아당겨)빗장을 벗기는 끈, 환대, ...에게 집에 자유로이 출입하는 것을 허락하다(허락하지 않다)
late : a, 늦은, 더딘, 요전의, 지난번의, 작고한, 고, keep ~ hours 밤 늦게 자고 아침 늦게 일어나다, of ~ (years) 요즈음, 근년
late : a, ad, 늦게, 뒤늦게, 저물어, 밤늦도록, 최근, Better ~ than never, 늦을망정 안 하느니보다 낫다, early and ~ 아침부터 밤가지
lateblooming : a, 늦게 피는, 늦게 번창하는, 만성형의
latecomer : n, 지참자, 지각자, 최근에 온 사람(물건), 신참자
lateen : a, 큰 삼각돛의 (배)
lateenrigged : a, 큰 삼각 돛이 있는
lately : ad, 요즈음
latemodel : a, 신형의
laten : vt, vi, 늦게 하다(되다)
latency : n, 숨어 있음, 보이지 않음, 잠복, 잠재
lateness : n, 늦은, 요전의, 작고한, 저물어, 밤늦도록
latenight : a, 심야의, 심야 영업의
latent : a, 숨어 있는, 보이지 않는, 잠복성(기)
latent : a, 숨은, 보이지 않는, ~ period (병의) 잠복기
latently : ad, 숨은, 보이지 않는
lateonset : a, 늦게 발생하는, 후발성의, 고령에 발생하는
later : a, 더 늦은, 더 이후의
later : ad, 나중에, ~ on 나중에, 추후에
lateral : a, 옆의, 옆으로의, 옆으로부터의, 측면의
lateral : a, 옆의, 가로의 옆쪽, 측면부, 가로장, 측음 = pass 래터럴 패스(골라인과 평행으로 패스하기)
laterality : n, 좌우차, 편측성(대뇌, 손 등 좌우 한쌍 기관의 좌우의 기능 분화)
Lateran : n, (로마의) 라테란 성당, (그옆의) 라테란궁
laterday : a, =LATTERDAY
laterite : n, 라테라이트
lateritic : a, 
laterization : n, 라테라이트화(작용)
latest : a, 최근의, at (the) ~ 늦어도
latex : n, (고무나무 따위의) 유액
lath : n, 욋가지, as thin as a ~ 말라빠져
lathe : n, 선반
lather : n, 외 만드는 사람
lather : n, vi, vt, 비누거품(을 칠하다), 땀투성이가 되다
lathery : a, 비누 거품의(같은), 거품이 인, 거품투성이의, 공허한
lathi : n, 나무(대나무)곤봉
lathing : n, 외(얽기)
lathorn : n, =LANTERN
lathy : a, 외같은, 말라빠진, 가늘고 긴
latices : n, LATEX의 복수
laticiferous : a, 유액(latex)을 함유하는
latifundism : n, 대토지 소유
latifundium : n, (부재 자본가가 노예를 써서 경영한)광대한 소유지
latimeria : n, 라티메리아(화석어)
Latin : a, 라틴어(계통)의, Latium(사람)의, 로마 카톨릭교의
Latin : n, 라틴어, Latium(고대 로마)사람, late ~ 23 세기의 라틴어
Latin America : x, 라틴아메리카(중남미, 멕시코, 선인도 제도 등)
LatinAmerican : a, 라틴 아메리카(사람)의
Latinate : a, 라틴말의, 라틴말에서 파생된, 라틴말과 유사한
Latin Church : x, (카톨릭의)라틴교회
Latin cross : x, 세로대의 아래쪽이 긴 보통의 십자가
Latinism : n, 라틴어풍(법)
Latinist : n, 라틴어 학자
Latinity : n, 라틴어 사용, 라틴 말투(어법)
Latinize : vt, vi, 라틴어로 번역하다
Latino : n, 미국의 라틴 아메리카계 주민
Latin Quarter : x, (파리의) 라틴구(학생, 예술가가 많이 삶)
Latin Rite : x, 로마 방식의 교회 의식
Latin square : x, 라틴 방진(n 종류의 기호를 n x n의 정방형으로 중복되지 않게 배열한 것)
latish : a, ad, 좀늦은
latitude : n, 위도, 지대, 지역, (활동) 범위, (행동, 해석의) 자유, 관용도, cold ~s 한지, 한대지방, out of one's ~ 격에 맞지 않게
latitudinal : a, 위도의
latitudinarian : a, n, (신앙, 사상 등이) 옹졸하지 않은, 자유로운, (신조, 예배, 형식 따위에 대한) 자유주의자
latitudinarianism : n, (종교상의) 자유주의
Latium : n, 이탈리아의 옛나라(로마의 남동쪽)
latosol : n, 라토졸(열대에서 생성되는 적황색 토양)
latria : n, 라트리아(하느님에게만 바치는 최고의 예배(흠숭))
latrine : n, (공장, 병사 등의) 변소
latten : n, (교회용 기구로 많이 쓰던)황동 합금판, 함석판(일반적으로)엷은 금속판
latter : a, 후자의, 뒤의, 끝의, 근자의, in these ~ days 요즈음은, one's ~ end 죽음
latterday : a, 근래의
Latterday Saint : x, 모르몬 교도
latterly : ad, 요즈음
lattermost : a, 최후의, 최신의
latterwit : n, 뒷생각(기회를 놓친 다음 일어나는 생각)
lattice : n, vt, (창문의) 격자(를 붙이다), (원자로 속 핵물질의) 격자형 배열
latticed : a, 격자를 붙인
latticework : n, 격자(만들기, 세공)
latticing : n, 격자 만들기(세공)
Latvia : n, 라트비아(발트해 동안의 소련의 한 지방)
Latvian : n, a, 라트비아의, 라트비아 사람
lauan : n, 나왕
laud : n, vt, 찬미, 칭송하다, 찬가, 첫기도
laudable : a, 칭찬할 만한
laudably : ad, 찬미, 칭송하다, 찬가, 첫기도
laudanum : n, 아편정기
laudation : n, 칭찬, 찬미
laudation : n, 칭찬, 찬미
laudative : a, =LAUDATORY
laudatory : a, 칭찬의
laugh : n, 웃음(소리), get(have)the ~ of ...을 (도리어) 되웃어 주다, have the ~ on one's side (이번에는) 이쪽이 웃을 차례가 되다
laugh : vi, (소리내어) 웃다, 흥겨워하다, 조모하다
laugh : vt, 웃으며 ...하다, ~ down 웃어대다 중지침묵, 시키다, ~ in a person's face 아무를 맞대놓고 조롱하다, ~ off 웃음으로 얼버무리다
laughable : a, 우스운, 어리석은
laughably : n, (소리내어) 웃다, 흥겨워하다
laughing : a, 웃는, 기쁜듯한, 우스운, 웃을(It is no ~ matter)
laughingstock : n, 웃음거리
laughmaker : n, 희극 작가(탤런트), 코미디언
laughter : n, 웃음, 웃음소리
launce : n, =SAND LANCE
launch : vt, 진수시키다, (보트를) 물에 띄우다, (아무를 세상에) 내보내다, 발사하다
launch : vi, 배를 타고 나아가다, 시작하다
launch : n, 진수, 기정
launch complex : x, 발사시설
launcher : n, (유도탄 등의) 발사대(장치)
launching site : x, 발사기지
launching ways : x, 진수대
launch pad : x, 미사일발사대
launch vehicle : x, (인공위성, 우주선의)발사로켓
launch window : n, (우주선 따위의) 발사시간대
launder : vt, vi, 세탁하다, 다림질하다
launderette : n, 세탁기 세 놓는 집
laundress : n, 세탁부
laundromat : n, 세탁기 세 놓는 집
laundry : n, 세탁장(물), 세탁소
laundryman : n, 세탁업자, 세탁소 종업원
laundrywoman : n, = LAUNDRESS
laura : n, 라우라, 독거 수도원, 라우라(현대의 대수도원)
Laura : n, 여자 이름
Laurasia : n, 로라시아 대륙(지금의 북미 대륙과 유라시아로 형성되는 초대륙, 고생대 말기에 분리한 것으로 보고 있음)
laureate : a, (영예의) 월계관을 쓴 poet
laureate : n, 계관시인
laureateship : n, 계관시인의 지위(임기)
laurel : a, n, 월계관, 명예, 승리, look to one's ~s 명예를 잃지 않도록 조심하다, rest on one's ~s 소성에 만족하다
laurel(l)ed : a, 월계관을 쓴, 영예를 짊어진
Laurence : n, 남자 이름
Lauretta : n, 여자 이름(Laura의 애칭)
Laurie : n, 남자 이름(Laurence, Lawrence의 애칭), 여자 이름(Laura의 애칭)
laurustinus : n, (남유럽산)인동과의 상록관목
Lausanne : n, 로잔(스위스 서부, 제네바 호반의 도시)
Lautrec : n, =TOULOUSELAUTREC
lav : n, =LAVATORY
lava : n, 용암
lava bed : x, 용암층
lavabo : n, (미사의) 손씻는 예식(때에 염하는 암송구), 손 씻는 그릇
lavage : n, (위, 장 따위의) 세척
lavalava : n, 라발라바(Samoa섬 및 남양제도의 원주민이 착용하는 사라사로 만든 허리 두르개)
lavalier(e) : n, (가는 사슬로 거는) 목걸이
lavation : n, 씻기, 세정(washing), 세정수
lavatory : n, 세면소, 세면대
lave : vt, vi, 씻다, (물에)담그다, (시내가 기슭을)씻다, (액체를)붓다, 따르다, 미역감다(bathe)
lavender : n, 라벤더(향수, 제충 원료), 연보라색(의)
lavender water : x, 라벤더향수
laver : n, 김, 해태
laverock : n, 종다리(lark)
Lavinia : n, 여자 이름
lavish : vt, 아낌없이주다, 낭비하다
lavish : a, 손이 큰, 낭비적인, 풍부한
lavisher : n, 아낌없이 주다, 손이 큰, 낭비적인, 풍부한
lavishly : ad, 아낌없이 주다, 손이 큰, 낭비적인, 풍부한
lavishment : n, 아낌없이 주다, 손이 큰, 낭비적인, 풍부한
lavishness : n, 아낌없이 주다, 손이 큰, 낭비적인, 풍부한
lavity : n, 경솔
Lavoisier : n, 라부아지에 Antoine Laurent ~(174394)(프랑스의 화학자, 근대 화학의 아버지)
law : n, 법, 규칙, 소송, 법학, be a ~(un) to oneself 관습(등)을 무시하다, give the ~ to ...을 마음대로 부리다
lawabiding : a, 법률을 지키는
lawandorder : a, 법과 질서를 지키게 하는 (존중하는), 준엄한
lawbreaker : n, a, 법률 위반자, 위반(의)
lawbreaking : n, 법률 위반
law court : x, 법정
lawful : a, 합법(적법)의, 정당한, 법정의
lawfully : ad, 합법의, 정당한, 법정의
lawfulness : n, 합법의, 정당한, 법정의
lawgiver : n, 입법자
lawgiving : n, a, 입법(의), 법률 제정(의)
lawhand : n, 공문서체, 법률문서체
lawks : int, 이런, 젠장, 이크, 큰일 났군
lawless : a, 법률없는, 무법의, (감정, 욕망 등을) 누를 수 없는
lawmaker : n, 입법자
lawmaking : n, a, 입법(의)
lawman : n, 경관, 보안관
law merchant : x, 상법
lawn : n, 잔디(밭)
lawn : n, 론(한랭사 비슷한 얇은 아마포(무명), 영국국교의 bishop의 소매로 쓰임), bishop의 직(직위)
lawn mower : x, 잔디 깍는 기계
lawn school : x, 법학부, 법과대학
lawn sleeves : x, bishop(의 소매)
lawnsuit : n, 소송, 고소
lawn swing : x, (유아용) 마주보기 그네
lawn tennis : x, 론 테니스
lawny : a, 잔디(밭)
law officer : x, 법무관
Lawrence : x 영국의 소설가, 시인
lawrencium : n 로렌슘(인공 방사성 원소의 하나, 기호 Lr)
lawsuit : n, (민사)소송(사건)
lawterm : n, 법률용어, 재판개정기
lawyer : n 법률가, 변호사
lax : a 느슨한, 느즈러진, 모호한, 단정치 못한
laxation : n, 느슨해짐, 방종, 완만, 변통
laxative : a, n, 대변이 나오게 하는
laxity : n, 느슨한, 모호한, 단정치 못한
lay : vt, 놓다, 가로(뉘어)놓다, 고정시키다, 바르다, (식탁을) 차리다, (무거운 짐, 세금, 책임을) 지우다, 과하다, 넘어뜨리다
lay : vi, 알을 낳다, 내기하다, 전력하다, ~ about 맹렬히 강타하다, ~ aside(away, by)떼어 두다, ~ at ...에 덤벼들다, ~ up 저장하다
lay : n, 위치, 지형, 상태, 직업, 일, (밧줄의) 꼬인자리
lay : a, 속인의, 평신도의, 전문가 아닌
lay : n, 노래, 민요, (새의) 지저귐
lay : v, lie의 과거
layabout : n, 부랑자
layaway : n, 예약 월부 상품(월부금이 완납되면 인도함) ~ plan 예약 월부제
layby : n, (도로, 운하의) 넓어진 부분, buy on the ~ 월부 예약제로 사다
laydown : n, (브리지에서)패를 펴 보여도 승리가 확실한 끗수, 실패
layer : n, 놓는 사람, 층
layer cake : x, 켜 사이에 크림 따위를 넣은 과자
layered : a, 층이 있는, 층을 이룬
layering : n, (모양, 색체적인 효과를 노려)껴입기, (지형의)단채식
layette : n, 갓난이 용품(배내옷, 침구 등의 일습)
lay figure : x, 모델인형, 하찮은사람
lay figure : x, 모델 인형, 인체 모형, 하찮은 사람
laying : n, 쌓음, (가스 등을)끌어 댐, 부설, 애벌칠, (실이나 새끼를)꼬는 법, 조준, 한 배에 깐 알
layman : n, 속인
layoff : n, 일시적 해고(휴직, 귀휴)(기간), (활동 등의) 휴지기간
layout : n, 설계, 지면배치, (도구 등의) 한벌
layover : n, 여행중단
layperson : n, a, (성직자에 대하여)일반 신도, 편신도, 속인, (전문가에 대하여)아마추어, 문외한
layshaft : n, 부축, 측축(secondary shaft)
laystall : n, 쓰레기 버리는 곳, 쓰레기장
layup : n, (잠시) 쉼, 바스켓 바로 밑에서 한 손으로 하는 점프슛
laywoman : n, LAYMAN의 여성형
lazar : n, 병든 거지(특히 나병의)
lazaret(te) : n, 병든 거지(특히 나병의)
lazaretto : n, 나병원, 격리 병원, (선미의) 식료품실
Lazarus : n, 나사로(한사람은 이적에 의하여 죽음에 부활한 예수의 친구, 한사람은 승천한 거지)
laze : vi, 게으름 피우다
lazily : ad, 게으른, 느린
laziness : n, 게으른, 느린
lazuli : n, LAPIS LAZULI
lazy : a, 게으른, 느린
lazybones : n, 게으름뱅이
Lazy Susan : x, (식탁 중앙의) 회전 쟁반
lazzarone : n, 부랑자, 거지
lea : n, 풀밭, 초원
leach : vt, vi, 거르다, 걸러내다(나오다)
leach : n, 여과(기), 잿물
leachate : n, 거른 액체, 삼출액
leachy : a, 다공질의(흙 따위)
lead : n, 납, 납제품, (연필의) 심, 측연, 함석 지붕, heave the ~ 수심을 재다
lead : vt, 납을 씌우다(채워 매우다), 인데르를 채우다
lead : vt, 인도(안내)하다, 거느리다, 꾀다, 지내다, (생활, 일상을) 보내다
lead : vi, 안내하다, (길이) 통하다, 솔선하다, ~ away 데리고 가다, ~ by the nose 맹종시키다, ~ off 시작하다, ~ on 꾀다
lead : n, 선도, 솔선, 지휘, 지침, 조언, 우세, (물을 끌어들이는) 도량, 도선, 광맥, follow the ~ of ...의 예에 따르다
leaded : a, (특히 휘발유에)납을 첨가한, 납 중독에 걸린
leaden : a, 납의, 답답한, 무딘
leaden : a, 납의, 납으로 만든, 납빛의, 답답한, 뻐근한, 나른한, 무기력한, 활발치 못한, 무가치한
leadeneyed : a, 거슴츠레한 눈을, 눈이 흐리터분한
leadenhearted : a, 무정한, 무기력한
leader : n, 지도자, 주장, 유도심문, 지휘자
leaderette : n, 짧은 사설
leaderless : a, 지도자(통솔자)가 없는
leadership : n, 지도자, 주장, 유도심문, 지휘자
leadfree : a, (휘발유가)무연의
leadin : n, a, 도입선, 끌어들이는(커머셜(광고의 말)을 이끄는)
leading : n, 지도, 지표, 통솔(력)
leading : a, 이끄는, 지휘하는, 주역의, 주요한, 훌륭한, 세력있는
leading article : x, 사설
leading case : x, 선례가 되는 판결례
leading lady : x, 주연여우
leading part : x, 주역
leading question : x, 유도심문
leading rein : x, (말 따위의) 끄는 줄
leading strings : x, (아기의 거름마 연습용) 끈, 지도, in ~ 혼자 걷지 못하고
leadless : a, (휘발유가)무연의, 탄환을 장전하지 않은
lead nitrate : x, 질산염
leadoff : n, 개시, 착수, 일번(선두)타자
lead oxide : x, 산화연
lead pencil : x, (흑심의 보통) 연필
lead poisoning : x, 납중독, 연독
lead poisoning : x, 연독, 납중독
leadsman : n, 측연수
lead swinger : x, 꾀쟁이, 게으름뱅이(측연 작업을 하는 체하는)
leadswinger : n, 꾀병쟁이, 게으름뱅이
leadswinging : n, 꾀병을 부리기, 게으름 피우기
lead time : x, 기획에서 생산까지의 시간, 발주에서 배달까지의 시간, 발주에서 배달까지의 시간
lead wool : x, 연모(파이프 접합용)
leadwork : n, 납을 다루는 일(배관, 유리 끼우기 등), 납세공, 납제품, (수도관 등의)납용제, 납제련소
leaf : n, (한장의, 또는 집합적으로) 잎(사귀), (책 따위의 종이) 한장, 꽃잎, 얇은 판자, 박, (경첩 따위의) 한장, come into ~ 잎이 나오다
leaf : vi, 잎이 나오다
leaf : vt, (급히 책) 페이지를 넘기다
leafage : n, 잎
leaf bud : x, 잎눈
leafed : a, 잎이 있는(난, 달린)
leafhopper : n, 매미충, 멸구
leafiness : n, 잎의 무성한(상태)
leafless : a, 잎 없는
leaflet : n, 작은 잎, 광고지 삐라
leafleteer : n, 광고 문안 작성자, 광고 삐라 돌리는 사람
leaf mold : x, 부엽토
leafraking : n, (실업자에게 일자리를 주기 위한, 본래는 필요없는)헛일, 군일, 무익한 일
leafstalk : n, 잎, 꼭지 엽병
leafy : a, 잎이 많은(무성한)
league : n, 동맹, 연맹, 리그, 맹약, 신성 동맹, in ~ with ...와 맺어
league : vi, vt, 동맹(연맹)하다(시키다)
league : n, 리그(거리의 단위)
league match : x, 리그전
leaguer : n, 동맹국
Leah : n, 여자 이름, 레아(야곱의 첫번째 아내)
leak : n, 샘, 새는 곳(구멍), 누전, spring(start)a ~ 새는 곳(구멍)이 생기다, 새기 시작하다
leak : vi, vt, 새(어 나오)다, 새는 구멍이 있다
leakage : n, 누출, 누설, 드러남
leakiness : n, 
leakproof : a, 새지 않는, 기밀 누설 방지의, 비밀을 지킬 수 있는
leaky : a, 새는 구멍 있는, 새기 쉬운, 오줌을 지리는, 비밀을 지킬 수 없는(He si a ~ vessel 그 친구에게 말하면 곧장 새어 버린다)
leal : a, 충실(성실, 진실)한
lean : a, 야윈, 살코기의, 지방 없는, (식사, 영양가, 강의 따위가) 빈약한, 수확이 적은
lean : n, 살코기, 야윈(가는)부분
lean : vi, 기대다, 기울다, 굽다, 의지하다, ...의 경향이 있다
lean : vt, 기대게 하다, 기울이다, 구부리다, ~ back 뒤로 젖혀지다, ~over backward 지금까지와는 반대(의 태도)로 나오다, ~toward mercy 조금 자비심을
lean : n, 기욺, 경사
leander : n, 남자 이름
leaner : n, 기대는 사람(것), (남에게)의지하는 사람
leaning : n, 경사, 경향, 기호
leanness : n, (사람, 동물, 토지 등이)야위어 있음, 야윈 상태, (고기 등에)지방이 없음, (내용 등의)빈약함, 모자람, 수지가 맞지 않음
leant : v, lean의 과거(분사)
leanto : n, 의지간, 달개지붕
leap : vi, 뛰다, 도약하다, 약동하다
leap : vt, 뛰어 넘(게 하)다, ~ to the eye 곧 눈에 띄다
leap : n, (한번) 뛰기, 그 거리, by ~s and bounds 급속히, 일사천리로, a ~ in the dark 난폭(무모)한 행동
leapfrog : vi, n, 개구리 뜀(을 하다)
leapfroging : n, 개구리뜀
leapt : v, leap의 과거(분사)
leap year : x, 윤년
learn : vt, vi, 배우다, 익히다, 외다, ~ by heart(rote)암기하다
learned : a, 학식 있는, 학구적인, 학자의, the ~ 학자들
learner : n, 배우다, 외다, 가르치다, 학문
learnerdriver : n, 가면허 운전자
learning : n, 학문, 박식, man of ~ing 학식 있는 사람
learningdisabled : a, 학습 불능(증)의
learnt : v, learn의 과거(분사)
lease : vt, 임대(임차)하다, 빌리다, ~d territory 조차지
lease : n, (토지, 건물의)임대차 계약서(권, 기간)by ~ 임대로, take amew ~ of life 수명이 늘다
leaseback : n, 임대차 계약부 매각, 매각차용(매각하고 임차하는 것)
leasehold(er) : n, 차지(인)
leaselend : n, v, =LENDLEASE
leash : n, vt, (개 따위를 매는) 가죽끈, (개, 토끼, 여우, 사슴 따위의) 세마리, hold in ~ 속박(지배)하다
leash : vt, 가죽끈으로 매다
leasing : n, 거짓말(을)함
least : n, a, 최소(의), at (the) ~ 적어도, 하다못해, not in the ~ 조금도 ...않다, the ~ common multiple 최소 공배수
least : ad, 가장적게, ~ of all 가장 ... 않다
leastways : ad, 최소의, 가장적게
leastwise : ad, 최소의, 가장적게
leat : n, (물방아등에 물을 대는)수로(도량)
leather : n, (무두질한) 가죽, 가죽제품, ~ and prunella 비슷비슷한 치들
leather : vt, 가죽을 씌우다(대다), 가죽 끈으로 때리다
leatherback : n, 장수거북(거북 무리 중 가장 큼)
leatherbound : n, 재생피, 모조 가죽(상표명), 가죽처럼 만든 종이
leather dresser : x, 무두장이
Leatherette : n, 인조피혁
leatherhard : a, (점토가)소성이 없는
leatherhead : n, 바보, 멍청이
leatherheaded : a, 
leatherjacket : n, 경피 어류, 각다귀의 애벌레
leatherlunged : a, 큰소리로(장시간)떠 들수 있는
leathern : a, 가죽(제)의
leatherneck : n, 해병대원
Leatheroid : n, 인조 가죽
leatherware : n, 피제품
leatherwood : n, 팥꽃나무과의 관목(미국산)
leathery : a, 가죽, 가죽제품
leave : vt, 남기다, 놓고가다, 둔채 잊다, (유산을) 남기다, ...인 채로 두다, 맡기다
leave : vi, 떠나다, 출발하다, be nicely left 속다, get left 버림 받다, ~ behind (뒤에) 남기다, ~ hold of (잡은 것을) 놓아 버리다, ~ over 남기다
leave : n, 허가, 휴가(기간), 작별, by your ~ 실례입니다만, on ~ 휴가로, take one's ~ of ...에게 작별인사를 하다, without ~ 무단히
leave : vi, 잎이 나오다
leaved : a, 잎이 있는, 잎이 (...개)인, (문짝 등)...장의
leavelooker : n, (시의)시장 감시원
leaven : n, 효모, 누룩, the old ~ 구폐
leaven : vt, 발효시키다, 영향을 주다
leavening : n, 발효시키기, 효모, 발효소, 감화, 영향
leaver : n, 떠나는(버리는)사람
leaves : n, pl, LEAF의 복수, 블루진
leavetaking : n, 작별, 고별
leavetaking : n, 작별, 고별
leaving : n, 잔물, 쓰레기, 찌꺼기(refuse)
leavings : n, 남은 것, 찌꺼기
Lebanese : a, n, 레바논(사람)의, 레바논 사람
Lebanon : n, 레바논(공화국)
Lebensraum : n, 생활권(독일 나치스의 이념이었던), (일반적인 개념의)생활권(living space)
Lebensraum : n, 생활권(국민 생활에 필요한 영토, 나치 독일의 지정학용어)
Leboyer : a, 르브와이에 분만방식의, 태아보호 분만법의
lech : n, vi, 정욕, 호색, 호색가(남자), 호색하다
lecher : n, 호색가
lecherous : a, 음탕한
lechery : n, 호색, 음란
lecithin : n, 레시틴(생물의 세포조직, 난황에 포함된 지방 비슷한 화합물)
lectern : n, (교회의) 성서대
lection : n, (교회에서 낭독되는)성구
lectionary : n, (교회에서 읽는)성구집
lector : n, 성구를 읽는 사람, (주로 유럽 대학의)강사
lecture : n, vi, vt, 강의(하다), 훈계(하다)
lecture hall : x, 강당
lecturer : n, 강사, 강연자
lectureship : n, 강사직(의 지위)
led : v, a, LEAD의 과거, 과거 분사, 지도(지배)되는, 이끌리는
LED : x, Light Emitting Diode 발광 소자(컴퓨터, 전자 시계 등에 씀)
Leda : n, 레다(Zeus가 백조의 모습을 하여 사랑을 나누었던)
Leden jar : x, 라이든 병(마찰 전기 축전기)
lederhosen : n, 무릎까지 오는 가죽 바지
ledge : n, 좁은선반, (해안부근의) 암초, 광맥
ledgement : n, 돌림띠쇠시리
ledger : n, 원장, (무덤의) 대석
ledger line : x, 덧줄
lee : n, a, 바람이 불어가는 방향(의), 바람을 등진 쪽(의), 보호, 비호
lee : n, (술 종류의) 찌끼, 앙금
leeboard : n, 측판(바람 불어가는 쪽으로 밀리지 않게 범선 중앙부 양현에 붙인 널)
leech : n, 거머리(특히 의료용의), 흡혈귀, 고리 대금업자, 의사
leech : n, (돛의) 세로의 가장자리
leek : n, 부추
leekgreen : a, 푸르무레한 초록색의
leer : n, vi, vt, 추파(를 던지다), 곁눈질(하다), 짓궂은 눈매(를 하다)
leering : a, 곁눈질하는, 심술궂게 보이는 눈초리의
leery : a, 곁눈질하는, 교활한, 의심이 많은
lees : n, pl, (술, 포도주 등의)재강, 지게미
lee shore : x, 바람 불어가는 쪽의 해안
leet : n, 영주의 재판소(의 관할 수역)
leeward : n, a, ad, 바람이 불어가는 쪽(의, 으로)
leeward Islands : x, 리워드 제도(서인도제도 중의 영령제도)
leeway : n, 풍압, 시간의여유, 활동의여지, make up ~ 뒤진 것을 만회하다
left : a, 좌(측)의, 왼쪽의, 좌익의, marry with the ~ hand 지체 낮은 여자와 결혼하다
left : ad, 왼쪽에, Eycs ~! 좌로 나란히! L turn! 좌향좌
left : n, 왼쪽, 좌익, 좌파, 혁신파, over the ~ 거꾸로 말하면
left : v, leave의 과거(분사)
Left Bank : x, (파리의 센 강의) 좌안(화가가 많이 삶), 자유 분방한 사람들이 사는 고장
leftbrain : n, 뇌의 좌반구
leftending : a, (정치적으로)좌경의(leftleaning)
left field : x, 좌익
left fielder : n, 좌익수
leftfooted : a, 왼발잡이의, 서투른
lefthand : a, 왼손의, 왼쪽의
lefthanded : a, 왼손잡이의, 왼손으로 한, 왼손용의, 서투른, 음험한
lefthander : n, 왼손잡이, 왼손잡이 투수, 왼손의 타격, 불의의 공격
leftie : n, =LEFTY
leftish : a, 좌익적인
leftism : n, 좌익주의(사상)
leftist : a, n, 좌익의 (사람), 좌파(의)
leftjustify : vt, ...을 좌측으로 가지런히 하다
leftlaid : a, (밧줄이)왼쪽으로 꼬인
leftleaning : a, (정치적으로)좌경의
leftluggage : n, (역의 임시 보관소 등에)맡겨 둔 수하물
leftmost : a, 가장 왼편의, 극좌의
leftofcenter : a, (정당 등이)급진(혁신)지지의, =LEFTWING
leftoff : a, 내버린, 그만둔, 벗어버린, 쓸데없는
leftover : a, n, 나머지(의), 남은 것
leftward : a, ad, 왼쪽 방향(에)의, 왼쪽에
leftwards : ad, =LEFTWARD
left wing : x, 좌익, 좌파, 혁신파
leftwing : a, 좌익의, 좌파의
leftwinger : n, 좌파(좌익)의 사람
lefty : n, 왼손잡이, 왼손잡이 투수
leg : n, vi, 다리(부분), 지주, 버팀대, (옷)자락, (갈짓자로 나아가는 범선의) 한 진행 구간(거리), feel(find)one's ~s (갓난아이가) 걸을 수 있게 되다
leg : n, vi, 걷다, 달리다, ~ it 걷다, 달리다
legacy : n, 유산, 전승물
legal : a, 법률(상)의, 합법적인
legal aid : x, 법률구조
legal holiday : x, 법정휴일
legalism : n, (극단적인) 법률 존중주의, 형식주의
legalist : n, 법률의, 합법적인
legality : n, 적법성, 법률준수
legalization : n, 합법으로 인정하다, 공인하다
legalize : vt, 합법으로 인정하다, 공인하다
legally : ad, 법률의, 합법적인
legal person : x, 법인
legal reserve : x, 법정준비금
legal tender : x, 법화
leg art : x, 여성의 각선미 강조 사진
legate : n, 로마교황사절
legatee : n, 유산 수취인
legation : n, 공사관, 공사관원
leg bail : x, 탈주
leg bail : x, 탈주
legend : n, 전설, 성도전, (화폐, 메달 등의) 명, (도표 등의) 설명문, 일러두기
legendary : a, 전설의, 전설적인
legerdemain : n, 요술, 속임수
legging : n, 각반
leg guard : x, 정강이 받이
leggy : a, 미끈한, 다리가 가늘고 긴
leghorn : n, 맥고모자의 일종
leghorn : n, 레그혼(닭)
legible : a, 읽을 수 있는, 읽기쉬운, 명백한
legibleness : n, 읽을 수 있는, 읽기쉬운, 명백한
legiblility : n, 읽을 수 있는, 읽기쉬운, 명백한
legibly : ad, 읽을 수 있는, 읽기쉬운, 명백한
legion : n, (고대 로마의)군단
legionary : n, a, 군단의 (병사)
legionnaire : n, 군단의 병사
legiron : n, 족쇄
legislate : vi, vt, 법률을 정하다
legislation : n, 입법
legislative : a, 입법의
legislator : n, 입법자
legislature : n, 입법부
legist : n, 법률에 정통한 사람
legitimacy : n, 합법, 정당, 적출
legitimate : a, 합법(적법)의, 정당한, 적출의, 논리적인, ~ drama(stage)(소극 등에 대하여) 정극
legitimately : ad, 합법, 정당한, 논리적인
legitimation : n, 합법화, 정당화, 적출로 인정하기
legitimatize : vt, =LEGITMATE
legitimism : n, 정통주의
legitimist : n, 정통주의
legitimization : n, =LEGITMATION
legitimize : vt, =LEGITIMATE
legman : n, 취재 기자, 외무 사원, 외근원
legopmutton : a, 양다리모양의
legpull : n, 골탕먹이기, 못된 장난
legrest : n, (환자용)발받침
legroom : n, (극장, 자동차 등의 좌석옆의)다리를 뻗는(발치의)공간
leg show : x, (각선미를 보이는) 레그쇼
legume : n, 콩과식물
legumin : n, 레구민(콩과 식물의 씨 속의 단백질)
leguminous : a, 콩이 나는, 콩과의
legwork : n, 취재 활동, 돌아다님
lehua : n, 레후아(다홍색 꽃이 피는 상록수, 하와이 제도산)
lei : n, 레이, 하와이 사람이 목에 거는 화환
Leica : n, 라이카(독일제 카메라 이름)
Leicester : n, 잉글랜드 북부지방
Leicestershire : n, 레스터셔(잉글랜드 중부의 주)
Leiden : n, 라이덴(네덜란드 남서부의 도시)
Leigh : n, 남자 이름
Leila : n, 여자 이름
Leipzig : n, 라이프치히(동독 남부의 도시)
leister : n, vt, (물고기를 찌르는)작살, 작살로 찌르다
leisure : n, 여가, 안일, at ~ 한가하여, 천천히
leisured : a, 한가한
leisurely : ad, 한가하게, 여유있게
leisuretime : a, 여가의
leisurewear : n, (집합적)레저웨어(여가를 즐길 때 입는 옷)
Leit : x, Leitrim(아일랜드의 주)
lek : n, 렉(알바니아의 화폐단위)
lekvar : n, 파이에 넣는 자두 잼
LEM : n, 달 착륙(탐사)선
leman : n, 연인, 애인, 정부
lemma : n, 보조 정리, 부 명제, 테마, 주제, (사전 등의)표제어(headword)
lemming : n, 나그네쥐
lemon : n, a, 레몬(나무, 열매), 레몬 빛(의), 레몬이 든
lemonade : n, 레몬수
lemon drop : x, 레몬캔디
lemon squeezer : x, 레몬 짜는 기구
lemony : a, 레몬 맛이(향기가)있는
lempira : n, 렘피라(Hounuras의 화폐 단위, 기호 L, =100 centavos)
Lemuel : n, 남자 이름
lemur : n, 여우원숭이
lemures : n, (고대 로마의)원혼, 원귀
lemuroid : a, n, 여우원숭이의(같은), =LEMUR
Lena : n, 여자 이름(Helena, Magdalene의 애칭), 레나강(시베리아 중동부의 강)
lend : vt, 빌려주다, (효과 따위를) 증대시키다, 더하다, ~ itself(oneself)to ...의 소용에 닿다
lender : n, 빌려 주는 사람, 대주, 돈놀이꾼, 고리 대금 업자
lending : n, 대여(물), 빌어 입은 옷
lendlease : n, vt, 무기 대여, 무기 대여법에 따라 대여하다
lendlease : n, (무기)대여
lendlease : vt, (무기, 물자를)대여하다
LendLease Act : x, 무기 대여법(1941년 제정)
length : n, 길이, 기장, 세로, 기간, 1마신, at full ~ 길게, at ~ 드디어, go all ~s, or go to grent(any)~ 어떤 일이라도 해치우다
lengthen : vi, vt, 길게하다, 늘이다
lengthily : ad, 
lengthman : n, (일정 구간의 선로(도로))보수원
lengthways : ad, 길게, 세로로
lengthwise : a, ad, 세로의(로), 긴(길게)
lengthy : a, 긴, 장황한
lenience : n, 관대, 온화
leniency : n, 관대, 온화
lenient : a, 관대한, 온화한
leniently : ad, 관대한, 온화한
Lenin : n, 레닌 Nikolai ~(18701924)(소련의 혁명가)
Leningrad : n, 레닌그라드(소련 북서 해안의 도시)
Leninism : n, 레닌주의
Leninist : n, a, 레닌주의자(의)
lenis : a, n, 연음의, 연음
lenitive : a, n, 완화성의, 진통제
lenity : n, 관대(한 조처)
leno : n, 일종의 얇은 면직물
lens : n, 렌즈, (눈알의) 수정체
lens hood : x, 카메라후드
lensman : n, 사진사
Lent : n, 사순절(Ash Wednesday부터 Easter 까지의 40일간, 이동안에 단식, 회개를 함)
lent : v, lend의 과거(분사)
lentamente : ad, a, 느리게, 느린
lentando : ad, 차차 느리게
Lenten : a, 사순절의, 봄철의, 육식없는, (복장 등)검소한, the ~ season 사순절의 계절
lenticel : n, 피목
lenticular : a, 렌즈 모양의, 공 모양의, (눈 알의)수정체의, 렌즈의
lentil : n, 렌즈콩
lentisk : n, =MASTIC 2
lento : n, 나팔수선하(daffodil)
lento : a, ad, 느린(느리게)
lentoid : a, 렌즈 꼴의
lent term : x, (대학의) 봄학기
Leo : n, 사자자리, (황도의) 사자궁
Leon : n, 남자 이름
Leonard : n, 남자 이름
Leonid : n, 사자자리의 유성군
Leonidas : n, 남자 이름
leonine : a, 사자의
Leonora : n, 여자 이름
leopard : n, 표범
leopardess : n, 암표범
Leopold : n, 남자 이름
leotard : n, (프랑스 곡예사의 이름에서)몸에 착 붙는 옷(곡예사, 댄서가 입는)
Lepcha : n, (히말라야 산지의)렙차 사람, 렙차 말
leper : n, 나병환자, 문둥이
lepid : n, 비늘
lepidolite : n, 리티아운모, 비늘 운모
lepidopteran : a, n, 인시목의, 인시류(의 곤충)
lepidopterist : n, 인시류 연구가(학자)
lepidopterous : a, 인시류의(나비, 나방)의
leporine : a, 토끼의(같은)
lepra : n, 문둥병, 나병(leprosy)
leprechaun : n, 난장이 노인 모습의 요귀
leprosarium : n, 나병요양소(leper house)
leprose : a, 비듬 같은, 비늘 모양의
leprosy : n, 나병
leprotic : a, 나병의, 문둥병에 걸린
leprous : a, 나병의(같은), 비늘 모양의
lepton : n, 경입자
leptospirosis : n, 렙토스피라병
Lepus : n, 토끼자리(the Hare)
Leroy : n, 남자 이름
les : n, a, =LESBIAN
Lesbian : a, n, Lesbos 섬의, 동성애의 (여자)
Lesbianism : n, 여성의 동성애(행위)
lesbo : n, =LESBIAN
lese majesty : x, 불경(대역)죄
lesion : n, 상해, (조직, 기능의) 장애, 병소
Lesley : n, 여자 이름
Leslie : n, 남자 이름, 여자 이름
Lesotho : n, 아프리카 남부의 독립국
less : a, 보다적은(작은), 보다 이하의(못한), little ~ than ...와 같은 정도, notthing ~ than 꼭 ...만큼
less : ad, 보다 적게, no(none the, or not the)~ 역시
less : prep, =MINUS
less : n, 보다 적은 수량(액), in ~ than no time 곧, 이내
lessee : m, 차지인
lessen : vt, vi, 적게하다, 줄이다
Lesseps : n, 레셉스 Ferdinand M. de ~(180594)(프랑스의 기사, (Suez운아의 건설자)
lesser : a, 보다작은
lessness : n, 한층적음
lesson : n, 학과, 과업, 교훈, 일과, 연습, give(have, take)~s in(chemistry) (화학을) 가르치다(배우다)
lessor : n, (토지, 가옥 등을) 빌려주는 사람, 집주인
lest : conj, ...하지 않도록, ...을 두려워하여
Lester : n, 남자 이름
let : vt, ...시키다, 하게하다, 빌려주다, 새어나오게 하다, (눈물을) 흘리다
let : aux, v, 권유, 명령, 허가, 가정의 뜻, ~ alone 내버려 두다, ~ be 내버려 두다, ~ down 내리다, ~ fly 날리다, ~ up 그만두다
let : n, vt, 방해(하다)
Let's : x, let us의 단축
letch : n, vi, =LECH
letdown : n, 감소, 이완, 실망, 환멸
lethal : a, 치명적인, 치사적인
lethality : n, 치명적임
lethargic : a, 졸린, 노곤한, 혼수상태
lethargically : ad, 노곤한, 혼수상태
lethargize : vt, 혼수 상태에 빠뜨리다, 졸리게 하다
lethargy : n, 혼수, 활발치 못한
Lethe : n, 망각의 강 (지옥의 강, 그 물을 마시면 과거를 잊음), 망각
Lethean : a, 망각의 강 (지옥의 강, 그 물을 마시면 과거를 잊음), 망각
Letitia : n, 여자 이름
letoff : n, 넘치는 기운, 싫은 일(마땅히 받아야 할 벌)을 면함, 방임
letout : n, 빠져나갈 길
Letraset : n, 레트라셋(인쇄용 시식 문자, 하나씩 따붙이게 되어 있음, 상표명)
Lett : n, Latvia 사람(말), 레트말
letter : n, 문자, 글자, 편지, 문학, 학문, 증서, ~ of attorney 위임장, ~ of credit 신용장, ~s patent 특허장, to the ~ 문자(그)대로
letter bomb : x, 우편폭탄
letterbound : a, 자구에 구애된
letter box : x, 우편함
letter card : x, 봉함엽서
lettercard : n, 봉함 엽서
letter carrier : x, 우편집배인
lettered : a, 학문있는, 교양있는
letterform : n, 활자의 디자인, 편지지
lettergram : n, 서신 전보
letterhead : n, 편지지 위쪽 인쇄 문구
lettering : n, 자체, 글자배치, 쓴글씨
letterless : a, 무교육의, 문맹의
letterman : n, 모교의 약자 마크의 작됴이 허락된 우수 선수
letter pad : x, 편지지
letter paper : x, 편지지
letter patent : x, 전매특허증
letterperfect : a, 대사를 외고 있는
letterpress : n, 활판 인쇄(법), 인쇄한 자구, 활판 인쇄기, 본문(삽화에 대하여), 편지 복사기
letterset : n, 레터셋 인쇄(법), 드라이 오프셋(dry offset)
letter stamp : x, 소인
letter stock : n, 비공개주
letterweight : n, 서진=LETTER BALANCE
letter writer : x, 편지쓰는사람
Lettic : a, =LETTISH
Lettice : n, 여자 이름
letting : n, 임대, 셋집, 전세(임대)아파트
Lettish : n, a, 레트어, 라트비아어
lettuce : n, 상추, 양상추
Letty : n, 여자 이름
letup : n, 정지, 완화
leucemia : n, =LEUKAEMIA
leucine : n, 루신
leucite : n, 백류석
leuco : x, =LEUC
leucocyte : n, 백혈구
leucocytosis : n, =LEUKOCYTOSIS
leucorrhea : n, =LEUKORRHEA
leucotome : n, 뇌엽절제용 메스
leucotomy : n, =LEUKOTOMY
leukemia : n, 배혈(구 과다)증
leukocyte : n, 백혈구
leukocytosis : n, 백혈구 증가(증)
leukopenia : n, 백혈구 감소(증)
leukorrhea : n, 백대하
leukotomy : n, 뇌엽 절제(술)
lev : n, 레프(불가리아의 화폐단위, 기호 LV, =100 stotinki)
Lev : x, Leviticus
Levant : n, 레반트(지중해 동부 지방 여러 나라)
levanter : n, 도망자, 지중해의 강한 동풍, 레반트(Levant)사람
Levantine : a, 레반트
levator : n, 거른, 기자(두개골절의 함몰부를 들어 올리는 기구)
levee : n, (군주의) 아침 알현(식), (대통령의) 집견회
levee : n, (강의) 제방, 둑, 부두
level : n, 수평(면), 평지, 높이, 수준, find one's(its)~ 실력에 맞는 지위를 얻다, on a ~ with ...과 동등하게, on the ~ 공정한
level : a, 수평의, 평평한, 동일 수준의, 서로 우열이 없는, 한결같은, 분별있는, do one's ~ best 전력을 다하다
level : vt, 수평으로 만들다, 고르다, 동일 수준으로 만들다, (건물을) 쓰러뜨리다, (의도를) 돌리다
level : vi, 겨누다, 조준하다, ~ down(up)(...의 표준을) 낮추다(올리다)
leveled : a, 등격의, (악센트가) 등고의
leveler : n, 수평하게 만드는 것, 평등 주의자, 수평주의자
levelheaded : a, 냉정한
leveling : n, 평평하게 함, 땅을 고름, 평등화, 수준(고저) 측량, (어형변화의)단순화
levelpeg : vi, 동점이다, 실력이 백중하다
lever : n, vi, vt, 지레(레버)(로 움직이다, 비집어 열다)
leverage : n, 지레의 힘(작용), (이용의) 수단, 세력
leveret : n, 새끼토끼
Levi : n, 세째아들
levi's : x, 리비스(솔기를 리벳으로 보강한 청색 데님의 작업복 바지)
leviable : a, (세금 등)부과할 수 있는, (화물 등)과세해야 할
leviathan : n, 거대한 바다 짐승, 큰배
levigate : vt, 가루로 만들다, 갈다, (잔 알갱이를)액체속에서 선별하다
levigation : n, 가루로 만듬
levin : n, 번갯불, 전광
levirate : n, 역연혼(죽은 자의 형이나 아우가 그 미망인과 결혼하는 관습)
levitate : vi, vt, 공중에 뜨(게 하)다
levitation : n, 공중 부양
levite : a, 레위 사람, 유대사람
levitical : a, 레위사람의, 레위기의
leviticus : n, 레위기
levity : n, 경솔, 부박, 경솔한 짓
levo : x, =LEV
levodopa : n, 
levorotatory : a, n, 왼쪽으로 도는, 좌선성
levulose : n, 과당
levy : vt, 거두어 들이다, (장정을) 징집하다
levy : vi, 징세(과세)하다, ~ taxes(blackmail)upon ...에 과세하다(공갈치다), ~ war on ...에 전쟁을 걸다
levy : n, 징세, 징집, 징집병원
lewd : a, 음탕한, 호색의
lewdly : ad, 음탕한, 호색의
lewdness : n, 음탕한, 호색의
Lewes : n, 루이스(잉글랜드 남부 East Susses주의 주도)
lewis : n, 무거운 돌덩이 등을 끌어 오리고 내리는 쇠 집게
Lewis : n, 남자 이름(Louis의 애칭)
Lewisham : n, 루이셤(Thames 강 남쪽에 있는 런던 자치구, 주택지)
lewisite : n, 루이사이(미란성 독가스의 일종)
lexeme : n, 어휘 항목, 어휘소
lexes : n, =LEXIS의 복수
lexica : n, =LEXICON의 복수형의 하나
lexical : a, 사전의
lexicog : x, lexicographer, lexidographical, lesicography
lexicographer : n, 사전편집
lexicographical : a, 사전편집
lexicography : n, 사전편집
lexicology : n, 어휘(어의)학자
lexicon : n, 사전(특지 고전어의)
lexicostatistics : n, 어휘 통계학
lexigram : n, 그림(기호)문자(글자를 대신하는 그림(기호))
lexigraphy : n, (한자 같은)일자 일어법
Lexington : n, 렉싱턴(미국 Massachusetts주 동부의 소도시, 1775년 4월 19일, 독립전쟁 최초의 전투가 있었음)
lexis : n, 어휘, 용어집, 어휘론
Leyden : n, 네절란드 남서부의 도시
Lhasa : n, 티베트의 수도
liability : n, 책임(있음, 부담, 의무, 경향, limited ~ 유한 책임
liable : a, 책임있는, 빠지기쉬운, (병에) 걸리기 쉬운
liaise : vi, (사람과)연락하다, 연락 장교로 근무하다
liaison : n, 연락, (프랑스 말 등의) 연결 발음, 간통, 밀통
liaison officer : x, 연락장교
liana : n, 리아나, 리아네(열대산 칡의 일종)
liar : n, 거짓말쟁이
lib : n, a, 여성해방운동(의)
libation : n, 헌주(술을 마시거나, 땅 위에 부어서 신을 제사하기), 신주, 음주
libbie : n, =LIBBER
Libby : n, 여자 이름(Elizabeth의 애칭)
libel : n, 중상문(서), 명예 훼손죄, 모욕이 되는 것
libel : vt, n, a, 중상하다, 고소하다, ~er, ~ler, ~ous, ~lous
libellant : n, (교회(해사)재판소에 있어서의) 민사 원고
libellee : n, (교회(해사)재판소에 있어서의)민사 피고
libellous : a, 비방하는, 중상적인, 남을 즐겨 중상하는
liberal : a, 자유주의의, 대범한, 풍부한, 교양적인
liberal : n, 자유주의자, 자유당원
liberal arts : x, 교양학과
liberal education : x, 일반교육
liberalism : n, 자유주의
liberalist : n, 자유주의의, 대범한, 관대한, 자유로운
liberalistic : a, 자유주의의, 대범한, 관대한, 자유로운
liberality : n, 자유주의의, 대범한, 관대한, 자유로운
liberalization : n, 자유주의화
liberalize : n, 자유주의화하다
liberally : ad, 자유주의의, 대범한, 관대한, 자유로운
liberalminded : a, 마음이 넓은, 관대한
Liberal Party : x, 자유당
liberate : vt, 해방하다, 석방하다, 유리시키다
liberation : n, 해방, 유리
liberator : n, 해방자
Liberia : n, 아프리카 서부의 (아프리카 최초의) 흑인 공화국
Liberian : a, n, 아프리카 서부의 (아프리카 최초의) 흑인 공화국
Libermanism : n, (소련 경제학자 이름에서)리베르만주의(사회주의 경제에의 이윤동기 도입론)
liberticide : n, a, 자유파괴(자), 자유를 파괴하는
libertinage : n, =LIBERTINISM
libertine : n, 방탕자, 난봉꾼
libertinism : n, 방탕, 난봉, 자유사상
liberty : n, 자유, 멋대로함, 자유구역, at ~ 자유로, ~ of conscience(press)신교(출판)의 자유, take liberties with ...에게 부담없이 굴다
Liberty Bell : x, 자유의종
Liberty Bell : x, 자유의 종
liberty hall : x, 손님이 마음대로 행동할 수 있는 집
Liberty Island : x, 자유의 여신상이 있는 뉴욕항 입구의 작은 섬
Liberty Ship : x, (제2차대전 중에 건조한) 수송선의 일종
libidinal : a, 리비도의
libidinous : a, ad, 호색의, 애욕의, ~ly 
libido : n, 애욕
LIBOR : n, London InterBank Offered Rate런던 은행간 거래 금리
libra : n, (무게의)파운드
librarian : n, 도서관원, 사서
library : n, 도서관(실), 장서, 서재, 표준 프로그램의 수집
library edition : x, 특제판, 동일 저자의 동일 장정본
library science : x, 도서관학
librate : vi, 흔들리다, 진동하다, 떨다, 균형이 잡히다
libration : n, 균형, 진동, (달의)칭동
librettist : n, 가극의 가사 작자
libretto : n, 가극의 가사(대본)
libretto : n, (가극 따위의) 대본
Libreville : n, 리브르빌(Gabon의 수도)
Librium : n, 리브리엄(트랭퀄라이저의 일종)
Libya : n, a, 리비아(이집트 서부의 옛 호칭), ~an 리비아의, 리비아사람
lice : n, louse의 복수
license : n, 면허, 인가, 허가증, 감찰, 방종, 방자, (기교상의) 파격
license : vt, 면허하다
licensed : a, ~ house 공인주류 판매점, ~ satirist 세상이 다 아는 독설가, ~ victual(l)er 공인 주류 판매인
licensee : n, 면허받은 사람, 공인 주류 판매인
license plate : x, (공식 인가를 표시하는) 감찰
licenser : n, 인가(허가)자, 검열관
licensor : n, 인가(허가)자, 검열관
licensure : n, (전문직 등의)면허 교부, 개업 인가(허가)
licentiate : n, 공인받은 사람, 유자격자
licentious : a, 방자한, 음탕한
licet : a, 허가된, 합법적인
lich : n, 시체
lichen : n, 지의류, 이끼
lichenous : a, 지의의(같은), 지의가 많은
lich gate : x, 지붕 있는 묘지문
lichgate : n, 묘지의 대문
lichhouse : n, 시체를 임시로 두는 곳, 영안실
licit : a, 합법적인, 정당한
lick : vt, 핥다, (물결이) 넘실거리다, ...에 이기다, 해내다
lick : (불길 따위가) 급속히 번지다, 너울거리다, 서두르다, ~ into shape 제구실 할 만큼 길러내다, ~ one's chops(lips)입맛다시다vi, 
lick : n, 핥음, 한번 핥기, 조금, 일격, 속력, give a ~ and a promise (청소, 일 등) 되는 대로 하다
lickerish : a, 갈망하는, 맛있는 것을 좋아하는
licketysplit : a, 전속력으로
licking : n, 핥음, 때림, 지게 함
lickspittle : n, 알랑쇠
licorice : n, 감초
licorous : a, =LICKERISH
lictor : n, 릭토르(고대 로마에서 집정관에 딸려 죄인을 처벌한 관리)
lid : n, 뚜껑, 눈꺼풀
lidar : n, 광선레이다
lidded : a, 뚜껑(덮개)이 있는
lidless : a, 뚜껑(눈까풀)이 없는, 경계하는(vigilant)
lido : n, (Venice 부근의) 해수욕장, 옥외 수영 풀
lie : n, 거짓말, 사기, 미신, give a person the ~, or give the ~ to ...의 거짓말을 면책하다, white ~ 악의 없는 거짓말
lie : vi, vt, 거짓말하다, 속이다, ~ a person into(out of)...을 속여서 ...에 빠뜨리다
lie : vi, (사람이나 동물들이) 누워(자고)있다, 눕다, 기대다, (어떤 상태에) 있다, (길이) 통해 있다, (군대 등이) 숙영(야영)하다
lie : n, (사물이 존재하는) 위치, 방향, 향, (동물의) 소굴, the ~ of the land 세
lieabed : n, 잠꾸러기
lieby : n, (철도의)측선, 대피선
Liechtenstein : n, 오스트리아와 스위스사이의 작은 후국
lied : n, 리드, 가곡
Liederkranz : n, 향기로운 치즈
lie detector : x, 거짓말 탐지기
liedown : n, 선잠
lief : ad, 기꺼이, 쾌히, would(has)as ~ ...(as) ...할 바에는 ...해도 좋다, would(had)~er ...than ...보다는 ...하는 편이 낫다
liege : n, 군주, 신하
liege : a 군주(신하)인, 충성스러운, ~ lord 군주
liege man : n, 신하
liein : n, 드러눕기 데모, 늦잠, 아침잠
lien : n, 유치권, 선취 특권
lierne : n, 둥근 천장을 잇는)서까래
lieu : n, in ~ of ...의 대신으로
lieutenancy : n, lieutenant의 직(직위, 임기)
lieutenant : n, 상관 대리, 부관, 중(소)위, 대(중)위, first(second)~ 육군중위(소위), ~ senior(junior)grade 해군 대(중)위
lieutenant colonel : x, 육군중령
lieutenant commander : x, 해군소령
lieutenant general : x, 육군 중장
lieutenant governor : x, 총독대리, (주의) 부지사
life : n, 생명, 목숨, 생애, 일생, 생기, 활력, 전기, 본인, as large(big)as ~ 실물 크기의, 틀림없이, come(bring)to ~ 소생하다(시키다)
lifeanddeath : a, 죽느냐 사느냐의
life annuity : x, 종신연금
life assurance : x, 생명보험
life belt : x, 구명대
lifeblood : n, 피, 활력소
lifeboat : n, 구명정
life buoy : x, 구명 부낭
life expectancy : x, 평균 예상 수명
life force : x, =ELAN VITAL
lifegiving : a, 생명을 주는
lifeguard : n, 호위병
life Guards : x, 근위 기병 연대
life history : n, 일생, 생애, (개체의 발생에서 죽음까지의)생활사
life insurance : x, 생명보험(의료보험금, 보험료)
life jacket : x, 구명 자켓
lifeless : a, 생명없는, 죽은
lifelike : a, 살아있는 것 같은
life line : x, 구명삭, 생명선
lifelong : a, 일생의, 종신의, 평생의
lifemanship : n, (남을 야코죽이기 위한)허세(부림)
life master : x, 브리지 경기에서 최고의 점수를 딴 선수
life net : x, (소방용의) 구명망
life office : x, 생명보험회사
lifeordath : a, =LIFEANDDEATH
life peer : x, 일대 귀족
life policy : x, 생명보험증서
life preserver : x, (수중) 구명대
lifer : n, 종신수
liferisking : a, 목숨을 건
lifesaver : n, 구조자
lifesaving : a, 인명구조의
life science : x, 생명과학(생물학, 생화학, 의학, 심리학 따위)
life sentence : x, 종신형, 무기징역
lifesize : a, 등신대의
life span : x, (생명체의) 수명
lifespring : n, 생명의 원천
lifestrings : n, pl, 생명줄, 목숨
lifestyle : n, (개성적)생활 양식
lifestyle : n, (개인에게 맞는)생활방식
lifesupport : a, n, 생명 유지 장치의, 생명 유지를 위한, (야생, 동, 식물의)생명을 유지하는, 생명유지장치, 연명 조처
lifesupport system : x, 생명유지장치(우주, 해저 탐험용)
lifethreatening : a, 생명을 위협하는
lifetime : n, a, 평생, 평생의
lifeway : n, 생활 방식
lifework : n, 필생의 사업
lifo : n, (회계 따위의) 후입선출법
lifrboatman : n, 구명정 담당원
lifrforce : n, 생명력
lift : vt, 들어(안아)올리다, 향상시키다, 제거하다, 캐(파)내다
lift : vi, 높아지다, 올라가다, (깔개 따위가) 부풀어 오르다, have one's face ~ed (미장원 등에서) 얼굴의 주름살을 펴다, ~ a hand 약간의수고를 하다
lift : n, (들어) 올림, 위로 향함, 승진, 승강기, (구름, 안개의) 걷힘, 도둑
liftback : n, 리프트백차(경사진 뒷부분의 지붕을 들어 올리게 된 자동차)
liftboy : n, 엘리베이터 보이
lifter : n, 승강기 운전사
liftgirl : n, 엘리베이터 걸
lifting body : x, 항공 겸용 우주선
liftman : n, 승강기 운전사
liftoff : n, (헬리콥터, 로켓 따위의) 이륙, 떠오름
lift pump : x, 빨펌프
lift truck : x, 적재용 트럭
ligament : n, 인대
ligase : n, 리가제(핵산 분자를 결합하는 효소)
ligate : vt, 잡아매다, 동이다, 결찰하다
ligation : n, (출혈 동맥의)결찰(법), 잡아매기, 잡아매는 것
ligative : a, 
ligature : n, 결찰사, 합자
liger : n, 라이거(수사자와 암범의 트기)
light : n, 빛, 광선, 조명, (성냥 등의) 불, (정신적인) 광명, 계몽, according to one's ~s 그 식견에 따라서, before the ~s 무대에 따라서
light : vt, 불을 켜다(붙이다), 비추다, 활기띠게 하다
light : vi, 불이 켜지다(붙다), 밝아지다
light : a, 빛나는, 반짝이는, 밝은
light : a, 가벼운, 간편한, 경쾌한, (흙이) 흐슬부슬한, (잠이) 깊지 않은, be ~ of heart 쾌활하다, have a ~ hand(touch)손재주가 있다
light : ad, 가볍게, 경쾌하게, 쉽게, ~ly ad, ~ness n, 
light : vi, (말해서) 내리다, (새가) 앉다, 우연히 만나다
light : vt, (밧줄을) 끌어 올리다, ~ into 공격하다, ~ on(upon)...을 만나다, ~ out 도망치다
lightadapted : a, (눈이)명순응한
lightarmed : a, 경장비의
light cavalry : n, 경기병
light chain : x, 전기 스탠드의 끈
light control : x, 등화 관제
lightday : n, 광일(1광연(lightyear)의 1일에 상당)
light eater : x, 소식가
lighted : a, 불이 켜진
lighten : vt, 비추다, 밝게 하다, ...에게 광명을 주다, 빛깔을 엷게 하다
lighten : vi, 빛나다, 번쩍이다, 밝아지다
lighten : vt, vi, 가볍게하다(되다), 경감(완화)하다
lighter : n, 불켜는 사람, 점화기, 라이터
lighter : n, vt, 거룻배(로 운송하다)
lighterage : n, 거룻배 운반(삯)
lighterman : n, 거룻배 사공
lighterthanair : a, 공기보다 가벼운, 비행선(기구)의
lightface : n, 획이 가는 활자
lightfast : a, 내광성의, 빛에 색이 바래지 않는
lightfingered : a, 손버릇이 나쁜
lightfoot : a, =LIGHTFOOTED
lightfooted : a, 발이빠른
lighthanded : a, 솜씨좋은
lighthead : n, 생각이 모자라는 사람, 머리가 몽롱한 사람
lightheaded : a, 경솔한
lighthearted : a, 쾌활한
light heavyweight : x, 레슬링, 라이트헤비급 선수
lighthorseman : n, 경기병
lighthour : n, 광시
lighthouse : n, 등대
lighthouse keeper : x, 등대지기
light industries : x, 경공업
light infantry : x, 경기병대
lighting : n, 조명
lighting bug : x, 개똥벌레
lightlegged : a, 걸음이 빠른
lightless : a, 빛이 없는, 어두운, 흑광(black light)
light literature : x, 경문학
light literature : x, 경문학, 중간소설
lightly : ad, 가볍게, 사뿐히, 조용히, 민첩하게, 재빠르게, 홀가분하게, 부드럽게, 온화하게, 경솔히, 신중하지 않게, 얕보고, 소홀히, 명랑하게, 경쾌하게, 들떠서, 예사로, 약간, 깨끗이, 쉽사리
light minded : a, 경솔한
lightminded : a, 경솔한
lightminute : n, 광분
lightmonth : n, 광월
light music : x, 경음악
lightness : n, 밝기, 광량
lightning : n, 번개
lightolove : n, 바람난 여자, 허튼 계집
light pen : x, 라이트펜
lightplane : n, (자가용)경비행기
lightproof : a, 광선이 안 통하는
light railway : x, 경편철도
lights : n, pl, 가축의 허파(특히 개, 고양이 등의 먹이)
lightsculpture : n, 빛의 조각(투명 소재와 전기 조명이 어우러지게 제작한 조각작품)
lightsecond : n, 광초
lightsensitive : a, 빛에 민감한, 빛을 잘 느끼는
lightship : n, 항로표지등선
lightskirts : n, 바람난(헤픈)여자
lightsome : a, 쾌활한, 경솔한, 밝은, 빛나는
lights out : x, 소등 나팔(시간)
lightsout : n, 소등 신호(나팔), 소등 시간, 정전
lightstruck : a, 광선이 들어간
light trap : x, 유아등
light wave : x, 광파
lightweek : n, 광주(빛이 1주일간에 진행하는 거리)
lightweight : n, 라이트급 선수
lightwood : n, 불쏘시개(lighter), 불붙기 쉬운 나무
lightyear : n, 광년
ligneous : a, 목질의
lignification : n, 목질화, 목화
lignify : n, 목질소, 리그닌
lignite : n, 갈탄
lignose : n, 리그노스(lignin의 한 성분), 폭발물(의 일종)
ligroin : n, 리그로인(석유 에테르의 일종, 용제로 씀)
ligula : n, =LIGULE, 순설
ligulate : a, 설상의, 혀모양의
ligule : n, 소설, 잎혀
likability : n, 
likable : a, 마음에 드는
like : vt, 좋아하다, 바라다, ...하고 싶다
like : vi, ...하고 싶다고 생각하다
like : n, 기호, 좋아함, ~s and dislikes 가리는 것
like : a, ...닮은, ...같은, 비슷한, (과연) ...다운, ...이 될 것 같은, feel ~ doing ...하고 싶은 생각이 들다, ~ nothing on earth 드문
like : vt, ...와 똑같이, 아마, 마치 ...같이, as ~ as not 아마
like : prep, ...처럼, ~ anything or ~ blazes(fun, mad)맹렬히, very ~, or ~ enough 아마
like : conj, ...와 같이, ...처럼
like : n, 비슷한 것(사람), 필적하는 것, and the ~ ...같은 것, or the ~ ...따위, the ~s of me (낮추어) 나같은 것
likeable : a, 마음에 드는
likelihood : n, 있음직한 일, 가능성, in all ~ 십중팔구
likely : a, 있음직한, 유망한, 믿음직한
likeminded : a, 한마음의
liken : vt, ...에 비유하다, 비기다
likeness : n, 비슷함, 상사성, 외관, hit a ~ 매우 닮다(비슷하다)
likenew : a, 신품이나 다름없는
likeron : n, 구경꾼, 방관자
likewise : ad, 똑같이, 마찬가지로, 또한
liking : n, 좋아함, 기호, to one's ~ 마음에 드는
Likud : n, 리쿠드(이스라엘의 우익 연합 정당)
lilac : n, a, 라일락
lilaceous : n, a, 백합의
liliaceous : a, 나리의(같은), 나리과의
Lilian : n, 여자 이름
lilied : a, 백합 같은, 백합이 많은
Lilith : n, 릴리스(황야에 살며 어린이를 습격하는 여자 귀신), 릴리스(아담의 첫 아내, 이브에게 쫓겨남)
Lilliput : n, 난장이 나라
Lilliputian : a, n, 난쟁이 나라의, Lilliput사람, 난쟁이
lilo : n, (플라스틱(고무)제의)에어매트리스
LILO : x, last in, last out
lilt : vt, vi, n, 경쾌하게 노래 부르다
lilting : a, (노래, 목소리 등)경쾌한(리듬의), 즐겁고 신나는
lily : n, a, 백합, 순결한, 사랑스러운
Lily : n, 여자 이름
lilylivered : a, 겁많은
lily of the valley : x, 은방울꽃
lilywhite : a, 백합처럼 흰
Lima : n, 리마
Lima bean : x, 리마콩
limb : n, 수족, 날개, 팔, 앞이, from ~ 갈기갈기(찢다, 따위), ~ of the law 사직의 손, out on a ~ 위태로운 입장에
limb : vt, ...의 가지를(손발을)자르다
limbate : a, (색다른)가장 자리가 있는
limbed : a, ...한 다리(가지)가 있는
limber : a, vt, 유연(경쾌)한(하게 하다)
limber : vt, n, 전차(를 연결하다)
limbic : a, (대뇌)변연계의
limbless : a, 팔다리(날개, 가지)가 없는
limbo : n, (천국과 지옥의) 임보, 지옥의 변방, 망각
Limburger : n, (벨기에산의 연한)림버거 치즈
limbus : n, 가장자리, 둘레
lime : n, vt, 석회(로 처리하다), 끈끈이(감탕)(를 바르다), ~ and water 석회수
lime : n, 보리수, 참피나무
lime : n, vt, 레몬 비슷한 과실
limeade : n, 라임에이드(라임과즙에 설탕, 물 등을 혼합한 음료)
Limeburger : n, 치즈의 일종
Limehouse : n, 라임하우스(London 동부, East End의 한 구역, 중국인이 많은 탓으로 Chinatown이라고도 함)
lime juice : x, 라임 과즙
limejuice : n, 라임 과즙
limejuicer : n, 새로 온 영국인, 영국 수병, 영국배, 영국인
limekiln : n, 석회가마
limelight : n, (옛날, 무대조명에 쓴)석회광등, 주목의 대상 in the ~ 화려한 무대에서서, 세상의 각광을 받고, 유명해져서
limen : n, 
limerick : n, 오행 희시
limestone : n, 석회석
lime tree : x, 보리수
limetwig : n, 끈끈이를 바른 나뭇가지, 덫
limewash : n, vt, (벽에 칠하는)석회도료, 회칠, ...에 석회 도료를 칠하다, 회칠하다
limewater : n, 석회수
limey : n, 영국인(수병)
limina : n, LIMEN의 복수
liminal : a, LIMEN의
limit : n, 한계, 한도, 제한, 경계, to the ~ 극단적으로, within the ~s of ...의 범위내에
limit : vt, 한정(제한)하다
limitary : a, 제하하는, 제한적인, 경계(상)의, 한정된, 유한의
limitation : n, 제한, 한정, 기한, (지력, 능력 등의)한도
limitative : a, 제한적인, 한정적인
limited : a, 유한의, 얼마안되는, 좁은, ~ war (적군의 전면적인 항복을 목적으로 하지 않는) 국지전
limited company : x, 유한 책임 회사, 주식회사
limited edition : x, 한정판
limited monarchy : x, 입헌군주정책
limiter : n, 제한하는 사람(것), 리미터(진폭제한회로)
limiting : a, 제한하는, 제한적 형용사(명사를 한정하느 구실뿐인 this, some, certain 등)
limitless : a, 무한한, 무기한의, 망막한
limitrophe : a, 국경의
limn : vt, 묘사하다
limner : n, 화공, 초상화가
limnology : n, 호소학
limo : n, 리무진
Limoges : n, (프랑스의 산지명에서)리모주 도자기
limonite : n, 갈철광(brown hematite)
Limousin : n, 리무쟁종의소(프랑스 원산의 강건한 육우)
limousine : n, 리무진(운전석과 객서의 사이에 유리 간막이가 있는 대형 자동차), 호화로운 대형 승용차, (공항의)여객 수송용 소형 , 버스)
limp : vi, n, 절뚝거리다, 절뚝거림
limp : a, 유연한, 약한, 흐늘흐늘한
limpen : vi, 절름발이가 되다
limpet : n, 꽃양산조개, 배밑 밀착식 수뢰
limpid : n, 맑은, 투명한
limpidity : n, 투명, 명쾌
limpkin : n, 뜸부기과의 새(미국 동남부, 서인도 제도 등지에 사는)
limpwristed : a, 여자 같은, 호모의, 연약한
limy : a, 석회질의, 석회를 함유하는, 끈끈이를 바른
linable : a, 한 줄로 세울 수 있는
linac : n, =LINEAR ACCELER ATOR
linage : n, 행수(에 따른 지불)
linar : n, 라이나(특별한 스펙트럼선을 지속하는 전파별)
linchpin : n, (바퀴 굴대의) 비녀장
Lincoln : n, 남자 이름, 링컨(미국 제 16대 대통령), 링컨종의 양(식용)
Lincolnshire : n, 링컨셔(영국 동부의 주)
lincomycin : n, 링코마이신(페니실린 저항균에 효과 있는 항생 물질)
lincrusta : n, 링크러스타(장식도안을 프린트한 두꺼운 벽지)
linctus : n, 목 아플때 먹는 시럽, 기침 물약
Linda : n, 여자 이름
lindane : n, 린데이(농업용 살충제)
Lindbergh : n, 린드버그(처음으로 대서양을 무착륙 비행한(190274)미국 비행가)
linden : n, 린덴(보리수, 참피 나무 무리)
Lindsay : n, 남자 이름
line : n, 선, 줄, 끈, 주름, 노선, 행렬, 솔기, 경계(선), 장사, 결혼 허가증, 악보, all along the ~ 도처에, bring into ~ 일렬로 하다
line : vt, 선을 긋다, 주름살을 짓다, 한줄로(줄지어)세우다(놓다)
line : vi, 나란히(줄지어)서다, ~ through 줄을 그어서 지우다, ~ up (기계를) 정돈하다
line : vt, (의복, 내벽 따위에) 안(감)을 대다, (배나 주머니를) 채우다
lineable : a, =LINABLE
lineage : n, 혈통, 부족, 민족
lineal : a, 직계의, ~ ascendant 직계존속
lineament : n, 용모, 얼굴 생김새
lineamental : a, 
linear : a, (직)선의(으로 이루어진)
linear accelerator : x, 선형가속기
linearly : ad, (직)선 모양으로, 선을 써서
linear measure : x, 척도
linear motor : x, 선형모터
linear programming : x, 선형계획
lineate : a, (평행한)줄무늬가 있는
lineation : n, 직선 긋기, 선을 그어 나누기, 윤곽, 선의배열
linebacker : n, 라인배커(스크럼인의 후방수비선수)
linebreeding : n, 동계번식
line drawing : x, 선화, 데상
line drive : x, 수평으로 친공
line engraving : x, 선조(판화)
lineman : n, 가선공, 보선공, 측선수, 전위
linen : n, 아마포, 린네르, 아마실, 린네르류, 린네르제품(시트, 셔츠 따위), wash one's dirty ~ at home 집안의 수치를 감추다(드러내다)
linen : a, 린네르제의, 린네르처럼 흰
linen draper : x, 린네르상
lineout : n, 라인아웃, 공이 터치라인을 나간 뒤의 쓰루인
line printer : x, 행인자기
liner : n, 정기항로선, 정기항공기, 안을대는, 깔쇠, 덧쇠
line shooter : x, 자랑꾼
linesman : n, 선심
lineup : n, 진용, 라인업, (내각 따위의)구성
liney : a, =LINY
ling : n, 대구 비슷한 물고기
lingam : n, (힌두교 Siva신의 상징으로서의)남근상
lingcod : n, (북태평양 연안산)쥐노래미과의 물고기
linger : vi, (우물쭈물) 오래 머물다, 꾸물거리다, (추위, 감정 등이) 쉬이 사라지지(물러가지)않다, 나중에까지 남다, 어정거리다
linger : vt, 질질 끌다, (시간을) 우물쭈물 보내다, ~ on (a subject) (한가지 일을 가지고) 언제까지나 끙끙 앓다
lingerie : n, 란제리
lingering : a, 오래끄는, 머뭇거리는, 미련이 있는, 못내 아쉬운
lingeringly : ad, 오래 머물다, 꾸물거리다, 쉬이 사라지다, 나중에까지 남다, 어정거리다
lingo : n, 말, 뜻을 알수 없는 말
lingua franca : x, 프랑크말, 르방지방에서 쓰이는 이탈리아, 프랑스, 그리스, 스페인말의 혼합어
lingual : a, n, 혀의, 설음의
Linguaphone : n, 어학레코드
linguiform : a, 혀모양의
linguist : n, 언어학자
linguistic : a, 언어학상의
linguistic atlas : x, 언어지도
linguistic geography : x, 언어지리학
linguistics : n, 언어학
linguistic stock : x, 어계와 그것에서 파생된 모든 방언, 언어), 어떤 어계를 말하는 민족
lingulate : a, 혀 모양의
lingulne : n, 납작하게 뽑은 파스타(pasta), 그 요리
liniment : n, 바르는 약, 도찰제
linin : n, 리닌, 핵사
lining : n, 안대기, 안, 안감
link : n, 횃불
link : n, (사슬의) 고리, 연쇄, 연결(부), (편물의) 코
link : vt, vi, 연접(연속)하다, 이어지다
link(ing) verb : x, 연결동사
linkage : n, 연쇄, 연합
linkboy : n, (옛날의)횃불 드는 소년
linkman : n, 횃불 드는 사람, (극장 등에서 차를 돌보는)안내원, 시중꾼, (축구, 럭비, 하키보는)센터포워드와 백의 중간을 이어주는 선수, (방송의)사회자, 중개자
links : n, 골프장
linksman : n, 골프 치는 사람
Link trainer : x, (지상에서의) 링크식 비행 연습장치
linkup : n, 연결, (우주선의)도킹
link verb : x, 연결동사
linkwork : n, 고리(사슬)세공, 연동 장치(linkage)
Linnaean : a, n, 린네(Linnaeus)의, 린네식 식물 분류법의, 린네식 분류법에 따르는 사람
Linnaeus : n, 린네(스웨덴의 식물분류학자)
linnet : n, 홍방울새(유럽, 아시아, 아프리카산의 명금)
lino : n, =LINOLEUM, LINOTYPE
linocut : n, 리놀륨 인각(화)
linoleum : n, (마룻바닥에 까는) 리놀륨
Linotype : n, (1행 분씩 만드는) 자동 주조식 자기, 라이노타이프
linseed : n, 아마의 씨
linseed oil : x, 아마인유
linsey : n, (튼튼한) 면모교직
linseywoolsey : n, 면모(마모)교직물
linstock : n, 화승간(구식 대포의 인화선에 연결된 막대)
lint : n, 린트천(린네르의 한면을 보풀일게 하여 부드럽게 한 것), 실보무라기
lintel : n, 상인방(창, 입구 따위의 위에 댄 가로대)
lintelled : a, 상인방(돌)이 있는
linter : n, 솜부스러기 채취기, (조면기로 긴 섬유를 앗은 뒤 씨에 남은)잔 솜털
linty : a, 조면(lint)이 많은, 조면 같은
Linus : n, 남자 이름, 리눅스 커널 개발자
Linux : n, 자유? 재미? 힘? 긴장? 불안? 환희? 모든것을 가지고 있는 그 이름하야 리눅스
liny : a, 선을 그은, 선(주름)이 많은, 선을 지나치게 쓴
lion : n, 사자, 아이온, 인기의 중심, 명사, 용사, 명소, ~ in the way(path)길에 가로놓인 난관, ~'s share 가장 큰(좋은)몫
Lionel : n, 남자 이름
lioness : n, 암사자
lionet : n, 새끼 사자
lionheart : n, 용맹스러운 사람, 사자왕(Richard 1세의 별명)
lionhearted : a, 용감한
lionhood : n, 인기 있는 사람(명사)임
lion hunter : x, 사자사냥군, 명사와 교제하고 싶어하는 사람
lionhunter : n, 사자 사냥꾼
lionization : n, 
lionize : vt, 치켜세우다, (...)의 명소를구경하다
lionlike : a, 사자 같은
lip : n, 입술, (pl)입, (물병 따위의) 귀때, 수다(떨기), 건방진 말, carry(keep)a stiff upper ~ 굴하지 않다, 끝끝내 고집을 세우다
lip : vt, , vi, , (pp)입술을 대다, (피리 따위에) 입술을 쓰다, 중얼거리다, (파도가 물가를) 찰싹찰싹 치다, 
lip : a, 표면(말)만의, 
lipase : n, 리파제(췌액), 아주까리씨 등에 포함된 지방 분해 효소)
lipbalm : n, 입술용 크림
lipdeep : a, 말뿐인, 입에 발린
lipectomy : n, (비만 부의의)지방 제거(술)
lipid : n, 지질
lipidic : a, 지질의
lip language : x, (농아자의) 시화법
lipography : n, (부주의로 인한) 탈자, 탈어
lipoid : a, n, 유지질의, 리포이드, 유지질
lipoprotein : n, 지단백질, 리포 단백질
liposome : n, 리포솜(인지질의 현탁액에 초음파 진동을 가하여 생기는 미세한 피막 입자)
lipotropin : n, 리포트로핀(뇌하수체에서 분비되는 지방 분해 호르몬)
lipped : a, 입이(귀때)달린
lipper : n, 해면의 잔 물결
lippie : n, 립스틱(lipstick)
lippy : a, 입술이 두툼한, 건방진(소리를 하는), 수다스러운
lipread : vt, vi, 시화하다, 독순술로 이해하다
lipreader : n, 독순술에 능한 사람
lip reading : x, (농아자의)독순술
lipreading : n, 독순술, 시화(농아자의)
lipsalve : n, 입술 연고, 입에 발린 말, 아첨(flattery)
lip service : x, 입에발린아첨, 말뿐인 친절
lipstick : n, vt, (막대꼴)입술 연지, 립스틱, ...에 입술 연지를 바르다
lipstick : n, 입술연지
lipsync : vt, vi, n, 녹음(녹화)에 맞추어 말(노래)하다, (녹음에)입 맞추기, 맞추어 노래(말)하기
liquate : vt, 족이다, 용해하다, 용석(용출)하다
liquation : n, 용석, 용출
liquefacient : n, 용해제
liquefaction : n, 액화
liquefactive : a, 액화(성)의, 용해성의, 액화하기 쉬운
liqueflable : a, 액화(용해)할 수 있는
liquefy : vt, vi, 액화하다
liquescence : n, 액화 (상태)
liquescent : a, 액화하는, 액화하기 쉬운
liqueur : n, 리큐어술
liquid : n, 액체, 유동체, 유음
liquid : a, 액체(유동체)의, (작은 새 소리, 하늘 빛 등이) 맑은, 유창한, 유음의, (공채 등) 돈으로 바꿀 수 있는
liquid air : x, 액체공기
liquidate : vt, 청산하다, 전멸시키다, 죽이다, 일소하다, 정리하다
liquidation : n, 변제, 청산, 정리, 일소
liquid fire : x, 액화(화염방사기에서 발사되는)
liquid fuel : x, (로켓의)액체연로
liquidity : n, 유동성, 유창함
liquidize : vt, 액화하다, 믹서로 액상화하다
liquidizer : n, (요리용)믹서(blender)
liquid measure : x, 액량
liquid sound : x, 유음
liquor : n, 알코올 음료, 술, 액 in ~, or (the) worse for ~ 취해서
liquor : vt, vi, 술을 많이 먹이다(마시다)
liquorice : n, 감초(licorice)
liquor store : x, 주류판매점
lira : n, (pl, ~s, lire(rei)) 리라, 이탈리아 은화
Lisa : n, 여자 이름(Elizabeth의 애칭)
Lisbon : n, 리스본, 포루투갈의 수도
Lise : n, 여자 이름(Elizabeth의 애칭)
Lisle : n, 튼튼한 무명실(양말, 장값용)
lisp : vt, vi, 불완전하게 발음하다, 혀짤배기소리로 말하다, 혀가 잘 돌지않다 ~ in numbers 혀도 잘 돌지 않는 어린 시절부터 시를 짓다
lisp : n, 혀짤배기 소리, 또렷하지 못한 말
lisping : n, a, 혀짧은 발음, 혀짤배기말, 혀가 잘 돌지 않는
lispingly : ad, 혀짧은 발음으로, 살랑거려
lissom : a, 나긋나긋한, 재빠른, 기민한
list : n, vi, 경사(지다)
list : vt, vi, 경청하다
list : n, 목록, (일람)표, 명부, 명세서, draw up a ~ 목록을 만들다, on the sick ~ 병으로, 앓고
list : vt, 명부(목록)에 올리다(싣다)
list : vi, 명부에 오르다(at)
list : vt, (3인칭 단수 현재 list, listeth, 과거(분사) list, or listed) 마음에 들다, 바라다, 원하다
listen : vi, 경청하다, 듣다(to), (충고 따위에) 따르다(to), 귀를 기울이다(for), ~ in (라디오를) 청취하다, (전화 따뤼를) 도청하다
listenable : a, 듣기 쉬운, 듣기 좋은
listener : n, 경청자, 청취자
listenerin : n, (라디오) 청취자, 도청자
listener research : x, 인기 프로조사
listening : n, 청음, 경청, 청취
lister : n, 리스트(카탈로그)작성자, 양축식 경토기
Listerism : n, 리스터 소독법(석탄산에 의한)
listerize : vt, (상처에)리스터식 소독을 하다
listless : a, 느른한, 열의(시름)없는, 무관심한, 냉담한
list price : x, 표시가격
Liszt : n, 헝가리의 작곡가, 피아니스트
lit : v, light의 과거(분사)
litany : n, 연도, 용장한말
litchi : n, 여주(열매)
liter : n, 리터(약 5흡 5작)
literacy : n, 읽고 쓰는 능력, 교양
literal : a, 문자의, 문자 그대로의, (과장, 수식 따위를 이해 못하고) 정확한, 문자 그대로 생각하는, 실제가 기질의 ~ translation 축어역
literalism : n, 직역주의
literalist : n, 직역자
literality : n, 글자대로임, 글자대로의 해석(뜻)
literalize : vt, 글자 뜻대로 해석하다, 글자 뜻에 구애 되다
literally : ad, 글자뜻대로
literarily : ad, 문학상(학술상)으로
literarism : n, 문어주의(취미), 문학(인문학)주의
literary : a, 문학의, 문학적인, 문필의, 문예의, 학문(상)의, 문어의, 문어적인, 문학에 능통한(조예가 깊은), 저술을 직업으로 하는
literary : a, 문학의(문예)의, 문학에 소양이 깊은, 문어의, ~ property 판권, ~ style 문어체, ~ works(writings)문학작품
literate : a, n, 글을 아는(사람), 교양있는
literati : n, 문인들, 학자들
literatim : ad, 한자한자, 축자적으로
literation : n, (음성, 말의)문자 표기, 문자화
literator : n, 문인, 문학자, 저작자
literature : n, 문학, 문헌, 문예, 지술, 인쇄물
litharge : n, 밀타승
lithe : a, 나긋나긋한, 유연한
lithesome : a, 나긋나긋한, 유연한
lithia : n, 산화리튬
lithic : a, 돌의, (방광) 결석의, 리듐의
lithium : n, 리튬
lithograph : n, 석판인쇄, 석판화
lithograph : vi, 석판으로 인쇄하다
lithographer : n, 석판 인쇄공
lithographic : a, 석판술의
lithography : n, 석판인쇄술
lithoid : a, 돌모양의, 석질의
lithology : n, 암석학, 결석학
lithophyte : n, 산호충, 암생
lithopone : n, 리토폰(백색 안료)
lithoprint : vt, n, 석판으로 인쇄하다, 석판으로 인쇄한 책
lithosphere : n, 지각
lithotomy : n, (방광 결석의)쇄석술
Lithuania : n, a, 리투아니아, 발트해연안의 한 공화국, 리투아니아(사람, 말)(의)
Lithuanian : a, n, 리투아니아(사람, 말)의, 리투아니아 사람, 리투아니아 말
litigable : a, 법정에서 투쟁할 수 있는
litigant : a, n, 소송하는, 소송관계자
litigate : vt, vi, 법정에 들고 나오다, 법정에서 다투다
litigation : n, 법정다툼
litigious : a, 소송의(을 좋아하는)
litist : N, =LUTANIST, 류트 제조인
litmus : n, 리트머스
litmusless : a, 긍정도 부정도 안하는, 중립적인
litmus paper : x, 리트머스 시험지
litotes : n, 곡언법
litre : n, =LITER
litter : n, 들것, 가마, (짐승의) 깔짚, 어수선하게 흩어진 물건, 잡동사니, 난잡, (돼지의) 한배 새끼, in a ~ 어지럽게 흩어져
litter : vt, 깃을 깔다, 난잡하게 어지르다(with), (돼지가 새끼를) 낳다
litter : vi, (가축이) 새끼를 낳다
litterateur : n, 문인, 문학자
litterbag : n, (자동차 안 등에서 쓰는)쓰레기 주머니(봉지)
litterbasket : n, 휴지통
litterbin : n, (공원 등의)휴지통
litterbug : n, (길거리, 열차안 따위에)쓰레기를 함부로 버리는 사람
litterer : n, =LITTERBUG
litterlout : n, =LITTERBUG
littermate : n, 한배 새끼(개, 돼지등의)
littery : a, 먼지로 더러워진, 난잡한, 흩뜨러놓은
little : a, (less, lesser, least) 작은, 적은, 조금밖에 없는, 얼마간, 조금은, 어린애 같은, 하찮은, 비천한, but ~ 극히 조금의, 거의 없는
little : n, pron, 조금, 잠깐, for a ~ 잠깐, ~ by ~ 조금씩, in ~ 소규모로, make ~ of 얕보다, not a ~ 적지 않게, 크게, quite a ~ 다량, 많이
little : ad, n, (a ~) 조금은, 거의 ...않는, 전혀 , 않는, ~ better(more)than ...나 매한가지, ~ less than 거의 ...과 같은, ~ness 
Little Assembly : x, 국제연합 소위원회
Little Bear : x, =BEAR
Little Corporal : x, 나폴레옹1세의 별명
Little Englander : x, 소 영국주의자(식민지에 의존하지 않고 영국의 충실을 주장하는)
Little finger : x, 새끼 손가락
littlego : n, 소시험(케임 브리지 대학에서 B, A, 의 학위를 얻기위한 예비 시험)
Little League : x, 소년 야구 리그
little magazine : x, 동인 잡지
Little Mary : x, 배
Little Neddy : x, 경제 개발 위원회의 하나
littleness : n, 작음, 조금, 근소, 옹졸, 인색
Little Rhody : x, 미국 로드섬주의 속칭
Little Russia : x 소러시아(우크라이나의 별칭)
little theater : x (진보적, 바상업적인)소극장(에 적당한 극)
littoral : a, n, 바닷가의, 바다가에서 나는, 연해지
liturgical : a, 예배식의, 예배식(전례)의 규정에 의한, 성찬식의
liturgics : n, 예배학, 전례학, 전례론
liturgist : n, 전례(예배)학자, 기도식문 편집자, 전례주의자, 예배식 사회목사
liturgy : n, 예배식, (희랍 정교의)성찬식, (the ~)(영국 국교회의) 기도서
livability : n, (가축의)생존율, (사람이)살기 좋음, 거주 적합성
livable : a, 살기에 알맞은, 사는 보람이 있는, 함께 지낼 수 있는, 무간한
live : vi, 살(고 있)다, 살아 있다, 생존하다, 생활하다, 재미있게 살다, 존속하다, (기억에) 남다, ...을 상식으로 하다, 재미있게살다
live : vt, 보내다, 지내다, (이상 따위를) 실행(실현)하다, ~ a lie 거짓에 가득찬 생활을 보내다, ~ and learn 오래 살고 볼일
live : a, 살아있는, 전류가 통하는, 활기있는, 활동적인, 장탄돼 있는, 생방송의
liveability : n, =LIVABILITY
liveable : a, =LIVABLE
lived : a, 생명이 ...한
livein : a, 입주하고 있는, 동거하는(애인)
livelihood : n, 생계, 살림, 호구지책
livelily : ad, 원기있게, 힘차게, 명랑하게, 떠들썩하게, 살아있는 듯이, 생생하게, 선명하게
liveliness : n, 원기, 활기, 명랑, 쾌활, 생기, 선명
livelong : a, (시간이)긴
livelong : n, 오랜, 내내, 온, 꼬박
lively : a, 활기있는, 쾌할한, (공, 마루 등이)잘 튀는, 명랑한, 선명한, 실감을 주는
lively : ad, 활발(쾌활)하게, make it ~ for ...을 곤란케 하다
liven : vt, vi, 활기띠다
live oak : x, 떡갈나무의 일종
liveout : a, 출퇴근하는
liver : n, 간장, 적갈색
liver : n, 생활자, 거주자
livercol(o)ured : a, 간빛의, 적갈색의
livercolored : a, 간장색의, 다갈색의
livered : a, ...한 간장(기질)을 지닌
liver fluke : x, 간흡충
liveried : a, 제복을 입은
liverish : a, 간장병의, 성미가 까다로운, 적갈색의
Liverpool : n, 잉글랜드 서부 Merseyside주의 주도(항구 도시)
Liverpudlian : a, Liverpool의(시민)
liverwort : n, 우산이끼
liverwurst : n, 간고기 소시지
livery : n, 일정한 옷, 정복, 제복, 정식량, 말이나 마차 세놓은 업(집), in(out of)~ 제복(평복)을 입고, ~ of grief 상복
liveryman : n, (런던의)동업 조합원, 세놓는 사람, 정복을 입은 사람
livery stable : n, 말(마차)세놓은 집
lives : n, life복수형
livestock : n, 가축
livestock farmer : x, 축산업자
livestock farming : x, 축산업
livetrap : vt, 생포용 덫으로 사로잡다
liveware : n, 컴퓨터 종사자(요원)
liveweight : n, 생체중(도살 전의 가축의 체중)
liveyere : n, =LIVYER
livid : a, 납빛의, 창백한, 퍼렇게 멍든, 격노하여
lividity : n, 흙빛, 납빛
living : a, 살아있는, 현대의, 현존의, 활기있는, 흐르고 있는, 자연그대로의, 생활에 관한, 생계의, ~ death 생지옥
living : n, 생활, 생계, 살림, 목사의 수입
livingin : n, 기숙
livingout : n, 통근
living quarters : x, 거소, 거처
living room : x, 거실, 거처방
Livingstone : n, 스코틀랜드의 선교사
living wages : x, (최저의)생활임금
livre : n, 리브르(옛날 프랑스의 화폐단위), 리브르금화(은화, 동화)
Livy : n, 리비우스(로마의 역사가, Latin이름은 Titus Livius)
livyer : n, (어기에 찾아오는 어부에 대해)정주자
lixiviate : vt, (고체 혼합물에서)가용 물질을 용액으로서 분리하다
liz : n, 여자 이름(Elizabeth)
lizard : n, 도마뱀, 유흥가의 건달
lizzie : n, (값싼)소형자동차(포드 자동차의 별명)
Lizzie : n, 여자 이름
llama : n, 라마, 남미산의 육봉없는 작은 낙타
llanero : n, LLANO의 주민
llano : n, (남아메리카의) 대평원
Llchesis : n, 라케시스(운명의 3여신(Fates)의 하나, 인간의 생명의 실의 길이를 정함)
llfi : a, 하이파이가 아닌, 저충실도의
Lloyd's : n, 로이드 조합, 런던의 해상보험업자 조합
Lloyd George : n, David (18631945) 영국의정치가
lo : int, 보라(behold)!
loach : n, (유럼산의)미꾸라지
load : n, 짐, 무거운 짐, 부담, 근심, 걱정, 적재량, 하중, 부하
load : vt, 싣다, 적재하다, 마구 처넣다(주다), (주사위에 납을 박아) 무겁게 하다, (술에) 섞음질을 하여 독하게 만들다
load : vi, n, 짐싣다, 총에 장전하다, 잔뜩 채워 넣다, ~er
load displacement : x, 만재 배수량
loaded : a, 짐실은, 탄알을 잰, 화약을잰, 납을 박은, 취한, 의미 심장한, 감정적이 된
loader : n, 짐을 싣는 사람, 적하기, (총포의)장전자, ...장전식 초(포), 로더(외부 매체로부터 프로그램 등을 주기억 장치에 넣기 위한 루틴)
loading : n, 짐싣기, 선적
Load Justice : x, 공소원 판사
load line : x, 만재홀 수선
loadmaster : n, 기상 수송원, 탑재물 관리 책임자
loadshedding : n, (공장의)전력제한, 전력 평균분배(법)
loadstar : n, =LODESTAR
loadstone : n, 천연 자석
loaf : n, (pl, loaves(vz)(일정한 모양으로 구워낸 빵의)덩어리, 빵 한덩어리, 요리의 일종, 원뿔꼴의 한덩이, loaves and fishes 제 잇속
loaf : vt, vi, n, 놀고지내다, 빈둥거리다, 어정거리다
loafer : n, 게으름뱅이, 간편화의일종
loaf sugar : x, 각설탕
loam : n, a, 양토, 롬(모래, 점토, 짚이 섞인 비옥토)
loamy : a, 롬(질)의
loan : n, 대부, 대부금, 대차, 공채, 외래어, 차관, get(have)the ~ of ...을 빌다, ~ on 대부하고, 차입하고, public ~ 공채
loan : vt, vi, 빌려주다(out)
loaner : n, 대부자, 대여자, (수리하는 동안에 빌려주는)대체품(자동차 등)
loaning : n, 좁은 길(lane), (소의)젖 짜는 곳, 착유소
loan office : x, 금융업소, 전당포
loanout : n, (계약한 영화 배우를 타사에)빌려줌
loan shark : x, 고리 대금 업자
loansharking : n, 고리 대금업
loan translation : x, 차용번역, 어구의 축어역
loan word : x, 외래어
loanword : n, 외래어, 차용어
loath : vt, vi, 싫어하여, 꺼려서, nothing ~ 기꺼이a, pred loathe(lou!)몹시 싫어하다
loathe : a, 싫은(reluctant), =LOATHSOME
loathing : n, 강한 혐오, 질색
loathly : ad, 마지못해
loathsome : a, 지긋지긋한, 구역질 나는
loaves : n, loaf의 복수형
lob : vt, vi, 높게 상대방의 뒷쪽으로 가게치다
lobar : a, 귓불
lobate : a, 열편이 있는, 열편 모양의, 발가락에 잎 모양의 막이 있는
lobation : n, 열편형성, 귓볼, 열편, 판
lobby : n, (호텔, 극장 등의) 로비, 현관의 홀, 복도, 의원
lobby : vi, vt, n, (휴게실에서) 의원에게 공작을 하다, (의원에 대한) 원외로부터의 운동, 원외 운동자
lobbyfodder : n, 이익 집단에 대한 봉사에만 전렴하는 의원(들)
lobbyism : n, (원외에서의)의안 통과(부결)운동, 진정 운동, 압력 행사, 의회 공작
lobbyist : n, 의안 통과(부결)운동자, 진정자, 로비스트
lobe : n, 귓불, 잎사귀, small ~ 소열편, 소엽
lobectomy : n, 폐엽 절제술
lobed : a, 잎 모양의, 열편의
lobelia : n, 숫잔대, 로벨리아
loblolly : n, 진창, 미송의일종
lobo : n, 회색의 큰이리
lobotomized : a, (대뇌의)백질 절제 수술을 받은, 생기 없는, 멍한
lobotomy : n, 뇌엽 절재
lobscouse : n, 고기, 야채, 비스킷 등으로 만든 스튜(선원의 음식)
lobster : n, 바닷가재, 대하
lobstereyed : a, 눈이 튀어나온, 퉁방울눈의
lobsterman : n, 왕새우잡이 업자(어부)
lobular : a, 소열편의, 소엽의
lobule : n, 소열편, 소엽
lobworm : n, =LUGWORM
LOC : x, line of communication, 병참선, 후방 연락선
local : a, 지방의, 지방적인, 국부적인, 공간의, 장소의, 소구간, 시내 배달의, 소구간의
local : n, 지방 주민, 구간 열차, (신문의)지방 기사
local color : x, 지방색, 향토색
locale : n, 현장
local goverment : x, 지방자치
localism : n, 지방근성, 지방색, 향토편애, 편협성
locality : n, 장소, 위치, 현장, 산지
localization : n, 국한, 지방화
localize : vt, 국한하다, 위치를 밝혀내다, 지방화하다
localized : a, 지방적인
localizer : n, 로컬라이저(계기 착륙용 유도 전파 발신기)
locally : ad, 장소(위치)상으로, 지방(국부)적으로, 지방주의로
local option : x, (지방자치제가 가지는)주류 판매 금지권
local time : x, 지방시, 현지 시간
local train : x, (역마다 서는)완행 열차
Locarno : n, 로카르노(스위스의 남동부에 있는 도시)
locate : vt, 위치를 정하다, 소재를 밝혀내다, be ~d 위치하다, 있다
locate : vi, 거주하다(in)
located : a, ...에 위치하여
location : n, 위치, 로케이션, 야외촬영
locative : a, n, 위치를 가리키는
locator : n, 토지(광구)경계 설정자, 전파 탐지기, 청음기, 위치 탐사 장치
loch : n, 호수, (가느다란)협만
lochia : n, 오로(산욕 배설물)
loci : n, LOCUS의 복수
locierroom : a, (갱의실에서 주고받는)야비한(상스러운)(말, 농담)
locion : n, 레이더에 의한 자동 추적, 잠수함과 구조정 등과의 사이의 기밀 통로의 연결
lock : n, 한 줌의털, (머리 양털 따위의)타래, 타래진 머리털
lock : n, 자물쇠, 총기, 제륜장차
lock : v, 자물쇠를 채우다, 챙겨넣다, 가두다, 끌어안다, 고착(고정)시키다
lock : vi, 자물쇠가 채워지다(잠기다), 닫히다, 서로 맞붙다, 수문을 지나다, ~ in(out)가두다(내쫓다), ~ up 자물쇠로 잠그다
lockage : n, 수문의 구축(사용, 개폐), 수문 통과(세), 수문재외의 수위차
lockaway : n, 장기 증권
lockdown : n, (죄수의 감방내에서의)엄중한 감금
Locke : n, 영국의 철학자
locker : n, 로커, 자물쇠 달린 장
locket : n, 로킷(사진이나 머리카락 등을 넣어서 목걸이에 거는 조그마한 갑)
lock gate : x, 수문
Lockheed : n, 록히드 (회사에서 만든 만든)비행기
Lock Hospital : x, 성병병원
lockin : n, 변경 불능, 고정화, 속박, 제약, 요지부동, 종성, 점거
lockjaw : n, 파상풍
lock keeper : x, 수문지기
lockkeeper : n, 수문 관리인
lockless : a, 갑문(수문)이 없는, 폐쇄 하지 않는
lockmaster : n, LOCKKEEPER
locknut : n, (다른 나사 위에 끼우는)고정 나사, 보조 나사
lockout : n, 공장폐쇄, 내쫓음
locksman : n, 수문지기
locksmith : n, 자물쇠 제조공
lockstep : n, a, (사람과의 거리를 좁혀 자아가는)밀집 행진법, 틀에 박힌 밥업, 딱딱한, 융통성이 없는
lockstitch : n, vt, vi, 재봉틀 박음질(감침질), 재봉틀로 박다, 재봉틀 박음질을 하다
lockup : n, a, 유치장, 구치소, 교도소, 임대차고, 감금, (자본의)고정, 고정 자본(액), 자물쇠가 걸리는(를 채운)
loco : n, 로코초(유독 콩과 식물, 가축이 먹으면 뇌가 상함), 로코병
loco : a, 정신이 돈, 머리가 이상한
lococitato : x, 전게 인용문 중에(생략 loc, cit, , l, c, )
locoed : a, 미친
locoism : n, 로코병(가축이 로코초를 먹고 걸리는 신경병)
locomobile : n, a, 자동추진차(기관), 자동차, 이동하는(할 수 있는)
locomote : vi, 이리저리 움직이다
locomotion : n, 운동, 운동력, 이동, 이동력, 여행
locomotive : a, 이동하는, 이동력있는
locomotive : n, 기관차, ~ engin 기관차, ~ organs 발, 다리(따위)
locomotor : n, 운동의
locomotor ataxia : x, 운동장애
locomotory : a, =LOCOMOTOR
locoweed : n, 로코초(미국산 유독 콩과 식물)
loculus : n, 포, 방, 소실, 고분내의 시체실
locum : n, 대리인, 대리목사
locus : n, 장소, 소재지
locust : n, 메뚜기, 매미, 대식가, 쥐엄나무 비슷한 상록 교목, 아카시아
locution : n, 화법, 어법, 어구, 관용어법
locutionary : a, 발화의, 발화적인
locutory : n, 담화실(수도원 등의)
lode : n, 광맥
lodestar : n, 로덴(두꺼운 방수, 순모 외투감), 암록색
lodestone : n, 천연 자석(natural magnet), 흡입력 있는 물건, 사람을 끄는 것
lodge : n, 오두막집, 파수막, 수위실, 지부, 해리따위의 굴
lodge : vi, 묵다, 투숙하다, (화살 따위가) 꽂히다, (바람에) 쓰러지다
lodge : vt, n, 투숙케 하다, 맡기다, 위탁하다, (화살 따위를) 꽂다, 숙박인, 하숙인, 동거인
lodgement : n, =LODGMENT
lodger : n, 숙박인, 하숙인, 동거인, 세든 사람
lodging : n, 하숙, 숙박, 숙소, 셋방, 하숙집 take one's ~ 하숙하다
lodging house : x, 하숙집
lodgment : n, 숙소, 군대의 숙영, 발판, (토사의) 퇴적, effect(make)a ~ 발붙일 곳(발판)을 마련하다
loess : n, 뢰스, 황토(중국 북부, 미시시피강, 라인강 유역 등의)
loess : n, 뢰스, 라인강 유역의 황토
lofi : a, 저충실도의
loft : n, vt, 고미다락, 위층, 올려치기, 우주선 쏘아 올리다
LOFT : n, 저주파 전파 망원경
loftbombing : n, 로프트 폭격법(비행기의 안전을 위해 저공으로 접근했다가 급상승하며, 폭탄을 투하)
lofter : n, 로프터(쳐올리기용 아이런 클럽)
lofty : a, 대단히 높은, 고상한, 숭고한, 당당한, 치속은, 거만한, 거드럭거리는
log : n, 통나무, 측정의, = ~ book 항해(항공)일지
log : vt, (나무를) 베어내다, 향해 일지에 적다
loganberry : n, 로건베리
logarithm : n, a, 대수, rithmic, mical
logarithmic : n, 대수
logbook : n, 항해일지, 항공 일지, 여정기록
log cabin : x, 귀틀집
loge : n, 극장 간막이, 좌석, 특별석
loger : n, 나무꾼, 통나무 적출기
logged : a, 움직임이 둔해진, (재목, 배 등)물에 젖어 무거워진, (땅이)질퍽질퍽한
loggerhead : n, 얼간이, 바보, at ~s 다투어(with)
loggerhead turtle : x, 붉은거북, 대서양산의 붉은거북
loggia : n, 베란다식 복도
logging : n, 통나무 벌채
logging train : x, (재목 반출용) 삼림철도
loghouse : n, =LOG CABIN
logic : n, 논리학, 논리, 조리, formal(symbolic)~ 형식(기호)논리학
logical : a, 논리적인, 논리학상의, 필연의
logicality : n, 논리성, 논리적 타당성, 논리(추리)의 적정(성)
logically : ad, 논리적으로
logician : n, 논리학자
logicism : n, 논리주의
logie : n, (연금에 쓰는) 모조보석
logion : n, (성경에 수록되지 않은)그리스도의 말
logistic : a, 병참술의
logistic : n, 기호 논리학 ~s , 병참술
logistics : n, 병참술(학), 병참 업무
logjam : n, (강물에 떠내려간)통나무가 한군데서 몰림, 정체(deadlock), 정지, 봉쇄
log line : x, 측정선
logo : n, =LOGOGRAM, =LOGOTYPE, 모토, 표어
logocentrism : n, 로고스 중심주의(문자 언어보다 음성 언어를 중시)
logoff : n, 단말의 사용을 종료하는 기계 조작의 절차
logogrammatic : a, 
logographer : n, 고대 그리스의 산문 작가(사가), (직업적)연설 기초자
logomachy : n, 말다툼, 입씨름, 글자 맞추기 놀이
logomania : n, =LOGORRHEA
logon : n, 단말 사용에서 메인 컴퓨터에 접속하기 위한 절차
logophile : n, 언어 애호자
logophobia : n, 언어 공포(불신)
logorrhea : n, (지리 멸렬한)병적 다변증
logos : n, 로고스, 이성, 하느님의 말씀
logotherapy : n, 실존 분석적 정신 요법
logotype : n, 연자 활자, 의장, 상표
logroll : vt, vi, n, 협력하여 통과시키다, (의안을 통과시키려고) 협력하다, (여럿이 하는) 통나무굴리기, (정당인의) 결탁
logroller : n, 협력해서 의안을 통과시키는 의원
logrolling : n, (협력해서 하는)통나무 굴리기, 투아나무 타기(경기), (특히 정치적으로의)협력, 결탁, 서로 돕기, (작가끼리)서로 칭찬하기
logwood : n, 로그우드, 남미 열대지방산의 나무
logy : a, 동작, 지능이)느린, 둔한(dull), 탄력이 없는
loid : n, (밤도둑이 자물쇠를 열 때 사용하는)엷은 셀룰로이드 조작
loin : n, 허리, (소 등의) 허리 고기
loincloth : n, (남양 토인 등의) 허리에 두르는 간단한 옷
loir : n, 큰산쥐
Lois : n, 여자 이름
loiter : vi, vt, n, a 빈들빈들 지내다, 어슬렁어슬렁 거닐다, ~er, ~ing
loiteringly : ad, 빈들빈들
Loki : n, 로키(파괴, 재난의 신)
loll : vt, vi, 척 기대다, 척 기대게하다, (혀 따위) 축 늘어지다
lollaby : n, 자장가
Lollard : n, 롤라드(14-15세개의 Wycliffe파의 교도)
Lollardy : n, 위클리프주의(개혁을 부르짖어 이단시당함)
lollipop : n, (보통 꼬챙이 끝에 붙인) 사탕, 교통지시관
lollop : vi, 강동강동 걷다, 비실비실 걷다
lolly : n, 캔디
Lombard : n, 롬바르드족의 사람, 16세기 이탈리아를 정복한 게르만 민족
Lombardy : n, 롬바르디아(이탈리아 북부의 주, 주도 Milan)
Lome : n, 로메(Togo의 수도)
Lomond : n, 스코틀랜드서부의 호수
Lomotil : n, 로모틸(특히 여행자용 설사약, 상표명)
London : n, 영국의수도, ~er
Londonderry : n, 북아일랜드의 주
londonism : 런던식(말투)n, 
lone : a, 외로운, 쓸쓸한
loneliness : n, 외로움, 쓸쓸함
lonely : a, 외로운, 쓸쓸한, 고립한, 외톨이
lonely heart : n, (결혼 상대를 얻지 못한) 고독한 여자
lonesome : a, 쓸쓸한, 고독의, 외로운
lone wolf : x, 독자적인 입장을 주장하는 사람, 고독을 즐기는 사나이
long : a, 긴, 길다란, 오래 걸리는, 지루한, 장음의, 강세의, 다량의, a ~ way off 먼 (from), draw a ~ face 침울(찌무룩)한 얼굴을 하다
long : ad, 길게, 오랫동안, 전부터, ...줄곧, all day ~ 종일, any ~er 벌써, 이 이상, at (the) ~est 길어야, 기껏해야, no ~er 이미 ... 아니다, ...이면
long : n, 오랫동안, 하기 휴가, 장모음, before(ere)~ 머지 않아, for ~ 오랫동안, The ~ and the short of it is that ... 간단히 말하자면, 결국은
long : vi, 간절히 바라다, 사모하다
longago : a, n, 옛날(의)
longarm : a, vt, vi, 긴 보조봉이 달린, 히치하이크(무임 편승)하다(로 가다)
longawaited : a, 대망의, 기다린 지 오랜
Long Beach : x, 미국 Los Angeles 근교의 도시, 해수욕장
longbill : n, 부리가 긴 새, 도요새
longboat : n, (범선에 싣는)대형 보트
longboat : n, 범선 적재의최대 보트
longbow : n, 큰 활, 긴 활
longbow : n, 긴활
longcloth : n, 엷고 가벼운 고급 무명(배내옷, 배냇저고리)
longcloth : 엷고 가벼운 무명(배넷저고리), 
longcloth : n, 옥양목
long clothes : x, 배내옷, 기저귀
long date : x, 장기의 상환 기일
longdated : a, (어음, 채권등)장기의
long distance : x, 장거리 전화, 장거리 교환국(수)
longdistance : a, 장거리의, a~call장거리 전화 호출
longdistance : a, n, 장거리의, 장거리 전화
long division : x, 장제법(12)이상의 수로 나누는 나눗셈
long dozen : x, 13개(baker's dozen)
long drawn : a, 길게 뺀(늘인), 길다란
long drink : x, 탄산수 등을 탄 술 (하이볼 등)
longe : n, vt, 조마용 줄, 원형 조마장, 조마용 줄로 길들이다, 
longeared : a, 기다란 귀를 가진, 당나귀 같이 멍청한(stupid)
longeared : a, 길게뺀, 길다란
long ears : x, 밝은귀, 나귀같은, 우둔한
longedfor : a, 대망의, 갈망의
longeron : n, 비행기 동체의 세로 뼈대
longeur : =LONGUEUR, 
longeval : a, 수명이 긴
longevity : n, 장수, 수명, ~pay연공 가봉
longevity : n, 장수, 수명
long face : x, 시무룩(침통)한 얼굴
longfaced : 얼굴이 긴, 침울한 얼굴의, 엄숙한(solemn), 
longfaced : a, 얼굴이 긴, 슬픈 듯 한, 우울한
long family : x, 대가족
Longfellow : n, 미국의 시인
long field : x , (크리켓)외야(long off 나 long on)
long finger : x, 가운뎃 손가락
long firm : x, 엉터리(사기)회사
longforgotten : a, 오랫동안 잊혀진
long green : x, (달러)지폐(greenback), 현금, 큰돈
longhair : n, 머리가 긴 사람, 지식인, 클래식 음악 연주가(애호가)
longhair : a, 예술가의, 인텔리 같은
longhaired : n, 장발의, 인켈리의, 젊고 반사회적인 히피적인
longhand : x, (속기에 대하여)보통 서법
longhand : n, 보통의 필기법
long haul : x, 장거리(수송), (the~)(괴로운)장시간, 장기에 걸친 어려운 일
longhead : n, 머리가 길쭉한 사람, 선견지명
longhead : n, 장두
longheaded : a, 머리가 길쭉한, 선견지명이 있는, 총명한
longheaded : a, 장두의, 총명한, 선견지명의
long hitter : x, 대주가
long hop : (크리켓)튀었다가 멀리 나는 공
longhorn : n, 롱혼(미국 남서부의 긴 뿔소, 체더치즈의 일종)
longhorn : n, 뿔이 긴 소
long hors : x, 뜀틀, 뜀틀 경기
long hours : x, 밤11시또는12시
longhouse : x, 공동 주택(남양토인의)
long hundredweight : x, 112파운드
longicorn : a, n, 촉각이 긴, 촉각이 긴 풍뎅이
longies : n, (겨울용)긴 내의, 남자 어린이용 긴 바지
longing : n, 갈망, 동경, ~for home, 고향을 몹시 그리워하고 있다, 
longing : a, ad, 갈망하는, ~ly
long interest : x, (강세가 예상되는)주시의 보유수
longisection : n, 종단면
longish : a, 기름한
longish : a, 기름한
Long Island : n, 롱 섬(미국 New York주 남도부의 섬)
Long Island Slund : n, 롱 아릴랜드 사운드
longitude : n, (길이, 세로의 뜻에서)경도, 황경, 세로
longitude : n, 경도
longitudinal : a, 경선의, 세로의, (연구가)장기적인
longitudinal : a, 경도의, 세로의
longitudinally : ad, 
longitudinal survey : x, 추적 조사
Long John : x, 키다리
long johns : x, (손목, 발목까지 있는) 긴속옷
long jump : x, 넓이뛰기
longleaf pine : x, (미국 남부산)대왕송, 대왕송재
longlegged : a, 다리가 긴, 발이 빠른
longline : n, 연승, 주낙
longliner : n, 주낙어선, 어부
longlived : a, n, 수명이 긴, 영속하는, ~ness
longlived : a, 명이 긴, 영속하는
long man : x, 롱 맨(한 패스플레이레서 가장 깊숙한 지점까지 달리는 리시버)
Long March : x, (the~)(중국 공산당의)대 장정
long measure : x, 척도
long meter : x, 장율(보통 약강 격 8음절4행으로 된 찬송가조)
long off : x, (크리켓)투수위 좌후방의 야수
long on : x, (크리켓)투수의 우후방의 야수
long pig : x, 인육, 인체
long play : x, LP판 레코드
longplay : a, (레코드가) 장시간연주의
longplaying : a, 장시간 연주 레코드의
long position : x, 상승 기대주를 매입, 보유한 상태(사람)
long pull : x, 장기에 걸친 일, 장거리 여행, 한잔 더 주기(손님을 끌기 위해)
long purchase : x, 강세 예상주 매입
longrange : a, 장거리에 달하는, 원대한
longreach : a, 멀리까지 이르는, 멀리까지 세력이 미치는
longrnage : a, 장거리의, 원대한
long robe : x, 법복, 성직자 옷
long run : x, 장기흥행, 롱런
longrun : a, 장기 흥행의
longrunning : a, 장시간에 걸친
long sale : x, 현물 매매, 실매
longship : n, 폭이 좁고 긴 galley 선 비슷한 배
longship : n, 대형선
longshore : a, 연안의, 항만의, 해안에서 일하는, ~fishery연안 어업
longshore : a, 연안의, 해변에서 일하는
longshoreman : n, 부두 노동자, 근해 어부
longshoreman : n, 부두노동자
longshort : n, 중편소설
long shot : x, 원사, 승산없는 말
long sight : x, 멀리까지 보임, 선견지명, 통찰력
longsighted : a, n, 면데 것을 볼 수 있는, 원시의, 탁견이 있는, ~ness
longsome : a, 기다란
longspun : a, 길게 잡아 늘인, 기다란, 지리한
longstanding : a, 여러해에 걸친
longsuffering : n, a, 참을성, 인내심, 인내심 강한, 참을성 있는
longterm : a, 장기의
longtimer : n, 고참자, 장기형의 죄수
Long Tom : x, 장거리포
long ton : x, 영톤, 2, 240파운드
long tongue : x, 다변, 수다
longtongued : a, 수다스러운
longueur : n, (소설, 음악 등의) 지루한 부분
longways : ad, 세로로, 길이로
longwearing : a, (옷 등이)질긴, 내구성이 있는
longwinded : a, 숨이 긴, 길다란
longwise : ad, =LONGWAYS
longwool : n, 길고 거친 털을 가진 양
loo : n, 카드놀이의 일종
loofah : n, 수세미 외
loogan : a, n, 얼간이, 멍청이, 프로 복서, 졸때기, 무뢰한, 맥주
look : vi, 보다, 바라보다, ...하게 보이다, ...의 얼굴모양을 하다, ...에 면하다, 조심하다, 기대하다
look : vt, 눈(짓)으로 나타내다, 눈여겨 들여다보다, 확인하다, 조사하다, ~ after 보살피다, 보호하다, 찾다, ~ ahead 장래임을 생각하다
look : n, 표정, 눈매, 용모, 일견, 모습, have(give, take)a ~ at ...을 (얼핏) 보다, have a ~ of ...와 비슷하다, ~er n, 보는 사람, 미녀
lookahead : n, a, 예견 능력, 예지 능력, 선견지명, 통찰력, (컴퓨터가)예견 능력이 이써는, 예지 능력에 의한
lookalike : n, 매우 흡사한 사람(것)
looker : n, 보는 사람, 미녀
lookerin : n, 텔레비젼 시청자
lookeron : n, 구경꾼, 방관자
lookin : n, 잠깐 들여다 봄, 잠시의 방문, 조사, 검토, 승리의 가망성, 승산
looking : a, ...으로 보이는, ...한 얼굴을 한
looking glass : x, 거울
lookingglass : a, 거꾸로의, 반대의
lookingin : n, 텔레비젼 시청
lookit : vt, int, 보아라(look at), 들어라, 들어봐
lookout : n, 감시, 경계망, 전망, 전도, 관심사
lookover : n, 검토, 음미, 대충 훑어 봄
looksee : n, 죽 훑어 봄, 검사, 조사, 시찰, (거리의 약장수 등의 휴대용)의사 면허증, (병사의)통행증, (일반적으로)허가증, 감찰
lookup : n, 룩업(키에 의해 항목이 구별되어 있는 배열이나 도표에서 데이터 항목을 가려내는 프로그래밍 기법)
loom : vi, n, 어렴풋이 보다
loom : n, 베틀, 직기
loon : n, 아비, 농병아리
loon : n, 얼간이, 게으름뱅이
loony : n, a, 미치광이
loony bin : x, 정신병원
loop : n, 고리, 공중회전, 프로그램중 명령반복 실행하기
loop : vt, vi, n, 고리 모양으로 만들다(되다), 죄다, 동이다, ~ 손 ~ 공중제비하다, ~er, 자벌레
looped : a, 동그라미가 된, 고리가 달린, 취한
looper : n, 고리를 만드는 사람(것), 자벌레, (재봉틀 등의)실 고리를 만드는 장치, 메리야스의 코를 잡아 매는 기계 장치, (크게(높게))원을 그리는 공, (골프의)캐디
loophole : n, 빠져나갈 구멍
loop line : x, 환상선
loopy : a, 정신이 이상한
loose : a, 매지않은, 풀린, 엉성한, 흐트러진, 낙낙한, 헐렁헐렁한, 포장이 나쁜, 설사하는, at a ~ END, at ~ ENDs, break ~ 탈출하다, cast ~ 풀다
loose : vt, 놓(아 주)다, 풀(어 주)다, (화살, 탄환을) 쏘다
loose : vi, 헐거워지다, 총포를 쏘다
loosebodied : a, (의복 등이)느슨한, 헐렁한
loose bowels : x, 설사
loosebox : n, (소, 말등을 매지 않고 자유롭게)놓아 기르는 외양간(box stall)
loose coins : x, 잔돈
loosefitting : x, 낙낙한, 헐거운
loosejointed : a, 관절이 헐거운, 유연한
looseleaf : a, (장부 등의 페이지를) 마음대로 바꾸어 꽂을 수 있는, 루스리프식의
looselimbed : a, 팔다리가 유연한(운동 선수 등)
loosely : ad, 매지않게, 풀리게, 엉성하게
loosen : vi, vt, 늦추다, 느그러지다, 풀리다, 흩어지다, 놓다, 놓아주다
looseness : n, 풀림
looseprincipled : a, 지조가 없는, 무절조한
loosestrife : n, 까치수염속, (특히)좁쌀풀
loose tongue : x, 수다쟁이
loot : n, 약탈물, 전리품, 부정이득, 돈
loot : vt, vi, n, 약탈하다, 부정 이득을 취하다, ~er, 약탈자
looter : n, 강탈자, 약탈자, 도둑, 부정 취득자
looting : n, 약탈, 부정이득
lop : vi, 늘어지다
lop : vt, (가지 따위를) 자르다, 치다
lope : vi, vt, n, 가볍게 달리다
lopear : n, 늘어진 귀
lopeared : a, 늘어진 귀의
lophophorate : n, 촉수 동물
loppings : n, 잘라낸 가지
loppy : a, n, 축 늘어진, (목장의)잡역부
lopsided : a, 한쪽으로 기울어진
loquacious : a, 말많은
loquacity : n, 수다, 다변
loquat : n, 비과(나무 열매)
loran : n, 로랜(두개의 무선국에서 오는 전파의 시간차를 이용한 자기 위치 측정 장치)
lord : vi, vt, 군주, 주인, 하느님, 영주, 권력자, 신, drunk as a ~ 곤드레 만드레 취하여, ~liness n, ~ship n, 귀족(군주)임, 주권, 영지
Lord Chamberlain : x, 궁내 대신
Lord Chief Justice : x, 수석 재판관
Lord High Chancellor : x, 대법관
lordinwaiting : n, (영국 왕실의)시종
lordling : n, 소 군주, 시시한 귀족
lordly : a, 귀족다운, 당당한, 왕후와 같은
Lord Mayer : x, 대도시의 시장
lordosis : n 척추 전만증
Lord Privy Seal : x, 옥새 상서
Lord Protector : x, 호민관
lordship : n, 귀족임, 군주임
lord spiritual : x, 성직 상원 의원
lord temporal : x, 귀족 상원 의원
lore : n, 지식, 학문, 전승, ghost ~ 유령전설
lorelei : n, 로렐라이(아름다운 미녀)
Lorenzo : n, 남자 이름
Loretta : n, 여자 이름
lorgnette : n, 오페라 글라스, 자루달린 안경
lorgnon : n, 안경, (특히)코안경
lorha : n, 서양식 선체의 중국배
lorikeet : n, 진홍잉꼬(호주산)
loris : a, 고독한, 의지할 데 없는, 적적한, 외로운
Lorna : n, 여자 이름
Lorraine : n, 여자 이름, 로렌(프랑스 동부의 지방)
lorry : n, 화물 자동차
lorryhop : vi, 트럭 편승 여행(무전 여행)을 하다
lory : n, 진홍잉꼬과의 새(호주산)
lory : n, 진홍잉꼬
LOS : x, Loss of Signal 신호 중단
losable : a, 잃기(없어지기)쉬운
Los Alamos : x, 미국 New Mexico 주 북부의 도시, 원자력 연구의 중심지
Los Angeles : x, , 로스앤젤리스, 미국캘리포니아주 남서부 도시
lose : vt, , 잃다, 늦어서 못타다, 지다, 패하다, 벗어나다, ...을 잃게하다
lose : vi, 줄다, 쇠하다, 손해보다, 실패하다, (시개가) 늦다, be lost upon ...에 효과가 없다, ~ oneself 길을 잃다, 정신 팔리다
losel : n, a, 방탕한 사람, 무뢰한, 쓸모없는, 방탕한
loser : n, 손실자, 유실자
losing : n, a, 패배의, 승산없는, 실패의
loss : n, 손실, 상실, 손해, 실패, 패배, 소모, at a ~ 곤란하여, 어쩔 줄 몰라서
loss leader : x, 특매품
lossmaker : n, 적자 기업
lossmaking : a, 계속 적자가 나는
lost : v, lose의 과거(분사)
lost : v, 잃은, 놓친, 길잃은, 진, 허비한, 정신팔린, 파멸된, 죽인, 헛되이, be ~ in ...에 잠겨있다, give up for ~ 가망 없는 것으로 치고 단념하다
Lost Generation : x, 잃어버린 세대
lot : n, 운, 제비, 당첨, 추첨, 몫, 무리, 패, 한구획의 토지, 많음, a ~ of, or ~s of 많은, cast(cut, draw)~s 제비를 뽑다
lot : vt, vi, 구분하다
Lothario : n, 탕아, 난봉꾼
Lothian : n, 로디언(스코트러랜드 Forth만 남쪽의 주, 1975년 설립)
lotion : n, 세척제, 외용 물약, 화장수, 로션, 술
lotion : n, 바르는 물약, 세제, 화장수
lots : n, 배우, 훨씬 더(much)
lotta : a, 많은(a lot of)
lottery : n, 복권, 추첨
lotto : n, 숫자맞추기
lotus : n, 연꽃, 망우수
lotuseater : n, 쾌락주의자, 무의미하게 일생을 보내는 사람
lotuseating : n, 일락(을 일삼는)
loud : a, 소리가 큰, 떠들썩한, (빛깔, 복장 따위가) 화려한, 극성스러운, 주제넘는, 야비한, ~ish a, 좀소리가 높은, 좀 지나치게 화려한
loud : ad, 큰소리로, 야(천)하게, 불쾌히
louden : vi, vt, 목소리가 커지다(를 크게 하다), 떠들썩하게 되다(하다)
loudhailer : n, (앰프가 내장된)휴대용 확성기
loudish : a, 약간 소리가 큰, 떠들썩한, 야한
loudly : ad, 큰소리로
loudness : n, 큰소리
loudspeaker : n, 확성기, 시끄러운 여자
loudspoken : a, 목소리가 큰
lough : n, 호수, 후미
Louis : n, 루이스, 프랑스왕의 이름
Louisiana : n, 미국남부의 주
lounge : n, 만보, 거니는 장소, 휴게실
lounge : vi, vt, 한가롭게 게닐다, 축 늘어져 기대다, 빈들빈들 지내다
lounge lizard : x, 난봉꾼
lounger : n, 거니는 사람, (빈둥거리는)놈팡이(idler)
lounging : a, (옷이)편하게 입을수 있는, 레저 용의, 활기(기운)없는, 게으른
loung suit : x, 신사복
loupe : n, 루페(보석상, 시계상 등의 강력 확대경)
lour : vi, 얼굴을 찌푸리다, 이맛살을 찌푸리다
louring : a, 기분이 좋지않은, 잔뜩 찌푸린
louse : n, 이, 기생충, 천한녀석
louse : ...의 이를 잡다, ~ up 결판내다, 
lousewort : n, 송이풀(속의 총칭)
lousy : a, 이 투성이의, 불결한, 지독한, 인색한
lout : n, 무작한 자, 촌놈, ~ish a, 
louver : n, 미늘살 창
Louvre : n, 루브르 박불관
lovable : a, 사랑스러운, 귀여운
love : n, 사랑, 애정, 애호, 자애, 경모, 동정, 연애, 애인, 사랑하는 자, fall in ~ with ...을 사랑하다, for ~ 좋아서, 거저
love : vt, vi, 사랑하다, 좋아하다, 그리워하다, Lord ~ you! 맙소사! ~d a, 사랑을 받고 있는
loveable : a, =LOVABLE
love affair : x, 연애, 정사
love apple : x, 토마토
lovebird : n, 모란잉꼬 무리, 사이좋은 부부(애인)
lovebombing : n, (종파(cult)의 신자 획득을 위한)애정 공세
lovebug : n, 날벌레의 일종(미국 멕시코만 연안 주의 흑색 곤충, 교미기(봄)에는 떼지어 다니며 자동차 교통의 장애가 됨
love child : x, 사생아
loved one : x, 시신, 주검
love feast : x, (초기 기독교의) 애찬, 친목회
love game : x, 제로게임
lovegbegotten : a, 사생의, 서자의
love generation : x, 히피족
lovehate : n, (동일 대상에 대한)강한 애증(의)
lovein : n, (히피족 따위의) 사랑의 모임
loveinidleness : n, 팬지(야생의 삼색 제비꽃)
lovejuice : n, 미약, 최음약, 애액, 체액, 정액
love knot : x, (리본 따위의) 사랑매듭
Lovelace : n, 난봉꾼, 색마
loveless : a, 사랑하지 않는
love letter : x, 연애편지
loveliesbleeding : n, 줄맨드라미
loveliness : n, 사랑스러움, 아름다움, 매력, 멋짐
lovelock : n, (이마의) 애교 머리카락
lovelorn : a, 사랑에 고민하는
lovely : a, n, 사랑스러운, 멋진, 사랑스러움
lovemaking : n, 구애, 구혼, 애무, 포옹, 성교
love match : x, 연애결혼
love nest : x, 사랑의 보금자리
lovephilter : n, 미약
love potion : x, 미약
lover : n, 연인, 애인, 애호자, 찬미자
love scene : x, 러브신
love seat : x, 두사람이 앉게된 소파
love set : x, 패자가 한 게임도 따지 못한 세트
lovesick : a, 사랑에 고민하는
lovesickness : n, 상사병
lovesome : a, 사랑스러운, 아름다운, 귀여운, 애교 있는, 요염한
love song : x, 연가
love story : x, 연애소설
lovetoken : n, 사랑의 정표(로서의 선물)
lovey : n, 애인, 여보(darling)
loveydovey : a, 맹목적인 사랑에 빠진, 달콤한
loving : a, ad, 애정을 품고있는, 사랑하는, 친애하는, ~ly
loving cup : x, 우애의 술잔
lovingkindness : n, 자애
low : vt, vi, (소 따위가) 움매하고 울다, 굵은 목소리로 말하다
low : n, 소의 울음소리
low : a, 낮은, 저지의, 저급한, 침울한, 값싼, 적은, 검소한, 저조의, 저음의, be in ~ water 돈에 궁하다, bring ~ 쇠퇴케 하다, 줄이다
low : ad, 낮게, 낮은 곳에, 야비(천)하게, 싸게, 검소한 음식으로, 적도 가까이, ~ down 훨씬 아래에, 푸대접하여
low : n, 낮은 것, 저속기어, 저기압
lowborn : a, 태생이 미천한
lowboy : n, 다리가 낮은 옷장
lowbred : a, 버릇이 나쁜
lowbrow : a, 교양없는 사람, (영화, 소설 등) 저급한
lowbrowed : a, 이마가 좁은, (바위가)쑥 나온, (건물이)입구가 낮은, 교양이 낮은
lowcal : a, 저칼로리의(식사)
Low Church : x, 저교회파(영국 국교파중, 교회의 교리, 의식에 중점을 두지 않는 한 파)
Low Churchman : x, 저교회파의 사람
lowclass : a, =LOWERCLASS
low comedy : x, 저속한 코미디
lowcost : a, 비용이 적게 드는, 값싼
Low Countries : x, 지금의 Benelux의 총칭
lowcountry : a, COUNTRIES의
lowdown : n, a, 실정, 진상
Lowell : n, 남자 이름
lowend : a, (비교적)싼, 저급의
lower : vi, (끌어) 내리다, 낮추다, 꺾다, 누르다, 내려가다, 낮아지다
lower : x, 더 낮게(은), 하급(하층)의, 열등한 내려가는, 비천(비열)한, 저하시키는
lower case : x, 소문자용 케이스
lowercase : a, 소문자의, 소문자로인쇄하다
lower classes : x, 하층계급
lower deck : x, 하갑판
Lower House : x, 하원
lowering : a, 내려가는, 비천한, 저하시키는
lowermost : a, 최하의, 맨 밑바닥의
lower world : x, 하계, 현세, 지옥
lowery : a, (날씨가)험상궂은, 음울한, 기분이 좋지 않은
lowest : n, 최하의, 최소의, at the ~ 적어도
lowest common denominator : x, 최소 공배수
low frequency : x, 저주파
lowgrade : a, 질이 낮은, 저질의
lowincome : a, 저소득의, 저수입의
lowing : a, n, 음매하고 우는, 소의 울음 소리
lowkey : a, 자제하는, 감정을 내색하지 않는, (화면이)어둡고 명암의 대비가 적은
lowland : n, a, 저지, 평원지방, ~er 저지 사람, 스코틀랜드 저지 사람
lowlife : n, 비열한 녀석, 못된 놈, 범죄자
lowliness : n, 자기를 낮춤, 겸양, 겸손, 비천함, 다라움
lowlived : a, 천한(낮은)생활을 하는, 천한, 비열한
lowly : a, 신분이 낮은, 비천한, 천하게, 초라한, 겸소한
lowlying : a, (땅이) 낮은
Low Mass : x, 평미사
lowminded : a, 야비한
lowneck : n, 목을 깊숙이 판 여자옷
lownecked : a, 깃을 깊이 판
lowness : n, 낮음, 미천야비, 헐값, 의기소침
lownumbered : a, 번호가 밑쪽의(작은)
lowpitched : n, 저조한, 경사가 느린
lowpowered : a, 저출력의, 마력이 적은
lowpressure : a, 저압의, 저조한
low relief : x, 얕은 돋을새김
lowrider : n, 차대(chassis)를 낮춘 차, 그 운전자, 핸들을 높인 오토바이 운전자, 슬럼가의 (난폭한)젊은이, (죄수들 돈을 갈취하는)교도소 내의 깡패
lowriding : n, 차체를 낮춘차를 몰고 다님
lowrise : a, (건물의) 층수가 적은, 높이가 낮은
lowspirited : a, 의기소침한, 우울한
Low Sunday : x, 부활절 다음의 일요일
low tea : x, 간단한 식사
lowtechnology : a, (일용품 생산에 이용될 정도의)수준이 낮은 기술의
lowtension : n, 저압(저전압)용(의)
lowtest : a, (휘발유가)비등점이 높은, 휘발도가 낮은
low tide : x, 간조, 썰물
lowveld : a, 
lowwaisted : a, 웨이스트라인(waistline)을 낮춘 스타일의
low water : x, 간조, 최저수면
lowwater mark : x, 간조표, 최저점
lox : n, 액체산소
loxodromic : a, 등사 항법의, 등사 곡선의
loyal : a, 충성스러운, 충성의, 충의의, 충실한
loyalism : n, 충성, 충절
loyalist : n, 충성스러운(충실한)사람, 왕(보수)당원, (독립 전쟁때의)영국 당원, (스페인 내란 때의)국왕지지자
loyalist : n, 충성자
loyally : ad, 충성스럽게, 충실(성실)하게
loyalty : n, 충성, 충절
loyalty oath : x, 합중국에 대한 충성의 선서
Loyola : b, 로욜라(1491-1556)(스페인의 성직자, 예수회(Society of Jesus)의 창설자)
lozenge : n, 마름모꼴, 마름모꼴의 면
LP : n, 장시간 레코드
LP : a, 장시간 연주의
LPG : n, liquefied petroleum gas 석유가스
luau : n, 하와이식 파티
Luba : n, 루바족(자이르 남동부에 사는 흑인족의 하나), 루바어
lubber : n, 덩지 큰 뒤틈바리, 느림보, 풋내기 선원, ~ly a, ad, 무미한(하게), 볼품없는(없게)
lubberly : a, ad, 무뚝뚝한(하게), 볼품없는(없게), 데퉁스럽게(스러운)
lube : n, 윤활유
lubra : n, 원주민 여자, (일반적으로)여자
lubricant : a, n, 매끄럽게 하는, 윤활제
lubricate : vt, 기름을 바르다, 매끄럽게 하다, 취하다, 뇌물을 주다
lubricating oil : x, 윤활유
lubrication : n, 미끄럽게 함
lubricative : a, 미끄럽게 하는
lubricator : n, 기름치는 기구(사람)
lubricious : a, 매끄러운, 붙잡기 곤란한, 불안정한, 교활한
lubricity : n, 매끄러움, 원활, 재치있음, 음탕
lubricous : a, 미끄러운, 포착하기 어려운, 정해지지 않은, 덧없는, 무상한, 음탕한, 외설한, 호색의
lubritorium : n, 주유소
Lucan : a, 성 누가의
lucency : n, 광휘, 투명(성)
lucent : a, 빛나는, 번쩍이는, 투명한
lucern : n, 자주개자리
luces : n, LUX의 복수
Lucia : n, 여자 이름
Lucian : n, 남자 이름
lucid : a, 명백한, 맑은, 투명한
lucid interval : x, (미치광이의) 평정기
lucidity : n, 밝기, 광명, 맑음, 청명, 투명, 명료, 명석, 평정(미친 사람의), 본정신, 제정신
lucifer : n, 샛별, 금성
luciferase : n, 루시페라아제, 루시페린의 산화를 돕는 효소
luciferin : n, 루시페린, 개똥벌레 따위의 발광물질
luciferous : a, 빛나는, 번쩍이는, 빛을 주는, 계발 하는
lucifugous : a, 일광을 피하는, 배일성의
Lucite : n, 플라스틱 유리
Lucius : n, 남자 이름
luck : n, 행운, 운, as ~ would have it 다행히, 불행히도, bad(ill)~ 불행, 불운, Bad ~ to ...에게 천벌이 있기를! down on one's ~ = UNLUCKY
luckily : ad, 운좋게, 다행히도, 상서롭게
luckiness : n, 운이 좋음, 행운
luckless : a, 불행한
luckpenny : n, 행운의 돈(재수 좋으라고 가지고 다니는 주화, 거래 성립시에 파는 사람이 사는 사람에게 돌려 주는 돈)
lucky : a, 행운의, 운이좋은, 상서로운, ~ beggar(dog)행운아, 재수 좋은 사람, ~ guess(hit)소경 문고리 잡기
lucky : n, 도망, cut one's ~ 도망치다
lucky bag : x, (바자회 등에서 뽑는) 복주머니
lucrative : a, 이익있는, 돈벌이가 되는
lucre : n, 이익, 돈, 부, filthy ~ 부정한 돈
Lucretia : n, 여자 이름, 르크레티아(고대 로마 전설에 나오는 열녀의 이름), (일반적으로)열녀, 정숙한 여자의 귀감
lucubrate : vi, 밤늦도록 공부하다, 고심하여 저작하다
lucubration : n, 한밤의 공부, 고심의 노작
luculent : a, (설명 등이)명쾌한, 명료한, 빛나는, 밝은
Lucullan : a, (음식이)호화로운, 사치스러운
Lucy : n, 여자 이름
Lucy Stoner : x, 결혼후에도 미혼때의 성을 고수하는 여자
Luddite : n, 러다이트(영국의 산업혁명 당시(1811-16)실직을 염려하여 기계파괴 둔동을 반대하는 사람)
ludicrous : a, 익살맞은, 우스운, 바보같은, 시시한
ludo : n, 주사위로 하는 점수 따기 놀이
lues : n, 매독, 역병, 전염병
luetic : a, 매독의(에 걸린)
luff : n, vi, vt, 역풍 항진(하게하다), (요트 경주에서 상대편의) 바람부는 쪽으로 가다
lug : vi, vt, n, 세게 끌다, 힘껏 끎, 잡아당기다, 잡아당김 = lugworm 갯지렁이
lug : n, 돌출부, 손잡이, 멍청이, 귀
luge : n, (스위스의) 산을 타기 위한 썰매, (스위스식) 터보건 썰매
luggage : n, 수하물, 여행가방
lugger : n, 작은범선의 일종
lughole : n, 귓구멍
lugsail : n, 러그세일(뒤폭이 더넓은 네모꼴 세로돛)
lugubrious : a, 슬픈듯 한, 애처로운, 가엾은
lugworm : n, 갯지렁이(낚시 미끼)
Luke : n, 누가, 누가복음
lukewarm : n, 미지근한, 미적지근한, 열의없는
lukewarmness : n, 미적지근함, 열의없는
lull : vt, (어린애를) 달래다, 어르다, (바람, 병세, 노염 등을) 가라앉히다, 진정시키다
lull : vi, 자다, 가라앉다
lull : n, (폭풍우 따위의) 잠잠함, 뜸함, (병세의) 소강 상태, (교통, 회화의) 두절, 잠깐 쉼
lullaby : n, 자장가
lulling : a, 달래는(어르는)(듯한)
lulu : n, 굉장한 사람, 거물
lumbago : n, 요통, 산기
lumbar : a, n, 허리의, 요추
lumber : n, 재목, (낡은 가구 따위의) 잡동사니
lumber : vt, 난잡하게 쌓다, 올리다, 목재로 장소를 막아버리다
lumber : vi, 목재를 베어내다
lumber : vi, 쿵쿵걷다, 무겁게 움직이다
lumberjack : n, 벌목꾼
lumberman : n, 재목상
lumbermill : n, 제재소(sawmill)
lumber room : x, 허섭쓰레기를 두는 방 또는 광
lumbersome : a, =CUMBERSOME
lumberyard : n, 재목두는 곳
lumen : a, 빛나는
luminal art : x, 빛의 예술, 빛나는 예술
luminance : n, 광휘, 휘도
luminant : a, n, 빛나는, 빛을 내는, 광채를 내는, 발광체
luminary : n, 발광체, 태양, 달, 지도자, 명사
luminesce : vi, 냉광을 발하다
luminescence : n, 냉광
luminescent : a, 발광성의
luminiferous : a, 빛을 발하는, 빛나는
luminosity : n, 밝음
luminous : a, (스스로, 또는 반사로) 빛나는, 밝은, 명쾌한
lummox : n, 뒤틈바리
lump : n, 덩어리, 많음, 멍청이, a ~ in one's(the)throat (감격으로) 목이 메는(가슴이 벅찬)느낌, in(by)the ~ (대충) 통틀어, 총체로
lump : vt, vi, 덩어리로 만들다, 덩어리지다, 한묶음으로(총괄)되다(하다), 어슬렁어슬렁 걷다, 털썩 주저앉다
lump : vt, 참다, 견디다
lumpectomy : n, 유방 종양 절제술, 유선 종류 적출술
lumpen : a, 사회에서 탈락한, 룸펜의
lumper : n, 부두 노무자, 하역 인부, 청부업자, 총괄적으로 정리(분리)하는 사람
lumpfish : n, 성대의 무리
lumping : a, 무거운, 부피가 큰, 덩치 큰, 총괄한, 한데 묶은, 많은
lumpish : a, 덩이져서 묵직한, 작달막한, 멍텅구리의
lump sugar : x, 각사탕
lump sum : x, (대충 잡은) 총액
lumpy : a, 흑투성이의, (바다가) 파도가 일고 있는, 투미한
Luna : n, 달의 여신, 달
lunabase : n, 달의 바다(부분)(평탄부)(의)
lunacy : n, 정신이상, 미친증세, 어리석은 짓
lunanaut[=LUNARNAUT
lunar : a, 달의, 초승달 모양의
lunar eclipse : x, 월식
lunarian : n, (상상적인)달주민, 달 전문가, 달 물리학자
lunar lander : x, 달 착륙선
lunar module : x, 달 착륙선
lunar month : x, 태음월
lunarnaut : n, 달 여행 우주비행사
lunar orbiter : x, 미국의 달 무인 탐사기
lunarscape : n, 월면 광경
lunar treaty : x, 달 조약
lunate : a, 초승달 모양의
lunatic : a, n, 미친, 미친사람
lunatic asylum : x, 정신병원
lunatic fringe : x, (사상, 운동 등의) 극단파, 열광적 지지자, ~er 열광자
lunation : n, 태음월, 삭망월(초승달부터 다음 초승달까지의 기간)
lunch : n, vi, vt, 점심, 점심을 먹다
lunch car : x, 이동식 노점
lunch counter : x, 런치용 식탁, 간이식당
luncheon : n, 오찬, 점심
luncheonette : n, 간이식당
luncheon voucher : x, 식권
lunchroom : n, 간이식당
lunchtime : n, 점심시간
lune : n, 활꼴, 반원형(의 물건)
lunette : n, 초승달 모양의 물건(공간), 아치형 채광창, (둥근 지붕이 벽과 접촉되는 곳에 생긴)반원 공간, 안경보, 반말굽쇠, (시계의)평면유리 뚜껑, 견인차의 접속용 고리
lung : n, 소리가 크다
lunge : n, vi, 찌르기, 찌르다, (말이) 차다
lunge : vt, (칼을) 불쑥 내밀다
lunged : a, 폐가 있는, 폐와 같은
lungfish : n, 폐어(인도의)남자용 허리 두르게
lungpower : n, 발성력, 성량, (발성으로 본)폐의 힘, (도시안의)녹지, 공원
lungwort : a, 지치과의
luniform : a, 달모양의, 반달 모양의
Lunik : n, 소련이 쏘아 올린 일련의 달 로켓의 하나
lunilogical : a, 달연구의, 달 지질 연구의
lunisolar : a, 해와 달의
lunitidal : a, 월조의, 태음조의
lunker : n, 큰 것, (특히 낚시의)대어
lunkhead : n, 바보
lunkheaded : a, 멍청한
Lunokhod : n, 소련의 자동 월면차
lunula : n, 초승달 모양의 것(무늬), 속손톱, 활 꼴, 위성
lunulate : a, 초승달 모양의 얼룩무늬가 있는, 초승달 모양의
Lupin : n, 루핀콩
lupine : a, 이리의, 잔인한
lupous : a, 낭창성의, 결핵성 부스럼의
lupus : n, 낭창(피부 결핵), 이리자리
lurch : n, (경기의) 대패, leave a person in the ~ (친구 따위가) 곤경에 빠져 있는 것을 모른체하다
lurch : n, vi, 경사, 비틀거림, 경향
lurcher : n, 좀도둑, 사기꾼, 스파이, 일종의 사냥개
lure : n, vi, vt, 매력, 미끼(로 꾀어들이다), 유혹(하다)
Lurex : n, 루렉스(플라스틱에 알루미늄 피복을 한 의복, 가구용 섬유, 상표명)
lurgy : n, 병(영국의 라디오 코미디 프로)
lurid : a, (하늘 따위가) 섬쩍지근하게(타는 듯이)붉은, 창백한, 무시무시한, 무서운, cast a ~ light on ...을 무시무시하게 보여주다(설명하다)
lurk : vi, 숨다, 잠복하다
lurking : a, 숨어(잠복해)있는
lurkingly : ad, 숨어서, 남몰래
Lusaka : n, 루사카(Zambgia의 수도)
luscious : a, 맛있는, 감미로운, 보기에 즐거운, 지루한
lush : a, (풀이) 파릇파릇하게 우거진, 풍부한, 유리한
lushy : a, 술 취한(drunk)
Lusitania : n, 루시타니아(이베리아 반도에 있던 옛로마령, 지금의 포르투갈)
lust : n, vi, 육욕, 열망
luster : n, (은은한) 광택, 광휘, 빛남, 밝기, 광택있는 모직물, 샹들이에, 촉대
luster : vt, 광택을 내다
lustered : a, 광택있는
lusterless : a, 광택이 없는
lusterware : n, 진주 광택이 나는 도자기
lustful : a, 음탕한, 색골의
lustily : ad, 튼튼하게
lustiness : n, 강건
lustra : n, LUSTRUM의 복수
lustral : a, 불제의, 깨끗이하는, 5년마다의, 5년에 1번의
lustrate : vt, 불제하다, 깨끗이하다
lustration : n, 정화, 재계
lustre : n, 광택
lustring : n, =LUTESTRING
lustrous : a, 광택있는
lustrum : n, (5년마다의)대재계, 5년간
lusty : a, 튼튼한, 원기 왕성한
lutanist : n, 류트 연주자
lute : n, 루트, 기타 비슷한 악기
lutein : n, 루테인(혈청, 노른자 등의 황색소)
lutetium : n, 루테튬(희토류 원소, 기호 Lu)
Luther : n, 루터, 독일의 종교개혁가
Lutheran : a, n, 루터파의 (사람)
lux : n, 럭스, 조명도의 국제단위
luxe : n, 화미, 사치, 우아, edition de ~ (책의) 호화판, train de ~ 특별열차
luxemburg : n, 룩셈버그, 독일, 프랑스, 벨기에에 둘러싸인 대공국, 이 나라의 수도
luxon : n, 룩손(질량이 0이며, 광속도로 운동하는 입자의 총칭)
luxuriance : n, 무성, 풍부, 다산, (문체의)화려
luxuriant : a, 무성한, 다산의, 화려한
luxuriate : vi, 무성하다, 호사하다, 즐기다, 탐닉하다
luxurious : a, ad, n, 사치스런, 호화스런, 사치를 좋아하는, 매우 쾌적한, ~ly, ~ness
luxury : n, 사치, 호화, 사치품, 비싼 물건, 쾌락
Luzon : n, 루손섬(핀리핀 군도의 주도)
lyase : n, 리아제(탈탄산 효소(decarboxylase)등의 효소)
lycanthrope : n, 이리 들린 사람(자기가 이리가 되었다고 믿는 미친 사람), 이리가 된 사람
lycanthropy : n, (마녀, 무당이)이리로 둔갑하는 마력, 낭광(자신을 이리라고 여기는 정신병)
lycee : n, (프랑스의) 국립 고등 학교
lyceum : n, 학원, 학회, 강당, 학우회
lychnis : n, 홍매동자꽃속
Lycia : n, 러시아(고대 소아시아의 한지방)
lycopod : n, 석송속의 식물
lycopodium : n, 석송속
Lycurgus : n, 리크르구스(기원전 9세기의 고대 스파르타의 입법자)
lyddite : n, 강력 폭약(의 일종)
Lydia : n, 소아시아 서부에 번영한 옛나라
Lydian : a, n, LYDIA의, 리디아 사람(말)의, 요염한, 육감적인(sensuous), 유약한, 환락적인, 리디아 사람, 리디아 말
lye : n, 잿물, 세탁용 알칼리액
lying : a, 거짓말의, 거짓말쟁이의
lyingin : n, a, 해산, 분만, 산과의
lyingin hospital : x, 산과병원, 산원
lyinginstate : n, 유해의 일반 공개(헌화를 받기 위해 공적 인물의)
lykewake : n, 철야, 밤샘
Lyly : n, 영국의 소설가 또는 극작가
lymph : n, 임파액, 혈청, 두묘액, 깨끗한물
lymphatic : a, n, 임파액의, 연약한, (성질이) 굼뜬
lymph gland : x, 임파선
lymphocyte : n, 림프톨(세포)
lymphogranuloma : n, 임파 육아종, 서예임파 육아종
lymphography : n, 임파관 조영(촬영)법
lymphoid : a, 임파의, 임파성의
lymphokine : n, 림포카인(T세포가 분비하는 화학 물질)
lymphopoiesis : n, 임파구 생성(신생)
lymphosarcomatous : a, 임파 육종의
lymphotoxin : n, 림포 톡신, 세포 장애 인자
lyncean : a, 스라소니 같은 눈을 한, 안광이 매서운
lynch : n, vi, 사형, 린치를 가하다
lyncher : n, 사형(린치)를 가하는 사람
lynching : n, 폭력적인 사적 제재(특히 교수형)
lynch law : x, 사형
lynchpin : n, =LINCHPIN
Lynd : n, 린드(1879-1949)(아일랜드 태생의 영국 술필가, 비평가)
lynx : n, 살쾡이(의 털가죽)
lynxeyed : a, 눈빛이 날카로운, 눈이좋은
lyonnaise : a, 얇게 썬 양파와 함께 기름에 튀긴
lyonnesse : a, (감자를)다진 양파와 함께 요리한
Lyons : n, 리용, 프랑스남 동부의 도시
lyophilic : a, (콜로이드가)친액성인, 친화성이 강한
lyophilize : vt, 동결건조하다
lyophobic : a, (콜로이드가)소액성의, 친화력이 약한
Lyra : n, 리라, 거문고 자리
lyrate : a, 수금(리라)모양의
lyre : n, 리라, (손에 들고 타는 옛날의 작은 수금), 서정시
lyrebird : n, 금조
lyric : n, a, 서정시(의, 적인)
lyrical : a, 서정시조의
lyrically : ad, 서정적으로
lyricism : n, 서정시체
lyricist : n, 서정시인
lyrist : n, =LYRICIST
lyrist : n, LYRE의 탄주자
Lysenkoism : n, 리셍코학설, 환경유전학설
lysergicacid : n, 리세르그산
lysin : n, 리신, 세포 용해소
lysine : n, 리진(아미노산의 일종)
lysis : n, 세포의 용해, 병세 감퇴, 환산, 소산
lysogen : n, 용원, 리소겐, 용원균(주)
lysogenic : a, (바이러스, 세균이)용원성인
lysogenize : vt, 용원화하다
lysogeny : n, 용원성
Lysol : n, 리졸(소독액)
lysosomal : a, 
lysosome : n, 리소좀
lysostaphin : n, 리소스타핀(포도상구균에서 얻는 항균성 효소)
lysozyme : n, 라이소자임
lyssa : n, 광견병, 공수병
lytic : a, 세포를 용해하는, LYSIN의, LYSIS의
Lytton : n, 리튼(영국의 소설가, 극작가, 정치가)
