N : n, 알파벳의 14째 문자, N자 모양(의 것), (수)부정수, 부정 정수, (연속물의)14번째(의 것)(J를 넣지 않을 때의)13번째(의 것)
N : x, (체스)knight, (화)nitrogen
n : suf, EN
n't : x, NOT의 단축형
n. : x, nephew, net, neuter, new, night, nominative, note, noun, number
N. : x, National(ist), Norse, November
N. & Q. : x, Notes and Queries
n., N, N. : x, north, northern
n., N. : x, name, navigation, navigator, navy, neutron, new, noon, (화)normal
N.A. : x, National Academy(Army), North America(n)
N.A.B : x, National Association of Broadcasters전미국 방송협회, New American Bible
N.A.S.D : x, National Amalgamated Stevedores and Dockers, National Association of Security Dealers
N.A.U. : x, (미)전국 체육연맹
N.AM. : x, North American
N.B, n.b. : x, nota bene주의(하라)
n.b. : x, 크리켓no ball
N.B. : x, New Brunswick, North Britain
N.B.G, n.b.g : x, no bloody good(영구)가망없음
N.B.R : x, North British Railway
N.C : x, New church, North Carolina
n.c. : x, (화)nitrocellulose
N.C.B. : ㅌ, National Coal Board
N.C.C.J. : x, National Conference of Christians and Jews
N.C.C.L. : x, National council for Civil Liberties
N.C.C.M. : x, National Council of Catholic Men
N.C.C.V.D. : x, National Council for Combating Venereal Diseases
N.C.C.W. : x, National Council of Catholic Women
N.C.E. : x, New Catholic Edition
N.C.I. : x, (미)National Cancer Institute
N.C.N.A. : x, New China News Agency신화사(Xinhuashe)
N.C.R. : x, no carbon required 카본지 불요
N.C.U. : x, National Cyclists' Union
n.c.v. : x, nocommercial value
n.d. : x, no date, no delivery, not dated
N.D.C. : x, national defence contribution
N.Dak., N.D. : x, North Dakota
n.e. : x, northeast(ern)
N.E., N/E : x, no effects
N.E.B. : x, National Enterprise Board, New English Bible
N.E.D., NED : x, New English Dictionary
N.E.D.C. : x, (영)National Economic Development Council
N.E.I. : x, Netherlands East Indies
N.E.R. : x, (영)North-Eastern Railway
N.E.R.C. : x, Natural Environment Research Council(영)자연 환경조사국
n.e.s., N.E.S. : x, not elsewhere specified(stated)별도로 특별기재가 없을 경우에는
N.Eng. : x, New England, North(ern) England
N.F, n/f : x, 예금 없음
N.F. : x, Nesfoundland, Norman French
N.F.L. : x, National Football League
N.F.S. : x, National Fire Sevice
N.F.U. : x, National Farmer' Union
N.G. : x, National Guard, New Granada, New Guinea, no good
N.H.I. : x, national Health Insurance(영)국민 건강 보험
N.H.P., n.h.p. : x, nominal horsepower
N.H.S. : x, National Health service
N.Heb. : x, New Hebrides
N.I. : x, national insurance, Northern Ireland
N.I.R.A., Nira : x, (미)전국 산업 부흥법
N.J, NJ : x, New Jersey
N.K.G.B. : x, narodnyi Komissariat Gosudarstvennoi Bezopasnosti(Russ.=People's Commissariat for State Security)국가안전 인민 위원부(소련의 비밀 경찰)
N.L. : x, National League, New Latin
n.l. : x, new line별행, non llicet불허의
N.L.C. : x, National Liberal club
N.L.R.B., NLRB : x, National Labor Relations Board(미)전국 노동관계위원회
N.lat., n.l. : x, north latitude
N.M(ex). : x, New Mexico
n.m. : x, nanometer, nautical mile(s), nonmetallic, noun masculine
n.o. : x, not out(크리켓)아웃 안되고 남아 있는 선수
N.O. : x, Natural Order, New Orleans
N.O.D. : x, Naval Ordnance Department
N.O.I.B.N. : x, not otherwise indexed by name
N.O.I.C. : x, Naval Officer in Charge
n.o.p. : x, not otherwise provided for
n.o.s., N.O.S. : x, not otherwise specified
n.p. : x, net proceeds, new paragraph, no pagination, no pageing, no place (of publication)(출판물의)발행지명 없음, notes payable지급어음
N.P. : x, no protest, notary public
N.P.A. : x, Newspaper Publisher's Association
N.P.F. : x, not provided for
n.p. or d. : x, no place or date
n.pl. : x, noun plural
N.R. : x, North Riding
n.s. : x, non satis, not specified
N.S.P.C.A. : x, National Society for the Prevention of Cruelty to Animals
N.S.P.C.C. : x, National Society for the Prevention of Cruelty to Children
N.S.W. : x, New South Wales
N.T. : x, Northern Territory
n.t.p., NTP : x, normal temperature and pressure상온 정상 기압
N.U, J. : x, National Union of Journalists
N.U.G.M.W : x, National Union of General and Municipal Workers
N.U.M. : x, National Union of Mineworkers(영)전국 광산 노동자 조합
N.U.R. : x, national Union of railwaymen
N.U.S. : x, National Union of Students
N.U.T. : x, National Union of Teachers
N.V. : x, New Version
n.v.d. : x, no value declared
N.V.M. : x, Nativity of the Virgin Mary
N.W.P(ROV). : x, Northwest Provinces(영령 인도)
N.W.T. : x, Northwest Territories(캐나다)
n.wt. : x, net weight
N.Y. : X, New York(cf.N.Y.C.)
N.Y.C. : x, New York City
N.Y.S.E. : x, New York Stock Exchange
N.Y.T., NYT : x, New York Times
N.Z., N.Zeak : new zeland:x, 
n/a : x, no account(은행)거래 없음
n/c : x, no charge
N/M : x, no mark
na : ad, conj, (스코)no(보통 조동사와 함께), not(cf.NAE), mauna=must not, NOR
Na : x, (화)sodium
NA : x, (광)numerical, aperture
NAA : x, National Aeronautic Association 전미 비행가 협회, neutronactivation analysis
NAACP : x, National Association for the Advancement of Colored People
Naafi, NAAFI : n, (Navy, Army and Air Force Institute(s))(영)육해공군 후생기관, 내피, (내피가 경영하는)매점((미)post exchange)
NAAU : x, National Amateur Athletic Union전미국 아마추어 체육연맹
nab : vt, 움켜쥐다, 붙잡다, (특히 현행범을)잡다, (arrest), 후닥닥 먹다(마시다)
nabe : n, (미속)동네(변두리)영화관
nabob : n, (mogul 제국 시대의)인도 태수, (18-19세기경 인도에서 돈을 벌어온) 대부호, 큰부자, 유력자, 명사
nabobery : n, 갑부기질, 갑부티
nabobism : n, 갑부기질, 갑부티
Naboth : n, (성)나봇(포도원의 주인으로 이 포도원을 탐낸 이스라엘 왕 아합에게 살해되었음)
Naboth's vineyard : x, 꼭 손에 넣고 싶은 물건
NACA : x, National Advisory Committee for Aeronautics미국 항공 자문위원회
nacarat : n, 주홍빛(천)
nacell : n, (공)(비행기, 비행선의) 엔진(화물, 승무원)실, (기구의)곤돌라(car)
NACF : x, National Agricultural Cooperative Federation 농업 협동조합
nacre : n, 진주층(mother of pearl
nacred : a, 진주층이 있는
nacreous : a, 진주층의, 진주 광택의
NAD : x, nicotinamide-adenine dinucleotide(생화)니코틴 아미드 아데닌 디누클레오티드(보조효소의 일종)no appreciable disease, nothing abnormal discovered
Naderism : n, (미국의 Ralph Nader의)소비자 보호 운동
Naderite : a, n, 네이더(Nader)식의 (소비자 운동가)
nadgers : n, (해명되지 않은)결점, 결합
nadir : n, (천)천저, (역경 운명등의)밑바닥, 최하점
nae : a, ad, (스코)NO, NOT
naevus : n, NEVUS
Naffy : n, NAAFI
nag : vt, vi, n, 성가시게 잔소리하다, 욕설하며 들볶다, 잔소리하여 괴롭히다, 바가지 긁다, (걱정거리 등이 사람을 )끈질기게 괴롭히다, 성가신 잔소리(를 퍼붓는 여자)
nag : x, (말)(특히)경주마, 늙은말, (미속)낡은 자동차(jalopy)
nagana : n, 나가나병(tsetse파리에 의한 치명적인 가축병
nagger : n, 잔소리 심한 여자
nagging : a, 잔소리 심한, 쨍쨍거리는, 끈질긴, 성가신, naggingly()ad, 
naggy : a, 잔소리 심한
nah : ad, (미속)아니(no)
Nah. : x, (성)Nahum
Nahal : n, 나할(농업 개척도 겸한 이스라엘 전투 부대), 그개척지
Nahum : n, (성)나훔(히브리의 예언자), (구약의)나훔서
naiad : n, (그, 로신)나이아스(물의 요정, 강, 샘, 호수에 사는), 젊은 여자 수영가
naif : a, =NAIVE
nail : 손톱, 발톱, 못, (새, 닭의)며느리발톱, (소, 말등의)뒷발톱, (유의어nail 사람 동물의 손톱, 발톱을 통틀어 하는 말이다, fingernail 손톱, toenail 발톱, claw 고양이 등의 발톱, talon 맹금의 발톱), 못, 징, 네일(옛날 길이의 단위 2 1/4인치, 5.715센티, (속)궐련, 술, 못(징)을박다, 못을 쳐서 고정하다, (구)체포하다, 붙잡다, (야구)터치아웃시키다, (학속)나쁜짓을 들추어내다, 잡다, (구)명중시키다, 잡다, (사람을)후려갈기다, 구타하다, (사람의 눈주의를)끌다, (사람의 말을)놓치지 않다
nailbiting : n, 손톱을 깨무는 버릇(긴장, 욕구 불만의 표시)완전한 좌절(정돈)상태
nail bomb : x, 긴 못이 들어 있는 GELIGNITE폭약(폭탄)(도시 게릴라들이 쓰는 수제 폭탄)
nailbrush : n, (매니큐어용)손톱솔
nail clipper : x, 손톱깍이
naildixic acid : x, (화)날리딕신산(비뇨, 생식기 감염증 치료용 항생물질
nail enamel : x, NAIL POLISH
nailer : n, 못만드는 사람, 못박는 사람, 자동 못박는 기계, (구)뛰어난 물건(동물, 사람)(일등을)열심히 하는 사람, 명수
nailery : n, 못제작소
nail file : x, 손톱 줄
nailhead : n, 못대가리, (건)(노르만 건축등의)못대가리 모양의 장식
nailheaded : n, 못대가리 모양의
nailhole : a, 손톱홈(접는 칼날의)
nailless : a, 손톱없는, 못이 필요없는
nail nippers : x, 손톱깎는 가위
nail polish : x, 매니큐어 액
nail puller : x, 못뽑이, 장도리
nailscissors : x, 손톱 깎는 가위
nail set : x, (목수의)못박는기구
nail varnish : x, (영)NAIL POLISH
nainsook : n, 네인숙(엷은 무명, 인도원산
naira : x, 나이라(나이지리아의 화폐단위 100KOBO 기호 N
Nairobi : n, 나이로비(Kenya 공화국의 수도
naissance : n, (사람, 조직, 사상, 운동등의)탄생, 태동, 기원, 생성
naive : a, (특히 젊기 때문에)세상을 모르는 단순한, 고지식한, (사람이)소박한, 순진한, 천진난만한, 숫된, 믿기쉬운, 속기쉬운, (미)소박한, 원시적인, (특정분야에)경험이 없는 , 선입적 지식이 없는
naive realism : x, (철)소박 실재론(외적 세계를 지각하는 그대로 인정하는 상식론)
naivete : x, 소박, 단순, 소박(단순)한, 행위(말)
naivety : n, NAIVETE
naked : a, 벌거숭이의, 나체의, 드러난, 가리개 없는, 잎(털, 껍질, 초목, 장식, 가구등)이 없는, 적나라한, 꾸밈없는, 있는 그대로의, 무방비의, (눈이)안경등에 의존하지 않은, 육안(나안)의 (칼등이)칼집에서 뽑혀 나온, nakedly()ad, 
naked ape : x, 발가벗은 원숭이, 인간(a human being)(영국의 인류학자 Desmond Morris의 저서 the naked ape(1967)에서
naked call : x, (미)파는 사람이 실제로 소유하고 있지 않은 주식, 증권을 매입하는 선택권
naked debenture : x, (영)무담보 사채
naked eye : x, 육안, 나안
nakedize : vi, vt, 벌거숭이가 되다, 벌거벗게 하다
nakedness : n, 벌거숭이 노출이 있는 그대로임, 결핍
naked option : x, 선택권부 주권을 소유하고 있지 않은 증권 거래업자가 제공하는 선택권
Nakhodka : n, 나훗카(시베리아 Vladivostok남동쪽에 있는 항구
Nalgo, N.A.L.G.O : n, (National and Local Government Officer's Association)(영국의) 국가 지방 공무원 조합
naloxone : n, 날록손(모르핀 등의 마약에 대한 길항제)
NAM : x, Narional Association of Manufacturers
namable : a, NAMEABLE
nambypamby : a, 지나치게 감상적인, 나약한, 감상적인 사람(말, 문장)나약한 사람
nambypambyism : n, 지나치게 감상적임, 나약(섬세)하여 남자답지 못함
name : n, 이름, 성명, 평판, 명성, 씨족, 가문, 가계, 가명, 욕설, 명의 , 명목, 이름뿐임, 허명, (논, 철)명사, (성)하느님, 그리스도의 이름
name : vt, 명명하다, 이름을 붙이다(짓다), 지명하다, 지명하여 부르다, 임명하다, ..의(올바른)이름을 대다, 가리키다, 초들다(mention)(시일, 가격등을)지정하다
name : a, (미)유명한, 일류의, 이름을 기입하기 위한
nameable : a, 이름지을수 있는, 지명할수 있는, 이름을 말해도 되는, 입에 올려도 실례가 안되는, 이름을 들먹일 가치가 있는
nameboard : n, (가게등의)간판, 선명판
namebrand : x, (미구)신용있는 회사의(상표가 붙은)제품
namecalling : n, 욕질, 중상, 비난
namechild : n, (어떤 사람의)이름을 따서 이름지은 아이
named : a, 지명된, 지정의, 유명한
name day : x, 성명축일(본인과 같은 이름의 성인의 축일), (아이의)명명일, (증권)계산일
namedropping : n, (구)유명한 사람의 이름을 마치 친구처럼함부로 부름, namedrop()vt, namedropper()n
nameless : a, 이름없는, 명명되지 않은, 익명의, 세상에 알려지지 않은, 무명의, 서출의, 사생의, 형언할수 없는, 언어도단의, nameness()n 
namely : ad, 즉
name part : x, (극)주제역(Hamlet 극의 Hamlet
nameplate : n, 명패, 명찰
namer : n, 명명자, 지명자
namesake : n, (어떤 사람의)이름을 받은 사람, 이름이 같은 사람(물건)
name tape : x, (의복등의)명찰
Namibia : n, 나미비아(UN 이정한 South West Africa의 공식명칭)
Nan : n, 여자이름(Ann의 애칭)
nana : n, 할머니, 유모, 아이보는 사람
nana : n, (오스속)머리, (속)바보, 멍텅구리
NANA : x, North American Newspaper Alliance 북아메리카 신문 연맹
Nance : n, 여자이름(Ann, Anna, Anne의 애칭)여자같은 남자(여성역의)호모
Nancy : n, 여자이름(Ann(e)의 애칭, (속)(여성역의) 호모(nance)
NAND : x, (전산)부정적, 낸드
nanism : x, 왜소, 왜성(drarfishness)
nankeen : n, 남경 무명, 그것으로 만든 바지, 담황색
Nanking : n, 남경(중국 장쑤성의
nanna : n, NANA
Nannette : n, 여자이름
Nannie : n, Ann(e)의 애칭
nannofossil : n, 초미화석, 극소플랑크톤(nannoplankton)화석
nanny : n, 여자이름, (Ann(e)의 애칭)(영소아)유모 할머니, (구)NANNY GOAT
nanny goat : x, (구)암염소
nano : x, (연결형)10억분의 1, 미소의 뜻
nanoamp : n, 나노앰프(전류의단위, 암페어(ampere)의 10억분의 1)
nanoatom : n, 나노아톰(원자의 10억분의 1)
nanofossil : n, 초미화석, 극소플랑크톤(nannoplankton)화석
nanometer : n, 나노미터(10억분의 1미터, 기호nm
nanosecond : n, (ns, nsec), (10억분의 1초)
nanosurgery : n, (외과)극소수술(전자 현미경으로 하는 세포, 조직등 극소부의 수술)
Nansen passport : x, 난센 여권(본국 정부가 없는 자들에게 국제 연맹에서 발생한 여권)
Nantes : n, 낭트(프랑스 북서부의 항구도시
Naomi : n, 여자이름, 나모미((룻)ruth의 시어머니)
nap : n, vi, vt, 선잠, 낮잠, 잠깐(낮잠을)자다, 선잠자다, 잠깐 졸다, 선잠자다, 방심하다, 졸면서(시간을)보내다
nap : n, vt, 보풀을 세우다, (나사등의)보풀
nap : n, vt, (카드)냅(napoleon)(카드놀이의 일종)(영)(경마)어떤 말이 반드시 이기리라는 예상, 필승마, (영)(말을)이길 말이 라고 지목하다(권하다)
NAP : x, naval aviation pilot
napa : n, 나파(무두질한(새끼)양의 가죽, 장갑, 의복용)
napalm : n, vt, (미군)네이팜탄(강렬한 유지, 소이탄)네이팜탄으로 공격하다
nape : n, 목덜미
napery : n, (스코, 고)TABLE LINEN
nap hand : x, 5회전승할수 있을 것 같은수, 모험하면 승산이 있을 것 같은 경우
naphtha : n, 나프타, 석뇌유, 휘발유, 석유
naphthalene : n, (화)나프탈렌
naphthaline : n, (화)나프탈렌
naphthol : n, 나프톨(방부제, 염료의 원료)
Napierian logarithm : x, 자연대수(natural logarithm)
Napiers rods(bones) : x, 네피어의 계산봉(J.Napier가 고안한 곱셈, 나눗셈 용구
napkin : n, vt, (식탁용)냅킨, 기저귀(diaper), 냅킨으로 싸다, (훔치다)
napkin ring : x, (고리 모양의)냅킨꽂이
Naples : n, 나폴리(이탈리아 남부의 항구도시
napless : a, 보풀이 없는, (옷등이)닳아서 올이 드러난
Napoleon : n, 나폴레옹(1769-1821)(프랑스 황제, 본명(Napoleon Bonaparte)(보불 전쟁에서 패배하여 영국에서 객사함)
napoleon : n, 나폴레옹, 옛날 프랑스의 20프랑 금화, 부츠의 일종, (미)크림, 잼을 넣은 생과자의 일종
Napoleonic : a, 나폴레옹I세(시대)의, 나폴레옹 같은
Napoleonic Wars : x, 나폴레옹 전쟁(1805-15)
Napoleonism : n, (국민에 대하여 절대권을 가지는)나폴레옹주의
Napoli : x, NAPLES
napoo : vt, int, (영군속)없어졌다, 죽었다, 틀렸다, 끝났다, 죽이다, 힘을 못쓰게 만들다
nappa : n, NAPA
nappe : n, (지질)냅(원지성 기반을 덮는 암체), 댐을 넘쳐 흐르는 물
napper : n, 꾸벅꾸벅 조는 사람, 보풀을 세우는 사람(기계)
nappy : a, n, (영구)(술이)독한, (스코)얼근하게 취한, (스코)술, (특히)맥주
nappy : a, 보풀이 인, 솜털이 난(머리털이)곱슬곱슬한
nappy : n, 기저귀
nappy : n, (미)유리또는 도자기로된, 작은접시
napu : n, (동)궁노루(자비, 수마트라산
narc : n, 마약단속관(수사관)
narc : x, (연결형)혼미, 마취의 뜻
narceine : n, 나르세인(마취성 알칼로이드)
narcism : n, narcissism
narcissism : n, 자기도취(증), 자애, 자기애, 자기 중심주의
narcissist : n, 자기도취자, narcissistic()a
narcissistic personality : x, (심)자기애인격, 자기 중심성성격
narcissus : n, (그신)나르시스, 나르키소스(물에 비친 자기의 모습을 연모하여 빠져 죽어서 수선화가 된 미모의 청년), 미모로 자부심이 강한 청년, (식)수선(속)
narco : x, (연결형)혼미, 마취의 뜻
narco : n, (미속)마약 단속관(수사관)(경찰의)마약 단속반원
narcobuck : n, 마약 거래자금, 마약 거래로 번돈
narcolepsy : n, (병리)(간질병의)기면 발작
narconalysis : n, (정의)마취분석(마취약에 의한 심리 요법)
narcosis : n, (의)마취약, 마약에의한 혼수상태
narcosynthesis : x, 정신병 마취 요법
narcotic : a, n, 마취약의, 마취성의, 최면성의, (책이야기등이)잠이 오는 , 졸리는, 마약의 마약사용의 , 마약상용자의, 최면약, 마취약(마약)(중독자)
narcotine : n, (화)나르코틴(아편 속의 일종의 유기 염기)
narcotism : n, 마취, 마취제(마약)중독(상용)
narcotist : n, 마약중독자(상용자)
narcotization : n, 
narcotize : vt, 마취제를 투여하다, 마취시키다
nard : n, (식)나드, 나드향, 진통제
nares : n, pl, 콧구멍
nargile : n, 수연통(연기가 물을 통하게 된 담뱃대)
nark : n, vt, vi, (경찰의)앞잡이, 밀정, (미속)NARC, 밀고하다, 화나게하다, 밀고하다, 불쳤하다
narky : a, (영속)화잘내는 기분이 언짢은
Narms : n, pl, 핵무기(nuclear arms)
narratage : n, 나라타주(영화tv에서 narrator가 보조 설명하는 것)
narrate : vt, vi, (전말을)말하다, 이야기하다, 나레이타가 되다, 이야기 하다
narration : n, 서술, 이야기함, 이야기, 스토리, (문법)화법
narrative : 이야기(의)(story), 이야기체의 문학(비교 narrative 이야기, 사건의 전말, 경험담 등을 흥미있게 정리하여 이야기하는 것을 말한다. narration 위의 것들을 이야기하는 동작을 주로 가리키며 특히 그 정리 방법이나 이야기하는 방법에 중점이 있는 말이다), 설화, 화술, 이야기체식의, 설화의, 화술의, narratively()ad, 
narrative art : x,  STROY ART
narrator, narrater : n, 이야기 하는 사람, 나레이터
narrow : a, 폭이좁은, 가는, 한정된, 제한된, 옹색한, 간신히 이룬, 가까스로의, 마음이 좁은, 편협한, (검사등이)정밀한, 엄밀한(minute), (영방, 스코)인색한(mean)(음성)(음성표기가)정밀한, 혀의 근육이 긴장한
narrow : n, (좁은) 해협, (도로등의)좁은 부분, (미)산사이의 좁은길(pass)
narrow : vt, vi, 좁히다, 좁게하다, 가늘게 하다, 좁아지다, 가늘어지다
narrow bed(cell) : x, NARROW HOUSE
narrow boat : x, (영)(운하용의)길죽한 배
narrowcast : 유선방송하다, 한정된 지역에 방송하다:vt, 
narrowcasting : n, 유선 텔레비전 방송(cablecasting)
narrow cloth : x, (영)(52인치)(미)(18인치)이하의 폭이 좁은천
narrow gage(d)[n'4roug'eid0(d)
narrow gate : x, (성)좁은 문(마태 복음 7:13-14)
narrow gauge : x, (철도)협궤, 협궤철도(용의 객차(화차)
narrow gauge(d) : a, 협괘의, 편협한
narrow goods : x, (영)폭이 좁은 물건(리본, 노끈등)
narrow house : x, 무덤(grave)
narrowly : ad, 좁게, 편협하게, 간신히, 가까스로, 엄밀(정밀)히
narrowminded : a, 마음이 좁은, 편협한, narrowmindedly()ad, narrowmindedness()n 
narrowness : n, 좁은, 협소, 편협, 협량, 궁핍, 세밀, 면밀
narrow seas : x, (영)(영국 본토쪽에서 본)좁은 해협(Irish Sea 또는 English Channel을 말함)
narrow way : x, (성)좁고 험한길, 정의
narthex : n, (건)나르텍스(고대 기독교 교회당의 본당 입구 앞의 넓은 홀, 참회자, 세례지원자를 위한 공간)
narwal : n, 일각 고래(한대의 바다에사는 돌고래과의 동물)
nary : a, (미방)단..도 없는, 하나도(조금도)..없는
NAS : x, National Academy of Sciences미국과학 학회, Naval Air Station
NASA : x, Aeronautics and Space Administration)미국 항공우주국, 나사
NASACOM : X, National Aeronautics and Space Administration Communication's Network(NASA의 우주 여행을 위한 세계적인 지상 통신지원망)
nasal : n, a, 코의, 코에 관한, 콧소리의, (음성)비음(의)콧소리, 비음, 비음자, (투구의)코가림
nasalism : ad, 
nasality : n, 비음성, (소리가)코를 통하여 나옴, 코속에서의 울림
nasalization : n, (음성)비음화
nasalize : vt, vi, (음성)..을 비음화하다, 비음화하여(콧소리로)발음하다
nascence : n, 발생기원
nascency : n, 발생기원
nascent : a, 발생하려고 하는, 초기의, 발생기의(에 있는)
NASDAQ : x, (미증권)나스다크(증권시세를 컴퓨터로 알리는 정보시스템)
naso : x, (연결형)코(의)의 뜻, 비과학화
Nassau : n, 내소(Bahamas의 수도)
Nasser : n, 나세르(1918-70)(통일 아랍 공화국의 대통령)
Nasserism : n, 나세르주의
nastily : ad, 더럽게, 추잡하게
nastiness : n, 더러움, 추잡함
nasturtium : n, (식)금련화, 금련화과
nasty : a, 더러운, 구역질나게 더러운, (거처등)욕지기나는 , 역겨운(음식물, 약, 냄새, 맛등)더러운, 불쾌한, 추잡한, 외설한, 음란한(말 생각, 책등)험악한, 거친(날씨, 바다등)난처한 귀찮은, (문제등)고역스러운, 무거운, 심한, (병타격등)비열한, 심술궂은, 음흉한, 간악한, 비천한
nastynice : a, (사람이)겉으로 친절한(정중한), 은근히 무례한
Nat : n, 남자이름(Nathan, Nathaniel의 애칭)
nat. : x, national, native, natural
Nat. : x, Natal, Nathan, Nathaniel, National(ist)
Nat. Gal. : x, National Gallery(런던의)국립미술관
nat. hist. : x, natural history
nat. phil. : x, natural philosophy
natal : a, 출생(출산, 분만)의
natal astrology : a, 인사점성학
natalism : n, 산아(인구)증가정책
natalist : n, (산아)인구증가제창자
natality : n, 출생(률)
natant : a, (생태)부동성의, 물에 떠도는
natation : n, (문어)수영(술)
natatorial : a, 유영의(에관한), 수영에 적합한, 헤엄치는 습성이 있는, 유금류의
natatorium : n, (미)(주로 옥내)수영장, 풀
natch : ad, (구)당연히, 물론(naturally)
nates : n, 엉덩이, 둔부(buttocks)
Nathan : n, 남자이름(애칭Nat, Nate)
Nathanael : n, 남자이름, (성)나다니엘(그리스도의 제자)
Nathaniel : n, (남자이름(애칭 Nat), natheless()ad, 
nathless : ad, (고)NEVERTHELESS
nation : n, (한정부 아래 공통의 문화, 언어 등을 가진)국민(전체)(유의어people), 세계의 여러국민, 전인류, (성)유대인쪽에서 본)이교도, 이방인, 국가(country), 민족, 종족, (북아메리카 원주민의)부족, (그들이 정치적으로 결성한)부족 연합
nation : n, (방)DAMNATION
national : a, 국민의, 전국민(공통)의, 국가의, 국가적인, 국가 전체의, 국유의, 국립의, 국정의, 한 나라를 상징하는 국민적인
national : n, 동국인, 동포(특히 외국 거주의), (미)(경기등의)전국대회
national anthem(air) : x, 국가
national assembly : x, 국회, 프랑스하원, (프랑스 혁명당시의)국민의회
National Assistance : x, (영)극빈자 보조금
national atlas : x, 국세지도(국세를 나타내는 요소의 지역적 분포, 변화를 나타내는 지도집)
national bank : x, 국립은행, (미)국법 은행(연방정부의 인가를 받은 상업은행
national bird : x, (조)국조, 나라새
national brand : x, 제조업자(제조원)상표, 내셔널 브랜드(제조업자가 붙인 상표, cf PRIVATE BRAND)
national cemetery : x, (미)국립묘지
National China : x, (대만의)국민정부, 중화민국(the Republic of China)
national church : x, 국민교회, 민족 교회, 국립교회, 국교회
National Congress : x, (인도의)국민회의파
National Convenant : x, (스코사)국민서약(주교제에 반대한 장로교회파의 서약)
National Convention : x, (프랑스사)국민공회, (미)(정당의)전국대회, 전당대회
national debt : x, 국채
national economy : x, 국민경제
national ensign : x, ENSIGN 1
national flag : x, 국기
National Front : x, (영)국민 전선(극우 정당)
National Gallery : x, (런던의)국립미술관
national government : x, 거국내각
National Government : x, (대만의)국민정부
national grid : x, (전)전국전력계통망, (영국 육지 측량부지도에 쓰이는)거리 좌표계
National Guard : x, (미국 각주의) 방위군, 주군
National Health Service : x, (영)국민 건강 보험제도
national holiday : x, 국경일
national hymn : x, NATIONAL ANTHEM
national income : x, (경)(연간)국민소득
National Insurance : x, (영)국민 보험 제도
nationalism : x, 민족주의, 국가주의, 국수주의(cf.ETHNOCENTRISM)민족 자결주의, 국가독립(자치)주의, (특히 아일랜드의), 산업국영주의, 애국심, 애국운동
nationalist : n, a, 국가(민족, 국수)주의자, 민족 자결주의자, 국가 자치론자, 국가(민족, 국수)주의(자)의(적인), 민족 자결주의(자)의
nationalistic : a, 민족(국가, 국수)주의(자)의(적인), nationalitically()ad, 
nationality : n, 국민(의 한 사람)임, 국민성, 국민적 감정, 국적, 선적, 국민, 민족, 국가
nationalization, -sa- : n, 국민화, 국유화, 국영, 귀화
nationalize, ise : vt, 국민으로(독립)국가로, 만들다, 국가(국민)적으로 하다, 국유로하다, 국영화하다, 귀하시키다, nationalizer()n, 
National Labor Relations Board : x, (미국의)전국 노동 관계 위원회
national lakeshore : x, (미)국립 호안(연방정부가 관리하는 레크레이션 지역)
National league : x, 내셔널 리그(미국프로야구 양대 리그의 하나(cf.AMERICAN LEAGUE)
nationally : ad, 국가로서, 국민으로서, 국가적으로, 거국 일치하여, 국가 본위로, 국가전체의 입장에서, 국가적으로 보아, 공공의 입장에서 , 전국적으로
national monument : x, (미)(국가지정의)천연기념물(사적, 명승지등)
national mourning : x, 국장
national park : x, 국립공원
National People's Congress : x, (중공의)전국 인민 대표대회
National Portrait Gallery : x, (런던의)국립 초상화 진열관
national product : x, (경)(연간)국민생산(cf.GNP)
national seashore : x, (미)국립해안 공원
National Security Council : x, (미)국가안전보장회의
National Service : x, (영)국민 (의무)병역 징병(1958년폐지cf.SELECTIVE SERVICE SYSTEM)
national socialism : x, 국가 사회주의
National Socialist Party : x, (특히 Hitler가 이끈)국가 사회당, 나치스
national treatment : x, (외교)내국민 대우
National Trust : x, (영)문화보호 협회(자연미, 사적의 보호를 위한 조직체)
National Weather Service : x, (미)미국 기상과(상무성, 해양 대기국의 한 과)
nationhood : n, 국민(국가)임, 국민의 신분
nationstate : n, (근대)민족국가
nationwide : a, ad, 전국적인(규모의), 전국적으로
native : 출생의, 자기나라의, 본래의, 토착(원주)민의, 토인의, 토박이의, 그 지방 고유의, 향토(지방)적인, 토착의, ..원산의, 타고난, 선천적인(유의어 native, natural 은 다같이 (타고난)의 뜻을 나타내지만 , 전자가 후천적이 아님을 강조하는데 비해 후자는 그 사람(물건)이본질이나 특징으로서 갖고 있는 것을 나타낸다), (광물등이)천연그대로의, 꾸밈없는, 자연스런, 소박한
native : n, 원주민, (..에서)태어난 사람, (오스)오스트레일리아 태생의 백인, 미개인, 토인, 토착의 동식물, (특히)양식한 영국산굴
Native American : x, (미)아메리칸 인디언(의)
native bear : x, (오스, 뉴질)(동)코알라(koala)
nativeborn : a, 본토박이의
natively : ad, 선천적으로, 천연적으로
native son : x, (미정)자기 주 출신입후보자
nativism : n, 원주민 보호주의, 토착문화 부흥(보호), (철)선천설, 생득설, nativist()a, 
nativity : n, 출생, 탄생, 그리스도, 성모마리아의 탄생(축일)(9월8일)세례자 요한 탄생축일(6월 24일), 그리스도 탄생의 그림, 사람의 탄생시의 천궁도크리스마스
nativity play : x, 그리스도 성탄극
natl. : x, national
NATO, Nato : n, (North Atlantic Treaty Organization)북대서양 조약기구, 나토
natrium : n, SODIUM
natriuresis : n, (의)나트륨뇨 배설항진
natron : n, 천연탄산소다
NATS[Naval Air Transport Service
natter : vi, n, 재잘거리다, 투덜거리다, 성급하게 말하다, (부질없는)수다, nattered()a, 
natter blue : x, 엷은 청색
natterjack : n, (유럽산)두꺼비
nattery : a, (영 구)성마른 까다로운(peevish)
natty : a, (옷차림, 풍채등이)깨끔한, 산뜻한(trim)말쑥한, nattyness()n, 
natural : 자연의, 자연그대로의, 가공하지 않은, 개간하지 않은, 자연의 과정에 의한 , 자연적인, 타고난, 선천적인, (논리상 또는 인정상)당연한, 무리가 아닌, (그림등이)실물과 같은, 꼭닮은, 본래의, 본시 그대로의 , 꾸밈없는, 평상 상태의, 보통의, 평상의, (가족이)낳아준, 친..(자식이)서출의, 사생의, (약)본위의
natural : n, 자연적인 것, (고)선천적인)백치, (음)제자리표, 제자리음, (피아노, 풍금의)백건, (카드)그냥 이기게 되는 두장의 패, 타고난 명인, 성공이 , 확실한것(사람), naturalness()n, 
naturalborn : a, 타고난, 생득의(cf.NATIVEBORN)
NaturalBridge : x, 천연다리, 천연의 바위다리(미국Utah주 남동부에 있는 국정 천연기념물), 내츄럴 브리지(미국Virginia 주에 있는 다리 모양의 석회암)
natural childbirth : x, 자연 분만(출산)(법)
natural classification : x, NATURAL SYSTEM
natural day : x, 자연일(해돋이부터 해질때 까지)
natural death : x, (노쇠에 따른)자연사
natural food : x, 자연식품
natural gas : x, 천연가스
natural generative phonology : x, (언)자연생성 음운론
natural guardian : x, (법)혈연 후견인
natural historian : x, 박물학자, 박물지저자
natural history : x, 박물학, (비전문인의)박물연구, 박물지, 발달사, 발달경로, 연혁(사), 계보
naturalism : n, 자연주의(현실 또는 자연의 객관적 진실 묘사를 목적으로 하는), 자연주의(본능에 따라 행동하는), (철)자연주의(자연을 중시하고, 모든 현상을 과학적 법칙으로 설명하는), (신학)자연론(종교적 진리는 자연에 대한 연구에서 얻어진다는
naturalist : n, (철, 종, 예술)자연주의자, 박물학자, (영)애완동물상인, 박제사
naturalistic : a, 자연을 따른, 자연주의적인, 사실적인, 박물학자적인
naturalization : n, (법)귀화, (외국어, 외국문화의)이입, (외국산 동, 식물의)이식, 귀화, 자연화
naturalize : vt, vi, 귀화시키다, ..에게 시민권을 주다, (외국어, 외국문화등을)들여오다, 동식물을..에 이식하다, 풍토에 익도록하다, 자연적으로 하다, 신비스럽지 않게 하다, 귀화하다, 풍토에 익숙해지다, 박물학을 연구하다
natural langugage : x, 인공언어, 기계언어에 대하여)자연언어
natural law : x, 자연의 이법, 자연율(법칙), 천리, 자연법
natural life : x, 천수, 천명, 수명
natural logarithm : x, (수)자연대수(cf.COMMON LOGARITHM)
naturally : ad, 자연히, 자연의 힘으로, 본래, 타고나기를, (문장전체를 수식하여)당연히, 물론, 실물그대로, 진짜 그대로, 있는 그대로, 꾸밈없이, 무리없이, 수월하게
natural magnet : x, 천연자석(lodestone)
natural number : x, (수)자연수(양의 정수)
natural order : x, 자연율, 자연계의 질서, (생), 과, (영)NATURAL SYSTEM
natural person : x, (법)자연인(법인에 대하여)
natural philosophy : x, 자연철학(지금의 natural science 특히 physics)
natural religion : x, 자연종교
natural resources : x, 천연자원
natural right : x, (자연법에 의거한 인간의)자연권
natural rubber : x, 천연고무, 탄성고무
natural science : x, 자연과학(생물, 화학, 물리등)
natural selection : x, 자연(선택)도태
natural sign : x, (음)제자리표, 본위기호
natural system : x, 자연분류(natural classification)
natural vision : x, (영)와이드스크린 방식(영사기의 렌즈 및 관람자용 입체 안경에 편광 필터를 이용)
natural year : x, 자연년, 태양년
nature : (대)자연, 천지만물, 자연계, 자연력, 자연현상, 자연의 법칙, (문명의 영향을 받지 않은)인간의 자연의 모습, 자연물, 실물, 본바탕, 본성, 천성, 성질, 인간성, 기질, (어떤 특수한)성미, (어떠한)성질의 사람, 본연의힘, 충동, 활력, 체력, 육체력(생리적)요구, 총탄환의 크기
naturecure : n, 자연요법
natured : a, (보통 복합어를 이루어)성질이 ..한
nature deity : x, 자연신(자연물, 자연현상이 신격화된 것)
naturegod : x, NATURE DEITY
nature myth : x, 자연신화
nature philosoph : x, NATURAL PHILOSOPHY
nature printing : x, 원물, 원형에서 직접 찍어내는 인쇄법
nature study : x, 자연공부(꽃 새 광석 날씨등의 관찰, 국민학교의 학과
nature trail : x, 숲속등의 자연 관찰을 위한 자연 산책로
nature worship : x, 자연숭배
naturism : n, (종교상의)자연주의, 자연숭배(설), 나체주의, naturist()n, 
naturopathy : n, 자연요법(주로 식이 운동 공기 일광등에 의해 자연 치유를 조장하는)
naught : n, a, (고, 시)무, 무가치(nothing), (미)제로, 영(nought), (고)무가치한, 무용의, 붕괴한, 망한, (발)(도덕적으로)나쁜, 사악한
naughty : n, a, (어린애가)장난꾸러기의, 버릇없는, (익살)(어린아이가)못된 나쁜, 아슬아슬한, 외설한, (오스속)성교, naughtily()ad, naughtiness()n, 
nauplius : n, (동)노플리우스, 나우플리우스(갑각류의 발생 초기의 유생)
Nauru : n, (지명)나우루 공화국(오스트레일리아 동북방의 섬나라, 수도(Nauru)
nausea : n, 욕지기, 매스꺼움, 배멀미, 매우 싫은 느낌, 혐오, 지겨움
nauseate : vt, vi, 구역질나(게 하)다, 혐오감을 느끼(게 하)다
nauseating : a, 욕지기나는, 지겨운, 몹시 싫은, nauseatingly()ad, 
nauseation : n, 
nauseous : a, 욕지기나게 하는, 지겨운, 진저리나는, nauseously()ad, nauseousness()n, 
Nausicaa : n, (그신)나우시카아(난파한 Odysseus를 구하여 아버지의 궁전으로 안내한 공주)
naut. : x, nautical(ly)
nautch : n, (인도무희의) 춤
nautical : a, 항해(술)의, 해사의, 선박의, 선원의, nautically()ad, 
nautical archaeology : x, 해양 고고학
nautical mile : x, 해리(sea mile)(영)에서는 1, 853.2미터, (미에서는)1959년이래 국제 단위(1, 852미터를 채용)
nautilus : n, 앵무조개속, 배낙지무리, 노틸러스호(미국 원자력 잠수함 제 1호)
nav. : x, naval, navigable, navigation, navy
Navaho, -jo : n, a, 나바호족(미국 NEW MEXICO, ARIZONA, UTAH주에 사는 원주민)나바호족의 사람, 나바호말, 나바호족(말)의
naval : a, 해군의, 해군에 의한, 군함의(에 의한)배의
Naval Acodemy : x, 미국 해군사관학교
naval architecture : x, 조선기사
naval base : x, 해군기지
naval brigade : x, 해병대
naval cadet : x, 해군 사관 후보생
naval college : x, (영)해군 사관학교
naval establishment : x, (집합적)(미군)해군 시설(부대)(함대, 항공부대, 지상부대, 전투함정, 보조함정, 보조시설, 인원, 조직, 기구등포함)
navalism : n, 해군력, 대해군주의
navalist : n, 대해군주의자
navally : ad, 해군식으로, 해군(해사)의 입장에서
naval officer : x, 해군사관, (미)세관공무원
naval reserve : x, (군)해군예비역
naval station : x, 해군보급기지, 해군기지, 군항
naval stores : x, (무기 이외의)해군 군수품, 함선용 특수품(특히 수지 도료등)
navarin : n, 나바랑(양고기를 넣어 삶은 스튜)
Navarre : n, 나바르(프랑스 남서부에서 스페인 북부에 걸쳐 있던 옛 왕국)
nave : n, (교회당 중앙의)본당, 회중석
nave : n, (차의)바퀴통(hub)(차바퀴 등의 축을 끼우는 중심부)
navel : n, 배꼽, 중앙, 중심, 네이블 (오렌지)
navel orange : x, 네이블 (오렌지)
navicert : n, (전시의)봉쇄 해역 통과 허가증
navicular : a, n, 배 모양의, 주상골의, 주상골
navig : x, navigation, navigator
navigability : n, (배 하천등이)항행할수 있음, 가향성, 기구의, 조종가능성, (배, 비행기 등의)내항성
navigable : a, (하천, 바다등이)항행할수 있는.(기구등이)조종할수 있는, (선박, 항공기등이)항행할수 있는, navigably()ad, 
navigate : vt, (배, 비행기를)조정(운전)하다, (하천, 바다, 하늘을)항행(향해)하다, 배로 수송하다, (사람이..을)걸어서 가다, 진행시키다, 뚫고 나가게 하다, (법안등을)통과시키다
navigate : vi, 항해하다, 조종하다, (차의 동승자가)운전자의 길 안내를 하다, (흰자, 취한 사람이)제대로 걸어서 가다
navigating officer : x, 항해장, 항공사, 기장
navigation : n, 항해, 항공, 항행, 항해(항공)학(술)항법, (집합적)항행 선박, navigational()a, navigationally()ad, 
Navigation Acts : x, (영사)항해 조례
navigation coal : x, STEAM COAL
navigation laws : x, 항해 법규
navigation light : x, 항해등, 항공등
navigation satellite : x, 항행(항해)위성
navigator  : n, 항해장, 항공사, 항법사, (항공기, 미사일의 진로의)자동조정장치, 항행장, 항해자, 항해술에 능한 사람, 해양 탐험가
navvy : n, (운하, 철도, 도로건설등에 종사하는 보통 미숙련의토역꾼, 인부, 일꾼, STEAM SHOVEL, NAVIGTING OFFICERN) 인부, (토목 공사용) 굴착기
navy : n, 해군, (한나라의)전 군함, (집합적)해군 군인, (시 고)함대, 상(선대), 짙은 남색
navy bean : x, (미)(미국 해군의 저장 식품인)흰강낭콩
navy blue : x, 짙은 남색의
navy blue : a, 영국 해군의 제복색에서 짙은 남색, 네이비 블루, 네이비 블루
navy chest : x, (미)올챙이배, 똥배
Navy cross : x, (미)해군 수훈장, 특공십자훈장
navy cut : x, (파이프용)실담배
Navy Department : x, 해군성
Navy Exchang : N-, e-(미국 해군기지내의)매점 해군
Navy league : x, (영)해군 협회
Navy list : x, (영)해군요람(사관 및 함선의 공식 명부
navy yard : x, 해군조선소, 해군공창
naw : ad, NO
nawab : n, (NABOB 1 나와브(인도, 파키스탄의 이슬람 귀족, 명사에 대한 존칭
NAWCH : x, (영)전국 입원 아동복지협회
Naxalite : n, a, 낙살라이트(의)(인도의 극좌 정당의 당원)
nay : ad, n, (고, 문어)아니(no)(opp.yea)(고)글쎄, 그렇기는 하나, ..라기보다는, 뿐만아니라, 그렇기는 커녕, 곤란하다, 아니, 불가능하다, 아니(라는 말)부정, 거절, 거부, 반대 투표(자)
naya paisa : x, 신파이사(1957-63년간의 인도의 보조 화폐단위)
naysay : 거절하다, 부인하다:n, vt, 
naysayer : n, 거부자, 부정자, 반대자
Nazarene : n, a, 나사렛 사람, 예수그리스도, 기독교도(유대인.회교도 쪽에서 경멸하여 말함), 나사렛의, 나사렛 사람의
Nazareth : n, 나사렛(Palestine북부의 작은 도시, 그리스도의 성장지
Nazarite, -irite : n, 나사렛사람, (성)나실인(헤브루의 고행자)
naze : n, 갑, 곶(promontory)
Nazi : n, a, 나치당원, 국가 사회주의 독일 노동자당, 나치당원, 나치, 나치주의(신봉)자, 나치(당의)
Nazification : n, 나치화
Nazify : vt, 나치화하다
Naziism : n, 독일 국가사회주의, 나치주의(cf.FASCISM)
nazir : n, (인도인)법정 관리
Nb : x, niobium
NB : x, northbound
NBA : x, National Basketball Association 미국 농구협회, National Boxing Association미국 권투 협회
NBC, N.B.C : x, (미)National Broadcasting Company, nuclear, biological and chemical weapons핵생물화학무기
NbE, N.b.E : x, north by east
NBER : x, (미)National bureau of Economic Research
Nbomb : n, 핵폭탄
NBR : X, NITRILEBUDADIENE RUBBER니트릴부다디엔 러버(특수합성고무, 내유성이 강함)
NBS : x, National Bureau of Standards(미)규격 표준국
Nbw, N.b.W. : x, north by west
NC : x, North carolina, (전산)numerical control
NCAA : x, National colleiate athletic Association미국대학체육협회
NCC : x, National Council of churches
NCMI : x, National Classical Music Institute(한국)국립 국악원
NCO, N.C.O., n.c.o. : x, noncommissioned officer
NCTE, N.C.T.E : x, National Council of Teachers of English
Nd : x, neodymium
ND : x, North Dakota
NDAC : x, National Defense Advisory Commission(미국)국방자문위원회
NDE : x, near death experience근사사체험, 임사체험
Ne : x, neon
NE : x, Nebraska
ne'er : ad, NEVER
ne'erdoweel : n, a, 
ne'erdowell : n, a, (스코)쓸모없는 사람(의), 식충이(의)
NE, N.E. : x, naval engineer, New England, northeast(ern), Northeastern(런던의 한우편구)
NEA, N.E.A. : x, National Education Association, Newspaper Enterprise Association
NEACP : x, National Emergency AirbornCommand Post(미)국가 긴급 공중 지휘기
Neal : n, 남자이름
Neanderthal : n, (인류)네안데르탈인, (사람, 행동등)네안데르탈 사람같은, 네안데르탈(서독 서부Dusseldorf부근의 골짜기), 야인, 거칠고 완강하고 서투른 사람
Neanderthal man : x, (네안데르탈 사람(1856년에 독일의 네안데르탈에서 발굴된 구석기 시대의 유럽원인)
neap : n, 소조, 조금, 최저조
neap : a, vi, vt, 소조의, 조금의, 소조로 되어가다(에 달하다), (배가)소조때문에 진행이 방해되다
Neapolitan : a, n, Naples의, (아이스크림이)나폴리탄의, 나폴리 사람, (종종)나폴리탄
neap tide : x, 소조, 조금
near : ad, 가까이, 근접하여, 이웃하여, 정밀하게, 세밀하게, 친밀하게, 풍향과 같은 방향으로, 검소하게, 인색하게
near : a, 가까운, 아주 가까운, (관계가)가까운, 근친의, 친한, (이해)관계가 깊은, 아주 닮은(흡사한), 진짜에 가까운, 아슬아슬한 위기일발의
near : prep, ..의 가까이에, ..에 가깝게
near : vi, vt, ..에 접근하다(approach)
nearathand : a, NEARBY
near beer : x, (미)니어비어(알코올분 법정률이하의 약한 맥주)
nearby : a, ad, 가까운, 가까이로, 가까이에, 근처에
Nearctic : a, (생물지리)신북아구의(Greenland와 북미 대륙의 북부지방 및 산악지대)
near distance : x, (그림의)근경
Near East : x, 근동(아라비아, 북동아프리카, 동남아시아, 발칸등을 포함하는 지역)
nearly : ad, 거의, 대략, 긴밀하게, 밀접하게, 간신히, 가까스로, 하마터면, 가까이에 접근하여, 정성들여, 꼼꼼하게, 인색하게
nearman : n, APEMAN
near miss : x, (유효한)근접폭격(사격), 지근탄, (공)(비행기의)이상접근, 니어미스, 성공에 가가운것, 일보직전(의 성과)
nearness : n, 가까움, 접근, 근사, 흡사, 근친, 친밀함, 인색
nearpanic : a, 거의 공황상태에 가까운
nearside : a, 왼쪽의, 좌측, 자동차의 길가쪽, 좌측의
nearsighted : a, 근시(안)의(shortsighted)
nearsightedly : ad, 근시안적으로, 선견지명이 없이, 일을 생각지 않고
nearsightedness : a, 근시
near thing : x, 이길(성공할)가망이 거의 없어 보이는 시합(선거, 모험(등))위기일발, 구사일생, 아슬아슬함(한짓)접전
near trm : a, 가까운 장래의
neat : n, 소종류, (한마리의), 축우(cattle)
neat : a, 산뜻한, 말쑥한, 깔끔한, 조촐한, 단정한, 깔끔한, 성미의, 솜씨좋은, 잘하는, 교묘한, 적절한, 간결한, 순수한, 물을 타지 않은(술등), 순..(이익), (미)굉장한, 멋진
neat'sleather : n, 쇠가죽(cowhide, oxhide의 총칭)
neaten : vt, ..을 깔끔하게 하다, 깨끗하게 하다
neatfootoil : x, 우각유(가죽을 부드럽게 하는데 씀)
neath : prep, =Beneath
neathanded : a, 손재주 있는, 솜씨(재치)있는, 민첩한, neathandness()n, 
neatherd : n, COWHERD
neathouse : n, (영방)외양간
neatly : ad, 깔끔하게, 말쑥하게, 맵시있게, 교묘하게
neatness : n, 깔끔함, 정연, 재치있음
NEATO : x, Northeast Asia Treaty Organization 동북아시아 조약기구
neb : n, (스코)부리(beak), (사람의)코, (짐승의)코오 입부분, 끝(tip)
Neb., Nebr. : x, Nebraska
nebbish : n, a, 시원찮은 사람, 박력이 없는 사람, 박력이 없는, 시원찮은
NEbE : x, northeast by east북동미동
NEbN : x, northeast by north
Nebraska : n, (북미 인디언 말(평평한강)의 뜻에서 , 네브래스카주(미국중서부의 주)
Nebraskan : a, n, 네브래스카주의(사람)
Nebuchadnezzar : n, 느부갓네살(신 바빌로니아 왕(605-562))
Nebuchadrezzar : n, 
nebula : n, 성운, 성무, (병리)각막예(백탁)
nebular : a, (천)성운(모양의), 흐릿한
nebular hypothesis(theory) : x, (천)(태양계의)성운설
nebulize : vt, 안개모양으로하다, (환부에)약액을 뿜다
nebulosity : n, 성운(성무)상태, 성운 모양의 물질(것), (사상, 표현등의)애매함(vagueness)
nebulous : a, (천)성운 모양의, 흐릿, 불투명한, 기억, 표현, 의미등이, 흐릿한, 불명료한, 애매(막연)한, nebulose()a, nebulously()ad, nebulousness()n, 
NEC : x, National Emergency Council(미)국가 비상대책 심의회
necessarian : a, n, Necessitarian
necessarily : ad, 반드시, 필연적으로, 부득이, (부정구문), 반드시(..은아니다)
necessary : a, 필요한, 없어서는 안될(유의어 necessary 필요한의 뜻의 가장 일반적인말, essential 어떤 것의 존재를 위해 본질적으로 필요한, indispensable필요 불가결한)필연의, 피할수 없는(inevitable)
necessary : n, 필요한물건, 필수품, (영방, 뉴잉글랜드)변소
necessary condition : x, (논, 철)필요 조건(cf.SUFFICIENT CONDITION)
necessary house : x, (방)변소(privy)
necessitarian : x, 필연(숙명)론자, 숙명론자의
necessitarism : n, 숙명론
necessitate : vt, (..을)필요로하다, 요하다, 부득이 ...하게하다(force)
necessitation : n, 필요화, 강제
necessitous : a, 가난한, 궁핍한(needy), 필연적인, 피할수 없는, 긴급한, 임박한, necessitously()ad, 
necessity : n, 필요성, 필요, 긴급한 필요, 필수품, 불가결한 것, 필연(성), 불가피(성), 궁핍, 궁상, 궁경
necessity stamps : x, (미)생활 필수품 원조제도
neck : n, vi, vt, 목(의복의)옷깃, (경마 말등의) 목의 길이, 근소한차, (기물등의)목부분, (바이올린등의)목, 통로의 좁은 곳, (육지 바다등의)좁은곳, 지협, (작은)해협, 기둥머리의 목부분(제일 밑부분), (양등의)목덜미 살, 서로 목을 껴안고 애무하다, 네킹하다
neck : n, (영방)(곡식을 베어 들일때의)마지막단
neckband : n, 샤쓰의 깃(칼라를 다는 곳)넥밴드(목에 감는 장식의 끈)
neckbeef : n, 소의 목덜미 고기, 도래목정
neckbreaking : a, BREAK NECK
neckcloth : n, (옛날 남성의 장식용)목도리, neckerchief
neckdeep : a, ad, 목까지 차는(빠져)
necked : a, 목이 있는, 목이..인(옷)
neckerchief : n, 목도리, 네커치프
necking : n, (기둥의)목부분의 몰딩장식, 목을 껴안고 하는 애무, 네킹
necklace : n, 목걸이, 네크리스, (익살)목을 달아매는 끈, 교수용 밧줄
necklet : n, (목에 꼭맞는)목걸이 털가죽 목도리
neckline : n, 네클라인(드레스의 목을 판 선)
neckpiece : n, (털가죽 등으로 된)작은 목도리, 목덮개(후드등의)
neckrein : vt, vi, (말의 목고삐로 말의)방향을 바꾸(게)하다
necktie : n, 넥타이, (미속)목 달아매는 끈, 교수용 밧줄
necktie party : x, (린치에 의한) 교수형, 목달아맴, 교살, 린치 집단
neckverse : n, 면죄시(옛날 사형수가 흑자체의 라틴어 성서 시편 제 51편 첫머리를 읽을수 있으면 사면되었음)
neckwear : n, (상용어)목에 착용하는 물건들(넥타이, 목도리, 칼라)
necoro- : x, (연결형)죽음, 시체, 회사, 회저의 뜻
necrobiosis : n, (병리)변성회저
necrogenic : a, 썩은 고기에서 발생하는, 썩은 고기에서 사는
necrolatry : n, 사자숭배
necrologist : n, 사망기자담당자, 사망자 명부 편집자
necrology : n, 사망자 명부, 사망기사
necromancer : n, 점쟁이, 무당, 마술사
necromancy : n, (죽은 사람과의 영혼의 교감으로 미래를 점치는)점, 마법, 마술
necromantic : a, 마술적인, necrophagia()n, 
necrophagous : a, 죽은 썩은 고기를 먹는(벌레, 세균등)
necrophagy : n, 죽은(썩은)고기를 먹음(먹는 습관), 시체식
necrophile : n, 시체애호자, 시간자
necrophilia : n, 
necrophily : n, (정의)시간, 사간, 시체 성애
necrophoabia : n, 시체(사망) 공포(증)
necropolis : n, (특히 옛 도시의)대규모 공동묘지, (폐허가 된)죽음의 도시
necroscopy : n, 검시, 부검, 시체를 검시하다
necrosis : n, (병리)회저(gangrene), 탈저
necrosy : n, vt, 검시, 부검, 시체를 검시하다
necrotic : a, 회저성의
necrotiz : vi, vt, (병리)회사하다, ..을 회사시키다
nectar : n, (그신)넥타, 신주(cf.AMBROSIA)(진한)과즙, 달콤한 음료, 넥타, 미주, nectarean()a, 
nectareous : a, NECTAROUS
nectarine : n, (식)승도복숭아
nectarous : a, NECTAR의 같은, 감미로운
nectary : n, (식)꿀샘, 밀선, 밀관
necton : n, NEKTON
Ned : n, 남자 이름(Edward, Edmond, Edwin의 애칭)
Neddy : n, NED, (영구)당나귀(donkey), 멍청이, 바보
nee : a, 구성은
need : x, 필요, 소용, 요구, 필요한 것, 어려울 때, 만일의경우, 군핍, 빈곤, 필요로하다, 필요하다
needer : n, 필요로 하는 사람
needfire : n, 정화, (나무를 마찰해서 일으킨 불, 가축병에 특효가 있다고 믿어졌음), 봉화, 횃불, 자연발화, (썩은 나무등의)발광
needful : a, n, 필요한, 없어서는 안될, 빈곤한, 필요한 짓(일), (필요한)돈, needfully()ad, 
needle : 바늘, 봉침, 뜨개바늘, (외과, 주사, 조각, 축음기등의)바늘, 지침, 나침, 뾰족한 바위, 방첨탑(obelisk), 바늘 모양의 잎, 침엽, (솔, 전나무 등의), 침정, 침상결정체, 저울대보, 버팀대막이, 바늘로 꿰매다, 바늘을 찌르다, 누비고 나가다, (백내장 등을)침으로 치료하다, (버팀대로)(벽을)받치다, 자극하다, 선동하다, 괴롭히다, 지분거리다, 꾸짖다, 비난하다, (볶아대어)서두르게 하다, (goad), (영)(게임, 경기, 등이)아슬아슬한, 격렬한, 바느질하다, 누비듯이 나아가다
needlebar : n, 바늘대(재봉편물)기계의)
needle bath : x, 물이 가늘게 나오는 샤워
needle book : x, 바늘쌈지(종이를 접은 모양의)
needle candy : x, (미속)주사해서 쓰는 마약
needle case : n, 바늘쌈
needlecraft : n, NEEDLEWORK
needlefish : n, (어)동갈치
needleful : n, 한 바늘에 쓸만한 실의 길이
needle gap : x, (전)침선갭
needle gun : x, (19세기 말의)후장총
needle lace : x, 바늘로 뜬 레이스
needle match(game) : x, 접전
needlepoint : n, 바늘 끝, 바늘로뜬 레이스
needler : n, NEEDLE하는 사람, 날카로운 말로 남을 자극하는 사람, 심한 잔소리로 남을 안달나게 하는 사람, 남의 흠을 잡는(남을 헐뜯는)사람
needle shower : x, NEEDLE BATH
needless : a, 불필요한, 쓸데없는, needlely()ad, needleness()n, 
needle therapy : x, 침요법, 침술(acupuncture)
needle time : x, (영)(방송)레코드 음악시간
needle valve : x, 니들밸브, 침판
needlewoman : n, 바느질하는 여자, 침모
needlework : n, 바느질(제품)(특히)자수
needleworker : n, 
needments : n, pl, 필요품(특히 여행용)필수품
needn't : x, need not의 단축
needness : n, 곤궁, 빈곤, 궁핍
needs : ad, 꼭, 고집스럽게(어리석게도)..히겠다고 주장하다
needy : a, 매우 가난한, 궁핍한 사람들
nef : n, 네프(배 모양의 식탁용기, 냅킨, 소금그릇, 포도주병등을 올려놓음)
nefarious : a, 극악한, 사악한, 버릇없는, 불손한, nefariously()ad, nefariousness()n, 
neg. : x, negative(ly)
negabinary : n, a, (수)음의 2진수(를 나타내는)
negate : n, vt, (사실, 진실을)부정(부인)하다(deny), 취소하다, 무효로 하다, 부정(반대)적인 것
negater : x, NEGATOR
negation : n, 부정, 부인, 취소, 무, 결여, 비존재, 비실재, (문법)부정, 부동(제외)의 단정
negationist : n, 부정론자
negative : a, 부정(부인)의, 부정적인, 거부적인, 반대의, 적극성이 없는, 소극적인, 효과가 없는, 쓸모없는, 음의 마이너스의, 음성의, 음전기의(를 일으키는), 음화의
negative : n, 부정어, 부정 명제, 거부, 거절, 부정의 말(회답), 거부권(veto), (일, 성격등의)소극성, 부정적 측면, (수)음수, (전)음전기, (전기의)음극판, 원판, 음화
negative : vt, 거부(거절)하다, 부인(부정)하다, 부결하다, 논박하다, 반증하다, 무효로하다, 중화하다, negativeness()n, 
negative campaign : x, (자기 주장을 펴기보다)상대 후보 공격을 위주로 하는 선거운동
negative capital : x, 부채
negative debt : x, 자본
negative eugenics : x, 소극적 우생학(좋지 않은 유전자를 감소시키는 요인, 수단을 연구함)
negative euthanasia : x, PASSIVE EUTHANASIA
negative evidence : x, (법)소극적 증거, 반증
negative feedback : x, 음 되먹임, 음 피드백
negative growth : x, (경제의)마이너스 성장
negative income tax : x, 역 소득세(저소득자에게 정부가 지급하는 보조금
negative interest : x, 역금리, 마이너스 금리
negative list : x, 네거티브, 리스트(GATT에 보고하는 수입제한 품목
negatively : x, 부정적으로, 소극적으로
negative option : x, 주문하지 않은 상품이 우송돼 왔을때의 수취인의 선택권
negative pole : x, (자석의)남극, (전)음극
negative quantity : 음수, 익살, 무
negative sign : x, (수)마이너스 기호, 감호
negative transfer : x, 소극적 전이(학습 과정에서 선행 학습이 후의 학습을 방해 억제
negativism : n, 부정(소극)주의, (심)반항(반대)벽, negativist()n, 
negativistic : n, 
negativistic : x, a, 극성, 음성
negativity : n, 부정성, 소극성, 음성
negator : n, 부정(반대)적인(negative)
negatory : 
negatron : n, 음전자
neglect : vt, n, (의무, 일등을)게을리하다, 소홀히하다, 무시하다, 경시하다, 간과하다, 태만, 소홀, 무시, 태만하여, ..하지 않다
neglect : n, 태만, 소홀, 무시, neglaecter()n, negativetor()n, 
neglectful : a, 태만한, 소홀한, 부주의한, 무관심한, 냉담한, neglectfully()ad, neglectfulness()n, 
negligee : n, a, (여자의 통넓은)네글리제, 실내복, 화장복, 약장, 소탈한 복장의, 마음을 터놓은
negligence : n, 태만, 부주의, 무관심, 등한, 단정치 못함, 태반한 행위, (법)부주의로 인하)과실, 법칙의 무시, 자유분방
negligent : a, 태만한, 부주의한, 무관심한, 등한한
negligiability : n, 
negligiable : a, 무시해도 좋은, 대수롭지 않은, 하찮은, negligiably()ad, 
negociant : n, (포도주)상인업자
negotiability : n, 협상할수 있음, (증권등의)양도 할수 있음, 유통성, (도로등이)통행할수 있음
negotiable : a, 교섭, (협정)할수 있는, (어음등 )양도할수 있는, 유통성있는, 도로등이 통행할수 있는, 유통성 있는, (도로등이)통행, (곤란등이)극복할수 있는
negotiant : n, NEGOTIATOR
negotiate : vt, vi, (교섭으로)협정하다, 결정하다, (어음, 증권, 수표 등을)유동시키다, 돈으로 바꾸다, 팔다, 뛰어넘다, 빠져나가다, (곤란, 장애등을)뚫고 나가다, 교섭(협상)하다
negotiation : n, 교섭, 협상, (어음등의)유통, 양도, 뛰어넘음, 뚫고 나감
negotiator : n, 교섭자, 협상의, (어음등의)양도인
negotiatory : a, 교섭의, negotiatress()n, 
negotiatrix : n, 여자NEGOTIATOR
Negress : n, NEGRO의 여성형
Negrillo : 네그릴로(아프리카의 키작은 흑인):n, 
Negritic : n, Negro의 NEGRITO의
Negrito : n, 네그리토(동남아, 오세아니아 등에 사는 키 작은 흑인
Negritude : n, 흑인의 문화적인 긍지, 흑인으로서의 자각, 흑인임, (집합적)흑인의 특질
negritudinous : a, 흑인적인, 흑인의 특징이 있는, 흑인임을 나타내는
Negro : n, a, 니그로, 흑인, 흑인(종)의, 흑인이 사는, 흑인에 관한, 검은
negro ant : 검은개미:x, 
negro cloth : (cotton)거친 무명의 일종
negrohead : n, 씹는 담배, 질이 나쁜 고무의 일종
Negroid : a, n, 흑인종과 관계가 있는, 흑인종 비슷한, 흑인계의, 흑인사람, 준 흑인종
Negroism : n, 흑인 옹호, 흑인의 언어 풍습, 흑인 사투리
Negro music : x, 흑인음악
Negroness : x, 흑인임
negroni : n, 니그로니(베르무트, 비터즈, 진으로 만든 칵테일)
Negrophile : a, n, 흑인 편드는(사람), 친 흑인파의(사람)
Negrophilism : n, 흑인편을 듦, 흑인두둔
Negrophobe : n, 흑인 혐오(공포)자
Negrophobia : n, 흑인 혐오
Negro spiritual : x, 흑인영가
Negro state : x, (남북 전쟁 이전의 남부의 노예주
negus : n, 니거스술(포도주 더운 물, 설탕, 레몬등을 탄 음료)
Negus : n, Ethiopia황제의 존칭
Neh. : x, Nehdmiah
Nehemiah : x, 느헤미야(기원전 5세기경의 유대의 지도자)느헤미야서
Nehru : x, 네루 인도의 수상
Nehru jacket(coat) : x, 네루복(코트)칼라를 높이 세운긴 상의
neigh : n, (말의)울음소리, (말이)울다
neighbor : n, a, vt, vi, 이웃사람, 옆자리 사람, 동포, (같은 종류의)서로 이웃하는 것, 이웃의, 이웃하다, 인접하다, 이웃해 있다, (..의)근처에 살고 있다, 가까운(친한)사이이다
neighbored : (부사 뒤에 놓여)이웃사람(부근이)..인(한)
neighborhood : n, a, 근접함, 근처, 인근, 이웃, (집합적)이웃사람들(neighbors)주위, (어떤 특징을 가진)지역, 지방, 이웃간의 정의, 친근한사이, 자네(친한 사이의 부름말)근처의, 이웃의, 그지역의
neighborhood house : x, (미)안보관(settlement house)
neighborhood unit : x, (영)근린 주택지구(인구 1만명 정도의 도시 계획단위)
neighboring : a, 이웃의, 근처(인근)의 인접한
neighborless : a, 이웃이 없는, 고독한(solitary)
neighborliness : n, 이웃의 정의, 사귐성 있음, 친절함
neighborly : a, 이웃 사람다운, 사귐성있는, 친절한
neighborship : n, 이웃함, 이웃관계, 이웃간
Neil : n, 남자이름
neither : ad, ...도 아니고 ...도 아니다, ...도 또한 ...이 아니다, 'Tis ~ here nor there, 그것은 관계없는 일이다
neither : conj, 또한 ...도 않다
neither : a, 어느쪽의 ...도 ...아닌
neither : pron, 어느쪽도 ... 아니다
nek : n, (아프리카 남부(산의)안부, 산협
nekton : n, 유영 동물
Nell : n, 여자이름
Nellie, Nelly : 남자이름(Nelson의 애칭), 여자이름(Eleanor, Ellen, Helen의 애칭), 바보, 여자같은놈, 연약한 녀석(호모)
nelson : n, (레슬링)넬슨, 목조르기
Nelson : x, 넬슨 영국의 제독
nem.con. : x, nemine contradicente
nem. diss. : x, nemine dissentiente
nematic : a, 네마틱(상태)의 (액정의 가늘고 긴 분자가 서로의 위치는 불규칙하지만 그장축은 모두 일정 방향으로 향하고 있는 상태)
nematocyst : n, (가시 세포(말미잘, 히드라 등과 같은 강장 동물의 기관)
nematode : a, n, 선충류의
Nembutal : n, 넴뷰탈 , 펜토바르비탈, (바르비투르산 유도체, 최면, 진정제, 상표명)
Nemea : n, 네메아(그리스 남동부 옛 Argolis에 있는 골짜기), Nemean()a, 
Nemean games : x, 네메아제(2년 마다 nemea에 열렸던 그리스 4대 제전의 하나, 나머지Olympian games, Pythian game, Isthmian games
Nemean Lion : x, (그신)네메아의 사자(Hercules가 죽였다고 하는 Nemea 골짜기의 사나운 사자)
Nemesis : n, (그신)네메시스(인과 응보, 복수의 여신), 천벌, 응보, 인과, 징벌을 가하는 사람, 보복하는 사람, 강한(이길수 없는)상대
neminecontradicente : ad, 만장 일치로(unanimously)
nemine dissentiente : ad, NEMINE CONTRADICENTE
nemophila : x, (식)네모필라(북미산의 1년생 초목)
nene : n, 하와이 기러기(하와이주의 주조, 국제 보호조)
NEO : x, near earth orbit지구에 가까운 궤도
neo- : prep, (연결형)신..부활..근대의.., 후기..의 뜻
neoantigen : n, 신(생)항원
NeoCambrian : a, 캄브리아기 후기의
Neocene : a, n, (지질)신 제 3기의, 신제3기
neoclassic, -sical[n'i:o~ukl'4sik(5l)신 고전주의의
neoclassicism : n, 신고전주의, neoclassicist()n, 
neocolonial : a, n, 신식민지주의의, 신식민지주의자
neocolonialism : n, 신식민지주의(제 2차 대전 이후 약소국에 대한 강대국의 정치적, 경제적 헤게모니)
neoconservatism : n, (미)신보수주의(정부의 거대화에 반대, 기업의 이익을 지지하고 사회 개혁에 주력)
neoconservative : a, n, (미)신보수주의의, 신보수주의자, 신보수파
neocortex : n, (대뇌의)신피질
neocortical : a, (대뇌의)신피질의, 
NeoDadaism : n, 신다다(이즘), 반예술운동
Neodarwinism : n, 신다윈설(자연도태를 중시하는(Weismann의 설), Neodarwinist()n, 
neodymium : n, 네오디뮴(회금속 원소의 하나, 기호 Nd)
neofascist : n, 신파시스트, 신국수주의자
Neogene : a, n, NEOCENE
neoglaciation : n, 신빙하 형성(작용)
Neogothic : a, 신 고딕(양)식의
NeoGreek : n, 현대 그리스어
NeoHegelian : a, n, 신헤겔 철학의(신봉자)
NeoHellenism : n, 신그리스주의
neoimperialism : n, 신제국주의
neoimperialist : n, 신제국주의자
NeoImpressionism, neoi- : n, 신인상주의
neoisolationism : n, 신고립주의(특히 월남전쟁후 미국의 외교정책에 나타난 경향)
neoisolationist : a, n, (정)신고립주의의, 신고립주의자
NeoKantian, neoK- : a, n, (철)신칸트파의(학도)
neoKeynesian : a, n, 신케이스주의의, 신케인스주의자
Neolamarckism, neoL : n, (생)신라마르크설
NeoLatin : n, a, 근대 라틴어 로만스 말, 로만스말(계)의
neoliberal : n, (미)신진보파(1960년대말에서 70년대에 걸쳐 민주당의 전통적 진보파에서 우익으로 전향한 그룹)
neolith : n, 신석기 시대의 석기
neolithic : a, 신석기시대의
neolocal : a, 새거소를 갖는, 신거제 혼인
neologian : a, n, 신교리를 채택(지지)하는, (신학의)합리주의주장자
neological : a, NEOLOGISTIC
neologism : n, 신어, 신조어, 신표현, 신어의, 신어(신조어, 신표현, 신어의)의 사용(채용), 신학설 신학, 신교리, 신교리의 채택(지지), neologist()n, 
neologistic, -tical : a, 신어(사용)의, 신설의
neologize : vi, 신어를 사용하다(만들다), 신교리를 채택하다
neology : n, NEOLOGISM
neoMalthusianism : n, 신맬서스주의(산아제한에 의한 인구 조절론)
NeoMelanesian : a, n, 신멜라네시아말(의)(Melanesia및 New Guinea에서 쓰이는 영어를 모체로 한 혼성어)
neomonetarism : n, 신화폐주의
neomort : n, 신사체 식물인간
neomycin : n, 네오마이신(방사균에서 얻는 항생물질의 일종)
neon : n, 네온(네온 기초 원소의 하나, 기호 Ne), 네온등
neonatal : a, 신생아의
neonate : n, (생후 1개월 이내의)신생아
neonatologist : n, 신생아 학자
neonatology : n, 신생아학
NeoNazi : n, (1945년 이후의)신나치주의자
NeoNazi activities : x, 신나치스 운동(1959년에 시작된 반유대 운동)
neon lamp(light, tube) : x, 네온등
neon tetra : x, 네온테트라(열대어의 일종)
neontology : n, 현세 생물학
neopaganism : n, 신부흥 이교주의
neoPentecostal : a, n, 신펜테코스테파의(신자)(방언, 신앙 요법등 펜테코스테파의 신앙을 강조하는)
neophilia : n, 새로운(신기한)것을 좋아하기
neophyte : n, 신개종자, 초심자, (천주교)새성직자, (수도원의)수련자, 신참자
neoplasitic : a, (병리)신생(물)의 종양의, 신조형주의의
neoplasm : n, (병리)체내에 생기는 신생물, (특히)종양
neoplasticism : n, 신조형주의
Neoplatonic : a, 
Neoplatonism : n, (철)신플라톤파 철학, 신플라톤주의(plato의 철학에 동양의 신비주의가 가미된 사상), Neoplatonist()n, 
neoprene : n, 네오프렌(합성고무의 일종)
Neorican : n, a, 푸에르 토리코계 뉴욕시민(의)
NeoRomandticism : n, 신낭만주의
Neosalvarsan : n, 네오살바르산(매독치료제)
neotemperance : n, 신 금주 운동(1980년대에 금연 운동에 이어 그 경향이 강화되고 있음)
neoteric : a, n, 현대의(modern), 최신의, 신안의 , 참신한, 현대인, 현대작가(사상가)
Neotropical : a, 신열대구의 (북회귀선이 남의 신대륙)
neovascularization : n, 신혈관형성(특히 종양 내의 새 모세 혈관의 발생 성장)
neozoic : a, n, CENOZOIC
NEP, Nep, N.E.P. : x, New Economic Policy
Nep. : x, Neptune
Nepal : n, 네팔(인도와 티베트사이의 왕국
Nepalese : a, 네팔(말, 사람)의
Nepali : a, n, 네팔의, 네팔사람(말)의
nepenthe : n, 시름을 잊게 하는약(물건)(일반적으로)고통을 잊게 하는 것, nepenthean()a, 
nepenthes : n, NEPENTHE, (식)네펜시스, 벌레잡이통풀
neper : n, (식)네퍼(감쇠 비율을 나타내는 정수)
nephanalysis : n, 네프아날리시스(구름의 모양, 양과 강수량의 관계를 중시하는 일기도 분석
nepheline : n, 하석
nepheloid layer : x, (점토 구성물 크기의 미세한 광물이 떠다니는 심해의)현탁층
nephelometer : n, 탁도계, 비탁계
nephew : n, 조카, 생질(완곡)(성직자)의 사생아
nephilite : n, 
nepho- : x, (연결형)구름(clound)의 뜻
nephology : n, (기상)구름학(기상학의 하나)
nephoscope : n, 구름 방향제, 측운기
nephr- : x, 
nephralgia : n, (병리)신장통
nephrectomy : n, (외과)신적출(술), 신장 절제
nephridium : n, (무척추 동물의)배설관, 신관
nephrite : n, 연옥(신장병에 좋다고 생각되었음
nephritic : a, 신장염의
nephritis : n, (병리)신염, BTIGHT'W DISEASE
nephro- : x, (연결형)신장의 뜻 (모음 앞에서는 nephr)
nephrology : n, 신장(병)학
nephropathy : n, (병리)신장해, 신중, 신장병
nephrosis : n, (병리)상피성 신장증
ne plus ultra : n, 극한, 극점, 극치, 정점, 뛰어넘을 수 없는 장애, 큰 난관
nepotic : a, 연고자(친척)등용의 (경향이 있는)
nepotism : n, 친척등용, 족벌주의
nepotist : 친척을 등용하는 사람, 족벌주의자
Neptune : n, (로신)냅튠(해신, 그리스 신화의Poseidon에 해당함)바다, 대양, 해왕성
Neptunian : a, NEPTUNE의 , 바다의, 해왕성의, 수성의(CF.PLUTONIC)
neptunism : n, (지질)(암석)수성론
neptunist : n, (암석)수성론자
neptunium : n, 넵투늄(방사능 원소의 하나, 기호 Np, 번호 93)원자 폭탄용
nerd : n, (미속)얼간이, 멍텅구리
nereid : n, a, (동)갯지렁이(의)
Nereid : n, (그신)네레이스(바다의 요정)(천)네레이드(해왕성의 제 2위성)
nereus : n, 갯지렁이
Nereus : n, (그신)네레우스(바다의신Nereids의 아버지)
nerf : vt, (drag race에서 남의 차에)(자기차를)가볍게 부딪치다
nerf(ing) bar : ㅌ, (바퀴를 보호하기 위하여 개조 고속차(hot rod)에 다니는)완충기(bumper)
neritic : a, 얕은 바다의, 연안의
Nero : n, 네로, (로마의 포악한 황제, 기독교도를 박해한 폭군)
neroli oil : x, 등화유
Neronian : a, NERO와 같은, 잔인(방탕, 횡포)한
nerts, nertz : int, (미속)NUTS
NERVA : x, nuclear engine for rocket vehicle application(미)핵 우주 차량 개발 계획
nerval : a, 신경계의(에 관한)
nervate : a, (식)잎맥이 있는
nervation : n, (생)맥상, 맥계
nerve : n, 신경, 치수, (통속적으로)(이의)신경, 근원, 중추, 힘줄, 건, 용기, 담력, 기력, 정신력, 뻔뻔스러움, 무례, 민감한곳(신경에 걸리는)미묘한 점, 신경이상(과민), 안달, 겁, 우울, 신경과민증, 히스테리, 잎맥, 날개맥
nerve : vt, 힘을 주다, 용기를 북돋우다, 격려하다
nerve agent : x, (군용의)신경계에 작용하는 물질, 신경가스(등)
nerve block : x, 신경차단(법)(국부 마취의 일종)
nerve cell : x, 신경세포
nerve center : x, 신경중추, (조직, 운동등의)중추(중심)부, 수뇌부
nerve cord : x, (무척추동물의)신경삭
nerved : a, 활기있는, 대담한, 신경이..한, 잎맥(날개맥)이 있는
nerve fiber : x, 신경섬유
nerve gas : x, 신경가스(독가스의 일종)
nerve growth factor : x, (생리)신경 성장인자(지각(교감)신경세포의 성장을 자극하는 단백질)
nerve impulse : x, (생리)신경충격(자극)
nerveknot : n, GANGLION
nerveless : a, 신경이 없는, 잎맥(날개맥)이 없는, 활기(용기)가 없는, 무기력한, 약한, (문체가)산만한, 냉정한, 침착한(calm), nervely()ad, nerveness()n, 
nerveracking, -wrack- : a, 신경을 괴롭히는, 안달나게 하는, 조마조마하게하는
nerve trunk : x, 신경원줄기, 신경간
nerve war : X, 신경전, 선전전(cf.COLD WAR, SHOOTING WAR)
nervine : a, n, 신경의, 신경을 진정시키는, 신경진정제
nerving : n, (만성 염증의)신경절제
nervosity : n, 신경질, 신경과민(성)소심
nervous : a, 신경(성)의, 신경에 작용하는, 신경질의, 신경과민의, 흥분하기 쉬운, 안달복달하는, 안절부절못하는, 침착성이 없는, (다소)겁내는, 두려워하는, 소심한, 강한, 굳센, (문체등이)힘찬, 간결한
nervous breakdown(prostration) : x, 신경쇠약
nervously : ad, 신경질적으로, 초조하게, 소심하게, 힘차게, 억세게
nervous Nellie(Nelly) : x, 겁쟁이, 못난이
nervousness : n, 신경과민, 겁, 소심성
nervous system : n, 신경계통
nervure : x, 날개막(vein), 잎맥
nervy : a, 기골이 장대한, 강한, 기운좋은, 대담한, 용기있는, 뻔뻔스러운, (신경질)신경과민, 흥분하기 쉬운, 신경에 거슬리는
nescience : n, 무지(ignorance), (철)불가지론
nescient : a, n, 무지한, 모르는, (철)불가지론(자)의, 불가지론자
ness : n, 곶, 갑, 해각
Ness : x, 네스호(스코틀랜드 북서부의 호수, 괴물이 살고 있다고 함)
ness : suf, (분사(복합)형용사 등에 붙여서, (성질, 상태)등을 나타내는 추상명사를 만듦
Nesselrode : n, 과일의 설탕절임(푸딩, 아이스크림등에 넣는)
Nessie : n, 네시(스코틀랜드의Ness호에 출몰한다고 하는 괴물)
Nessus : n, (그신)네소스(켄타우로스족의 하나, Hercules의 아내를 범하려다 독화살을 맞고 죽음)
nest : (새, 곤충, 물고기, 파충류, 쥐, 토끼등의)보금잘, 둥우리, 둥지, 새집, 피난처, 아늑한곳, 소굴, 온상(나쁜짓 등의)(집합적)보금자리속의 것(알새끼등)한배(에 깐) 새끼떼, (새벌레등의), (벌레등의)떼, (악인등의)일당(크기가 각각 다르고 포갤수 있는 상자, 탁자스푼등의)한벌
nest : vi, vt, 보금자리(새집)를 짓다, 깃들이다, 알자리를 찾다, 새집을 찾다, 보금자리(새집)을 지어주다, (상자등을)포개넣다
NEST : x, Nuclear Emergency Search Team
nestdoor : a, 이웃의
nest egg : x, 밑알, 자금의 밑천, 본전, (만일의 경우에 대비하는)비상금
nestful : n, 새둥우리 하나에 가득한것
nestle : vi, vt, 깃들이다, 편안하게 드러눕다, 기분좋게 자리잡다, 바싹다가서다, (집등이)(쾌적하게 깊숙이)자리잡고 있다, 주위의 풍경속에 파묻히다시피서 있다, (머리, 얼굴, 어깨등을..에 비벼대다, 아늑하게 자리잡도록하다, nestler()n, 
nestling : n, 갓 깐 병아리, 어린아이(young child)
Nestor : n, (그신)네스토르(homer작 Iliad)중의 슬기로운 노장군), 현명한 노인oy전쟁때의 현명한노인
Nestorian : a, n, Nestorius교파의, 네스토리우스 교도
Nestorism : n, 내스토리우스의 교의
Nestorius : n, 네스토리우스 (예수의 신성과 인성을 구별할 것을 주장)
net : n, 그물, 네트, 그물모양으로 짠것, 그물세공, 그물레이스, 거미줄, 올가미, 함정, 계략, 통신망(라디오, 텔레비전등의)네트워크, 방송망, 네트볼
net : v, 그물로 잡다, 투망질하다, 그물로 덮다, 그물을 치다, 그물을 뜨다(만들다)(속)올가미로 걸다, (노력의 결과)얻다, (공을)네트에 치다, 그물모양을 이루다
net : a, n, 에누리 없는 정미, 순, 정가의, (결과등)결국의, 최종의, 순량, 정미, 순익, 정가
net : n, (얼마의)순익을 올리다, (..에게 이익을)올리게 하다
NET : x, National Educational Television
net amount : x, 판매가격(고객에서 파는)
netball : n, 네트볼(농구비슷한 일종의 구기, 영국 여성이 좋아함)
net domestic product : x, 국내 순생산
net economic welfare : x, 순경제 복지도
net fishing : x, (주낙에 대하여)투망질
netful : n, 그물 가득한(것)
Neth. : x, Netherlands
nether : a, 아래의, 지하의, 지옥의
Netherlander : n, 네덜란드 사람
Netherlandic : a, 
Netherlandish : a, n, 네덜란드 사람(말)의, 네덜란드말
Netherlands : n, 네덜란드, Netherlandian()a, 
Netherlands East Indies : x, DUTCH EAST INDIES
nether man(person) : x, 다리
nethermost : a, (문어)가장아래의
nether regions : x, 지옥
netherworld : n, 명부, 지옥, 내세, 저승, 암흑가
net income : x, 순수입, 순(이익)
netkeeper : n, 
netman : n, 정구선수
netminder : x, GOALKEEPER
net national product : x, 국민순생산
net play : x, (정구)네트플레이(네트 가까이 위치하는 플레이의 총칭)
net profit : x, 순이익, 수수익, 순익
NETRC : x, National Educational Television and Radio Center
netskimmer : x, (정구)네트스키머(네트를 스치듯이 넘어가는 타구)
nett : a, n, vt, =Net
netted : a, 그물로잡은, 그물로싼(창등이)그물을 친, 그물 모양의, 그물세공의
netter : n, 그물을 치는, 만드는, 사람, 정구선수
Nettie, Netty : n, 여자이름
netting : n, 그물세공, 그물뜨기, 그물질
netting needle : x, 그물뜨는 바늘
nettle : n, vt, 쐐기풀, 무리, 쐐기풀처럼 찌르다, 약오르게 하다, 초조하게 만들다, 화나게 하다
nettle creeper : x, 휘파람새의 일종
nettlegrasper : n, 어려운 일에 대담하게 대처하는 사람
nettle rash : x, 두드러기
nettlesome : a, 초조하게 만드는, 난처하게 만드는, 귀찮은, 화를 잘내는
net ton : x, (미)톤(2000파운드, 순톤
netty : a, 그물모양의, 그물 세공의
net weight : x, 순중량(cf.GROSS WEIGHT)
network : n, vt, (운하, 철도등의)망상조직, 연락망, 망세공, 망제품, 라디오tv)방송망, 네트워크, (전산)회로망, ..에 방송망을 설치하다, 방송망으로 방송하다
network analysis : x, (수)회로(망) 해석, 네트워크분석, (회로망 해석 수법을 이용하여 프로젝트의 계획 관리를함
networking[n'etw'네트워킹(여러대의 컴퓨타 데이타뱅크가 연계되어 있는 시스템)
Neufchatel : n, (생산자인 프랑스 북부의 도시명에서), 뇌사텔(치즈의 일종, 무르고 맛이 진함)
neume, neum : n, 네우마(중세의 기보, 기호, 현재의 그레고리오 성가에서 씀)
neur- : x, 
neural : a, 신경(계)의, neurally()ad, 
neuralgia : n, 신경통
neuralgic : a, 신경통성의
neurasthenia : n, 신경쇠약(증)
neuration : n,   venation
neuristor : n, (전산)뉴리스터(신호를 감소시키지 않고 전달하는 장치)
neuritis : n, 신경염, neuritic()a, 
neuro : x, (연결형)NEUR-
neuroactive : a, (생리)신경조직을 자극하는
neurobiology : n, 신경생물학
neurochemical : a, n, 신경화학의, 신경화학물질
neurochemistry : n, 신경화학
neurodepressive : a, 신경을 진정시키는, 신경억제의
neuroendocrine : a, (생리)신경내분비(작용)의
neuroendocrinology : n, 신경내분비학
neuroethology : n, 신경동물 행동학
neurogenetics : n, 신경유전학
neurol. : x, neurological, neurology
neuroleptanalgesia : x, 신경이완성 진통상태, 신경이완마취(법)
neuroleptic : n, a, 신경이완(차단)제, (특히 정신분열증의)진통제, 신경이완(차단)작용을 하는
neurolinguistics : n.pl, 신경언어학
neurological : a, 신경학상의
neurologist : n, 신경학자, 신경과의사
neurology : n, 신경학
neurolysis : n, (병리)신경조직붕괴, 신경피로, 신경박리술
neuroma : n, (병리)신경종
neuron : n, 신경단위(세포)
neuronic : a, 신경단위의
neuropath : n, 신경병환자, 신경병 소질자
neuropathist : n, 신경병전문가(의사), neuropathic()a, 
neuropathology : n, 신경병리학, neuropathologist()n, 
neuropathy : n, 신경병, 신경장애
neuropharmacology : n, 신경약리학, neuropharmacologist()n, 
neurophysiology : n, 신경생리학, neurophysiologist
neuroprobe : n, 신경침(전류를 통하여 환부를 찔러 자극, 치료하는 바늘)
neuropsychiatric : a, 신경정신병의
neuropsychiatrist : n, 신경정신병의사
neuropsychiatry : n, 신경정신병학
neuropsychic, neuropsycical : a, 신경심리(학적)의
neuropsychosis : n, 신경 정신병
neuropteran : n, 맥시목의 곤충(명주잠자리, 풀잠자리등)
neuropterous : a, 맥시류의
neuroregulator : n, (생리)신경조정 물질(신경세포간의 전달에 작용하는 화학물질)
neuroscience : n, 신경과학
neuroscientis : n, 
neurosensory : a, (생리)감각(지각) 신경의
neurosis : n, 신경증, 노이로제
neurosurgeon : n, 신경외과 의사
neurosurgery : n, 신경외과학, neurosurgical()a, 
neurotic : a, n, 신경증의, 신경계의, 노이로제에 걸린, (약제가)신경을 침범하는, 신경증에 잘듣는, 신경증환자
neurotomist : n, 신경해부가
neurotomy : n, (아품을 더는)신경절제, 신경해부학
neurotransmitter : n, 신경전달물질
neut. : x, neuter, neutral
neuter : a, 중성의, 자동의, 무성(중성의)
neuter : n, a, vt, 중성, 중성명사(대명사, 형용사, 관사), 자동사, 중립자, 암수구별이 없는동식물, 무생식 암펄레(일개미, 일벌등)거세된 사람(동물), (동물을)거세하다, 난소를 제거하다
neutercane : n, 아열대성 저기압(생성기구는 허리케인이나 전선저기압과 같으나 규모가 작은것)
neuto- : x, 신경조직, 신경계의 뜻(모음 앞에서는 neur-)
neutral : a, 중립(국)의, 중립국, 불편부당의, 어느편도 들지 않는, (종류, 특징)분명치 않은, (색이)바랜, 회색의, 중성의, 암수 구별이 없는, (혀의 위치가)중성의, 중간의, 중리국(민), 중립자, (전동기어의)중립(위치)
neutral corner : x, 뉴트럴 코너(경기자의 휴게용으로 지정되어 있지 않은 코너)
neutral current : x, 중립적 소립자류, 중성 커렌트
neutralism : n, 중립주의(정책), 중립(태도, 상태, 표명)
neutralist : n, 중립주의자
neutrality : n, 중립 (상태), 국외중립 정책, 불편부당, 중성
neutralization : n, 중립화, 중립(상태), 무효화, (화)중화, (언)중화
neutralize : vt, 중립시키다, 지우다, 중화하다, 무효로하다
neutralizer : n, 중립시키는 것, 무효로 하는것, 중화물(제)
neutrally : ad, 중립적으로
neutral meson : x, 중성 중간자(neutretto)
neutral mutation : x, 중립돌연변이
neutral spirits : x, 중성 주정(95도 이상순수 알코올, 보통 다른 술과 섞어마심)
neutral tint : x, 중간색, 연한회색
neutral zone : x, 중간지대
neutretto : n, 중성중간자(neutral meson)
neutrino : n, 중성미자
Neutrodyne : n, 진공관식 라디오 수상기(상표명)
neutron : n, 중성자
neutron activation analysis : x, 중성자(유도)방사화 분석
neutron bomb : x, 중성자 폭탄
neutron poison : x, 중성자독, 중성자 흡수 물질(반응저해물질)(중성자를 흡수하여 핵분열 반응의 장애가 됨)
neutron radiography : x, 중성자 사진법, 중성자 라디오 그래틱(x선 대신에 중성자선을 써서 물체 내부를 촬영하는 기술)
neutron star : x, 중성자성
Nev. : x, Nevada
Nevada : n, 네바다, 미국서부의 주
Nevadan : a, n, Nevada주의(사람)
neve : n, 만년설(빙하의 상층부를 형성하는 입상 빙설
never : ad, 결코(일찌기, 조금도)... 안다, ~ ever 결코 ...않다, Well, I ~! 설마
neverending : a, 끝없는, 영원한
neverfailing : a, 무진장의, 끊기지 않는, 변하지 않는
nevermind : n, (부정문으로)주의, 배려, 용무, 책임
nevermore : ad, 두번다시~~하지않다(never again
nevernever : n, a, 분할지불, 월부로, 실재하지 않는, 환상의, 이상의
neverneverland : x, J.M Barrie작 Peter Pan에서)동화(꿈)의 나라
neversaydie : a, 지지 않는 기질의, 불굴의
nevertheless : ad, 그럼에도불구하고, 그렇지 마는, 역시
neverwas : n, 지금까지 이름을 날려본적이 없는 사람, 무명으로 끝난 사람
Neville : n, 남자이름
Nevis : n, 서인도제도 동부Leeward제도의 섬
nevoid : a, 모반의, 점의
nevus : n, 모반, 점, 사마귀, 반점
new : a, 새로운, 새로운 발견(발명)의, 처음 보는(듣는)신품의, 낡지 않은, 새로 입수한, 새로워진, 이번의, 신임의, 현(근)대적인, 새것만 좋아하는, 근세(근대)의, (음식물)신선한, 갓 만든, 새로 시작되는, 다음의, 아직 익숙하지 않은, 경험없는 풋내기의
new : ad, n, 새로이, 다시, 최근에, 근래에, 새로운것(일)
NEW : x, net economic welfare
New Amsterdam : x, 뉴암스테르담(네덜란드령 당시의 New York City의 이름)
new archaeology : x, 신고고학(최신 통계, 과학기술의 방법으로 연구하는 고고학)
Newark : n, 뉴어크(미국 New Jersay주의 도시)
newbeat : x, (미)기자의 취재 담당구역
Newbery Award : x, 뉴베리 상(미국의 아동문학상)
new blood : x, (새로운 활력(사상)의 원천으로서의)젊은이들, 신인들
newblown : a, 갓(방금)핀
newboard : n, 게시판
newborn : a, n, 갓(방금)태어난, 신생의, 다시 태어난, 마음을 고쳐먹은, 부활한, 신생아
New Britain : n, 뉴브리톤(남태평양 Bismarck제도 중의 최대의 섬, 주요 도시Rabaul)
newbuilt : a, 신축한
Newburg(h) : a, 뉴버그풍의(버터 포도주 생크림등을 사용한 요리)
New Caledonia : x, 오스트레일리아 동쪽의 섬
Newcastle disease : x, 뉴캐슬병(설사, 호흡 곤란을 주로 하는 바이러스성 가금병)
Newcastli : n, 뉴캐슬(England북부의 항구, 석탄 수출로 유명)
New Christian : x, MARRANO
newcoined : a, 새로만든
newcome : a, 새로온, 신참의
newcomer : n, 새로온 사람, 신출내기, 풋내기
New Critic : x, 신비평가
New Criticism : x, 신비평
New Deal : x, 뉴딜정책(Roosevelt 미국 대통령이 1933년에 제창한 경제 부흥과 사회 보장의 증진 정책)
New Delhi : x, 뉴델리(인도 공화국의 수도
New Economic Policy : x, 신경제정책, 네프
new economics : x, 신경제학, 신케인스 경제학(케인스 이론의 논리적 연장인)
newel : n, (나선형 층층대의)중심 기둥, 엄지기둥(계단의 상하 양끝의)
New England : x, 이지방이 영국해안과 비슷하다해서 Captain John Smith각 명명)뉴잉글랜드미국북동부의 여섯주Connecticut, Massachusetts, Rhode Island, Vermont, New Hampshire, Maine)
New Englander : x, 뉴잉글랜드 사람
new English : x, 신영어(1500년경 이후의 영어
New English Bible : x, 신 영역성서(신약 1961년, 신구약합본 1970년에 간행
Newf. : x, Newfoundland
new face : x, (연예계 등에서의)신인
new fallen : a, 갓 내린, 방금 떨어진
new fangled : a, 신식의, 최신 유행의, 신기한 것을 좋아하는, new fangly()ad, new fanglness()n, 
newfashioned : 신식의, 새로운 유행
New Federalism : x, 신연방주의
new found : a, 새로 발견된
Newfoundland : n, 뉴펀들랜드, (캐나다 동해안의 섬, 영국령, 뉴들렌드 종개(온순하고 헤엄을 잘쳐 인명 구종에 사용)
New Frontier : x, 뉴 프론티어(미국 대통령 존 에프 케너디의 적극적인 정책)Frontier
Newgate : n, 뉴게이트 (City of London의 서문에 1902년 까지있었던 유명한 교고서
Newgate frill : (fring)턱밑에 기른 수염
Newgate knocker : (영)(생선, 야채 해상인 들이 기르는)귀 옆의 곱슬 머리카락
New Guinea : x, 오스트레일리아 북부의 섬
New Hampshire : x, 미국북동부의 주, 뉴햄프셔
Newhigte : n, 뉴헤어본, 미국(connecticul주의 도시
newish : a, 약간 새로운
new issue : c, 신규발행 채권
New Jersey : x, (누저지)이땅을 받은 영국제독의 출신지, Jersey섬의 이름을 따서), 미국 동부의 주
New Jerusalem : x, 새로운, 예루살렘, 서온, 요한 계시록, 지상낙원, 천국
New Journalism : x, 신 저널리즘(객관성)간결성 위주의 종래 저널리즘에 대하여 기자의 주관적 참가 심리적 추측등이 특징)
New Journalist : x, 신저널리즘 기자(리포트)
newlaid : a, 갓깐, 갓낳은(달걀), 방금 쌓은, 미숙한, 숫된
New Latin : x, 근대라틴어
New Learning : x, 신학문, 학예 부흥(문예부흥의 자극을 받고 일어난 고대 그리스 문예의 연구)
New Left : x, 신좌익, 뉴레프트(1960)년 이후 인종 통합, 군비 축소, 반전등 급진적 사회 개혁을 부르짖는 자유주의 지식층
new look : x, 새로운 유행스타일, 신정책(소련의 SPUTNIK이후 eISENHOWER행정부가 내세운)
new low : X, 새로운 최저 가격, 최저기록(cf.NEW HIGH)
newly : ad, 요즈음, 최근에, 새로이, 다시
newly industrializing countries : x, 신흥공업국(1970년대에 공업화된 나라들, 한국대만, 홍콩, 싱가포르등)
newlywed : n, a, 신혼자, 신혼부부, 신혼의
newmade : a, 갓만든, 다시만든
new man : x, 신인, 신임자, 심기일전한사람, 개종자
Newman : x, 뉴먼(1801-90)영국의 추기경, 신학자, 저술가)
Newmarket : n, 뉴마켓(잉글랜드 남동부의 도시, 경마로 유명), (몸에 꼭맞는)외출용의 긴외투
newmarried : a, 갓 결혼한, 신혼의
new math : x, (특히 미국 초중교에서 배우는, 집합론에 기초한)새수학
new media : x, 새로운 정보 전달수단, 뉴미디어(TV의 음성 다중 방송 문자 다중 방송 비디오디스크CATV전화와 컴퓨터를 조합한 VIDEOTEX등 새로 등장한  정보매체)
New Mexican : x, 뉴멕시코주의(사람)
New Mexico : x, 뉴멕시코, 미국 남서부의 주
newmodel : n, 새로 형성하다, 다시 편성하다
newmoneay : x, 뉴머니, 신규차입 자금(국제 은행등에 의해 채무 연장에 더하여 신규로 융자되는 자금)
New Moon : x, 초승달(히브리인)신월제
newmown : a, (목초등)갓 베어낸
newness : n, 새로움, 신기함, 미숙함
new order : x, 새질저, 신체제, 나치의 독일 민족을 주체로 하는 유럽재편성 계획
New Orleans : n, 뉴올리언스(미국Mississippi 강변의 항구도시)
new penny : x, (영국의)신페니(1971년 실시)
New politics : x, 새로운 정치(학)(정당 정치보다 투표자의 직접 참가를 중시하는 정치)
new poor : x, 최근에 영락한 사람들, 사양족
new product : x, 신제품(새로운것으로 인정된 제품 또는 서비스)
New realism : x, 신사실주의
newrich : n, a, (교양, 교육이 없는)벼락 부자, 벼락부자의, 벼락부자특유의
New right : x, 신우익(New left에 대응하는 신보수주의)
New Romantic : x, 의상과 음악의 융합을 시도한 록 음악, 중세 취향에 현대의 에센스를 가미한 패션 경향(해저록도이의 일종)
news : n, vi, vt, 뉴스, (새로운 사건의)보도, 정보, 진문, 기사, 소식, 기별, 근황, 색다른(재미있는)일, 흥미있는 사건(인물), 신문이름, 뉴스로서 알리다, 뉴스를 말하다
news agency : x, 통신사, 신문잡지판매소(업)
newsagent : n, NEWS DEALER
news analyst : x, 시사해설가
newsboy : n, 신문파는 아이, 신분배달원
newsbreak : n, 보도가치가 있는(일(사건))
newsbulletin : x, 뉴스방송
newscast : n, vi, (라디오, 텔레비전의)뉴스방송, 뉴스를 방송하다
newscaster : n, 라디오, 텔레비젼뉴스방송(해설)자
newscasting : n, 뉴스방송
news conference : x, (특히 정부 고관 등의) 기자회견
New Scotland Yard : x, 런던 경시청
news dealer : x, (미)신문(잡지)판매인(영)newsagent)
news editor : x, (일간 신문의)신문편집자
news flash : x, 뉴스속보
newshawk : n, NEWS HOUND
newshen : x, 여기자
news hole : x, (신문, 잡지에서 광고 스페이스에 대하여)기사 스페이스
newshound : n, (신문등의)기자, 보도원
newsless : a, 뉴스가 없는 , newsness
newsletter : n, (회사, 단체관청등의)회보, 월보, 연보, 시사회보(현대 신문의 전신, 주간)
newsmagazine : n, 시사 잡지(주로 주간지)
newsmaker : n, 뉴스가치가 있는 사건
newsman : n, 취재기자(news dealer)
newsmonger : n, 소문을 퍼뜨리는 사람, 수다쟁이
newsmongering : n, 
New South Wales : n, 뉴사우스 웨일스주(오스트레일리다 남동부의 주, 수도 Sydney)
newspaper : n, vi, 신문(지), 신문사, 신문인쇄용지, 신문지, 신문업무에 종사하다
newspaper : n, NEWSBOY
newspaperdom : n, 신문계(journalism)
newspapering : n, 신문업무(경영보도편집)
newspaperman : n, 신문기자
newspaper route : x, 신문배달(구역)
newspaper vendor : x, 신문판매기(NEWS DEALER)
newspaperwoman : n, (미)여기자
newspeak : n, (정부관리등이 여론 조작을 위하여)고의적으로 애매하게 말하여 사람을 기만하는 표현법
newsperson : n, 뉴스 보도자, 기자 특파원 뉴스 캐스터
newsprint : n, 신문(인쇄)용지
newsreader : n, =Newcaster
newsreel : n, (단편)뉴스영화
news release : x, PRESS RELEASE
newsroom : n, (미)편집실, (신문사, 라디오, 텔레지변의)뉴스 편집실, (영)신문잡지 열람실, 신문잡지 판매장
news satellite : x, 통신위성
news service : x, 통신사(news agency)
newssheet : n, (옛날의 접지 않는)한장짜리 신문NEWSLETTER
news source : x, 뉴스소스(뉴스의 출처)
news stall : x, NEWSSTAND
newsstand : n, (미)거리, 역, 구내등의)신문, 잡지 매점
news story : x, 사설, 해설기사와 구분한 보도기사
news theater : x, 뉴스영화관
New Stone Age : x, 신석기 시대(Neolithic Age)
New Style : x, 양력 그레고리력
news value : x, 보도 가치
news vendor : n, news dealer
newsweekly : n, 시사주간지
newsworthy : a, 보도 가치가 있는, 기사거리가 되는, newsworthiness()n, 
newswriter : n, 신문기자
newsy : a, n, 뉴스가많은, 화제가 풍부한, 말이 많은=Newsboy, newscaster, newsiness()n, 
newt : n, 영원, 바보얼간이
New Test. : x, New Testament
New Testament : x, 신약성서
New Thought : x, 신사상(인간의 신성을 강조하여 올바른 사상이 병과 과실을 억제할수 있다고 여기는 일종의 종교철학)
Newton : n, 뉴턴, 영국의 물리학자, 수학자, 만유인력, 미적분의 발견자
Newtonian : a, n, Newton의 학설 신봉하는 사람, 뉴턴이 고안한 망원경
new town : x, 교외 주택지
new wave : x, (유행, 예술, 정치등의)새물결 운동, 새풍조, 새경향
new woman : x, 신여성(특히 19세기 말경 인습과 싸우며 자유와 독립을 요구한 여성)
New World : x, 신세계(서반구, 특히 남북아메리카 대륙)
newworld : x, 신세계의, 아메리카 대륙의(opp.oldworld)
new year : x, 정월 초하루, 설날
New Year's Day : x, 정월초하루, 설날(미, 캐나다)에서는 종종Day를 생략)
New Year's Eve : x, 섣달그믐날
New York : x, 뉴욕주
New York City : x, 뉴욕시 New York주에 있는 미국 최대의 도시
New Yorker : x, 뉴욕주 사람, 뉴욕시민
New Yorkese : x, 뉴욕사투리
New York School : x, 뉴욕파(1940-50)년대에 New York에 나타난 추상 표현주의 화파)
New York State Barge Canal : x, 뉴욕쥬 운하망
New York Stock Exchange : x, 뉴욕증권 거래서(세계 최대의)
New Zealand : x, 뉴질랜드(남태평양의 영연방내의 독립국, 수도 Wellington)
New Zealander : n, 뉴질랜드 사람, next()ad, prep, 
next best : x, SECOND BEST
Nextel : x, 넥스텔(연극, 영화에서 혈액 대용으로 쓰는 합성 물질, 상표명)
next friend : x, 소송 대리인(소송에서 법적 무능력자의 대리인
nexus : n, 연계, 관계, (물건, 관념등의)연쇄, 연합, 넥서스, 서술적 관계(표현)
Nez perce : x, 네즈퍼스족, 네즈퍼스어
NFC, N.F.C. : x, National Football Confernce
NFD, .Nfd. : x, Newfoundland
Ng. : x, Norwegian
Ngalaxy : x, N형 은하(별과 같은 중심핵을 가지며, 그 좁은 영역에서 활발히 에너지 방출을 함)
NGF : x, nerve growth factor
NGK : x, New Greek
NGO : x, nongovernmental, organization 비정부 조직
NH, N.H : x, New Hampshire
NHA : x, National Housing agency(미) 주택 건설청
NHC : x, National Health Center국립 보건원
NHG, N.H.G. : x, New high German
Ni : x, nickel
ni.pr. : x, nisi prius
NIA : x, 국민 보험법
niacin : n, 니코틴산
Niagara : n, 나이아가라강(미구과 캐나다 국경의)홍수, 쇄도, 나이아가라(미국 동부산 백 포고릎 한 품종)
Niagara Falls : n, 니아가라 폭포, 니아가라 폴시(미국, 캐나다쪽의 두 도시명)
nialamide : n, 니알라미드(우울증 치료제)
Niamey : n, 니아메(Niger의 수도)
nib : (둘로 갈라진)펜쪽끝, 펜촉, 깃펜끝, (새의 부리), (일반적으로)첨단, 첨두, 거칠게 빻은 코코아콩, (깃펜)끝을 뾰족하게 하다, 펜촉 끝을 손질(교환하다), n, vt, pl, 
nibble : vt, (짐승 물고기가)조금씩 갉아 먹다(갉아 먹음), 조금씩 뜯어먹다, (물고기가)입질하다, 서서히 잠식하다, 트집을 잡다, 흠뜯다, 조심스럽게 손을 내밀다, 의향이 있는 체하다, 흥미를 보이다, 조금씩 물음, (물고기의)입질, (짐승이 뜯는)풀의 한입 분량, 마음에 있는듯한 기색, 선대답, nibbler()n, 
Nibelungenlied : n, 니벨룽겐의 노래(13세기 전반에 남독일에서 이루어진 대서사시)
niblick : n, (골프)니블릭, 9번 아이언(number nine iron
Nibmar, NIBMAR : x, 로디지아 등지에서 독립전에 흑인에게 비례 대표제를 시행한다는 영국의 정책
nibs : n, 높은 양반, 나으리
Nicaea : n, 니케아(소아시아 북서부Bithynia의 옛 도시)
NICAP : x, National Investigators Committee on Aerial Phenomena 전미 대기 현상 조사위원회
Nicar. : x, nicaragu
Nicaragua : n, 니카라과(중앙아메리카의 공화국 수도 Managua)
Nicaraguan : a, n, 니카라과(사람)의, 니카라과 사람
niccolite : n, 붉은 니켈광
Nice : n, 니스(프랑스 남동부의 피한지)
nice : a, 좋은, 괜찮은, 예쁜, 훌륭한, 잘하는, 재미있는, 기분좋은, 마음에 드는, 친절한, 교양이 있는(refinde), 미묘한, 어려운, 수완을 요하는, 정밀한, 민감한, 식별력을 요하는, 성미가 까다로운, 가리는 것이 많은, 근엄한, 꼼꼼한, 난처한, 싫은, 
nicelooking : a, 예쁜, 애교가 있는
nicely : ad, 훌륭하게, 기분좋게, 정밀하게, 꼼꼼하게, 제대로, 잘
Nicene : a, (소아시아의 옛 도시)니케아(Nicaea)의
Nicene Creed : x, (325년 니케아 화의에서 결정된)니케아 신조
nice Nelly(Nellie) : x, (미케나다)점잔빼는 사내(여자), 완곡한 말(표현)
nice Nelly(Nellie) : a, (미, 캐나다)점잔빼는, 넌지시 말하는
nice Nellyism : n, 점잔빼기, 완곡어, 완곡적 표현
niceness : n, 기분좋음, 친절함, 정밀(면밀)함, 미묘함, 성미가 까다로움, 꼼꼼함
nicety : n, 정확, 정밀, 기미, 미묘, 섬세, 상세, 결벽, 우아한 것, 맛있는것(음식)
niche : n, vt, 벽감(조상등을 두기 위한 벽의 움푹 들어간곳), 적소, (조상등을)벽감에 안치하다
Nicholas : n, 남자이름, 어린이, 학자, 선원등의 수호신
Nichrome : n, 니크롬(니켈, 크롬, 철의 합금, 상표명)
Nick : 새김눈(notch), (접시등의)홈, 깨진곳, (주사위놀이에서)던지는 사람이 부르는 수와 같은 점수 또는 관계 있는 주사위 눈이 나옴, 교도소, 건강상태, 컨디션, 눈금을 새기다, 상처를 내다, 흠을 내다, 새김눈으로 기록하다, (말꼬리의)밑동을 절개하다(꼬리를 높이 들게 하기위하여), (진실등을)이김수를 굴리어 내다, 훔치다, 붙잡다, ..에게 부당한 돈을 요구하다, (사냥경주에서)지름길로질러가서 이기다, (가축이)교미하다, , 남자이름, 악마
nickel : n, 니켈, 5센트 백통화
nickel : vt, 니켈 도금하다
nickel's worth : x, 5분간의 교신 제한시간
nickelanddime : vt, a, 알뜰하게 굴다, 아끼다, (알뜰하게 굴어서)얻다, (달성하다), 사람을 인색하게 대우하다, 소액의, 아끼는, 인색한, 하찮은
nickel nurser : x, (미속)구두쇠
nickelodeon : n, 5센트짜리 영화 극장, jukebox
nickelous : a, 니켈의, (특히)2가의 니켈을 함유하는
nickel plate : x, 니켈 도금
nickelplate : x, 니켈 도금하다
nickel silver : x, 양은
nickel steel : x, 니켈강
nicker : n, vi, 눈금을 새기는 사람, 말의 울음, 낄낄웃음, (말이)울다, 낄낄웃다, 니커(1파운드 영국화폐)
nicknack : n, Knickknack
nickname : n, vt, 별명, 닉네임, 별명을 붙이다, 애칭(약칭)으로 부르다
Nicolas : n, 남자이름
Nicol prism : x, (발명자인 물리학자의 이름에서)니콜프리즘(편광실험용, 방해석으로 만듬)
Nicosia : n, 니코시아(키프로스의 수도)
nicotian : a, n, 담배의, 담배에서 뽑아낸, 흡연가(smoker)
nicotinamide : n, 니코틴아미드
nicotine : x, 니코틴
nicotinicacid : n, 니코틴산
nicotinism : n, (만성)니코틴 중독
nicotinize : vt, 니코틴으로 중독시키다
NICS : x, newly industrializing countries신흥공업국
nictate : vi, 눈을 깜박거리다
nictitate : vi, 
nictitating membrane : x, 순막, (새 악어등의 눈꺼풀 안쪽에 있는 제 3의 눈꺼풀)
nicy : n, 과자, 사탕
nidate : vi, (수정란이)자궁에 착상하다, nidation()n, 
niddering, nider- : a, n, 비열한, 비겁자
niddlenoddle : a, (머리를)끄덕거리는, 불안정한
niddlenoddle : vt, vi, 머리를 근들거리(게 하)다
nidificate : vi, (새가)집을 짓다
nidification : n, 
nidify : vi, NIDIFICATE
nidnod : vi, 꾸벅꾸벅졸다
nidus : n, (곤충등이)알을 까는 자리, 산란장소, (병균 기생충등이)발생하는 곳, 병소, (성질, 주의등의)근원(source)
niece : n, 조카딸, 질녀
nielist : n, 흑금상감사
niello : n, 흑금, 흑금상감(세공품)
Nielsen(rating) : x, (텔레비젼의)닐슨 시청률(A.C.Nielsen Co.는 미국의 시장 조사회사)
NIEO : x, new internation economic order신국제 경제질서
Niersteiner : n, (라인 강변의 산지명)백포도주
NIES : x, Newly Industrializing Economies신흥 공업 경제 지역(cf.NICS)
Nietzsche : n, 독일의 철학자
Nietzschean : a, n, 니체철학의, 니체 철학자
Nietzscheism : n, 니체 철학
niff : n, vi, (악취가)나다, 반감 노여움, niffy()a, 
nif gene : x, (생화)질소 고정에 관여하는 유전자
nifty : a, n, 멋진, 재치있는, 재치있는 말, 매력적인 계집애
nig : vi, (카드)RENEGE
Nigel : n, 남자이름
Niger : n, 니제르(북아프리카 서부의 공화국)
Nigeria : n, 나이지리아(서아프리카의 공화국)
Nigerian : a, n, 나이지리아의(사람)
niggard : n, a, 구두쇠(miser), 인색한
niggardliness : n, 인색
niggardly : a, ad, 인색한, 아까워하는, (액수 분량이)아주 적은, 인색(째째)하게
nigger : n, 깜둥이(negro), 흑색토인(동인도, 오스트레일리아등의)흑갈색의 물감, 제재소의, 동력지레(몰재를 끌어올리는)
nigger brown : x, 암갈색
niggerdom : n, 흑인임, 흑인사회
niggerhead : n, NEGROHEAD
nigger heaven : n, (극장의)맨 위층좌석, (경멸)흑인 거주지역, 뉴욕시의 할렘
niggerish : a, 흑인의(같은)
niggertoe : n, BRAZILNUT
niggle : vi, n, 하찮은 일에 마음을 쓰다, 옹졸하게 굴다, 까다롭게 흠잡다, 탈잡다, 하찮은 불평(불만), 결점, niggler()n, 
niggling : a, n, 하찮은 일에 마음을 쓰는, 옹졸한, 손질이 너무 꼼꼼스런, (필적)등시원스럽지 않은, 읽기 힘든, 지나치게 꼼꼼한(시간이 걸리는)일
nigh : v, Near
night : a, n, 밤, 저녁(해질녁부터 동이 틀때 까지)야음, 어둠, (비유적)죽음의 암흑, 죽음, 맹목(blindness), 무지몽매(한 상태), 실의(불안한)시기, 노령, 죽음, 밤공연, 밤의, 야간의, (동물등)야행성의
night bell : x, (영)(특히 의사집 등의)야간용벨
night bird : x, 밤새(올빼미, 나이팅게일 등), 밤에 돌아다니는 사람, 밤도둑
nightblind : a, 밤눈이 어두운, 야맹증의
night blindness : x, 야맹증
nightblooming cereus : x, (식)밤에 꽃피는 선인장
nightcap : n, 나이트캡(잘때 쓰는 모자), (구)잘때 마시는 술, 그날의 마지막 시합, (야구)더블헤더(하루에 2개 시합)때의 뒷시합
night cart : x, 분뇨 운반차
nightcellar : n, (영)(하급의)지하선술집
night chair : x, NIGHTSTOOL
nightclothes : n, pl, 잠옷
night club : x, vi, 나이트클럽, 나이트클럽에서 놀다
nightclubber : n, 나이트클럽의 단골손님
night commode : x, NIGHTSTOOL
night court : x, (미)(즉결 사건을 취급하는)야간 재판소
night crawler : x, 밤에 기어나오는 큰 지렁이, 밤에 돌아다니는 사람
night crow : x, 밤에 우는 새, (특히)해오라기
nightdress : n, NIGHTGOWN
nighted : a, 캄캄해진, 길이 저문
night editor : x, (신문)조간의 편집 책임자
nightery : n, NIGHTCLUB
nightfall : n, 황혼, 저녁때 해질녁
night fighter : x, 야간 요격 전투기
night flower : x, 밤에 피는 꽃(달맞이 꽃등)
night glass : x, 야간용 망원경, 야간용 쌍안경
nightglow : n, 야광(야간의 대기광)
nightgown : n, (여자, 어린이용)잠오 NIGHTSHIRT
nighthag : n, (밤 하늘을 날아다닌다는)마녀, 몽마
nighthawk : n, vi, 쏙독새(의 일종), 밤에 나쁜짓을 하는 사람, 밤도둑, 밤을 새우는 사람, 야간 택시, 밤에 돌아다니다
night heron : x, 해오라기
nightie : n, 잠옷(nightdress)
nightingale : n, 나이팅게일, 미성의 가수(해설자)
Nightingale : n, 나이팅게일, 1820-1910영국의 간호사, 근대 간호학 확립의 공로자)
nightjar : n, 쏙독새
night latch : x, 야간 자물쇠(latchkey)(안에서는 손잡이로 바깥에서는 열쇠로 조작)
night letter : x, 야간발송전보(이튿날 아침에 배달되며 요금이 쌈, 100단어 이내)
night life : x, 밤의 유흥, 밤놀이
night lifer : x, 밤유흥을 하는 사람
nightlight : n, (병실, 복도, 화장실용)철야등, (선박의)야간등
night line : x, 밤낚시줄(미끼를 달아 밤에 물속에 넣어둠)
nightlong : a, ad, 밤새는, 철야의, 밤새도록
nightly : a, ad, 밤마다의, 밤의, 밤에 나오는, 밤마다, 밤에
night man : x, 야간 직업을 가진 사람, (특히)야경꾼
nightman : n, 분뇨수거인, NIGHT MAN
nightmare : n, 악몽, 가위눌림, 몽마(수면중의 사람을 질식시킨다고 상상되는 마녀), 무서운일, 불쾌한 사람(물건), 공포(불쾌)감, 불쾌한 예감
nightmarish : a, 악몽(악마)같은
nightnight : int, (밤의 작별인사로서)안녕, 안녕히 주무세요
night nurse : x, 야간 근무간호사
night owl : x, 밤늦도록 자지 않는 버릇이 있는 사람, 밤일하는 사람, 쏙독새류(nightawk)
night people : x, 야간형 생활자, 사회 통념에 따르지 않는 사람들
night person : x, 야간형 생활자
night piece : x, 야경화, 야경을 다룬 작품(회화, 악곡)
night porter : x, (호텔프론트의)야근보이
night raven : x, 야행성 새, (특히)해오라기, 밤에 우는 새, 불길한 징조
night rider : x, 야간의 복면 기마 폭력단원
night robe : n, 잠옷
night router : x, (다음날 아침 편지를 배달하기 위해)야간에 수집, 구분하는 우체국 직원
nights : ad, 밤에, 밤마다(cf.AFTERNOONS)
night safe : x, (은행등의)야간(시간외)예금 창구, 야간금고
nightscape : n, 야경, 야경화(night piece)
night school : x, 야간학교
night season : x, NIGHTTIME
nightshade : n, 가지속의 식물
night shift : x, (주야 교대제의) 야간근무, 야근시간, 야근 노무자(조)
nightshirt : n, (남자용)잠옷(긴 셔츠 모양의)
nightside : n, (신문사의)조간요원, (지구달 행성등의)빛이 닿지 않는 쪽, 밤쪽
nightsight : n, (총의)야간 조준기
night soil : x, (보통 밤에 쳐낸다고 해서)분뇨(cf.NIGHRMAN)
night spot : n, 나이트 클럽(nightclub)
night stand : n, 침대용 스탠드
night stick : n, 야경봉
night stool : x, 침실용 변기, 요강
night suit : x, 파자마(pyjamas)
night sweat : x, 도한
night table : x, (침대 옆에 놓는)침실용 소탁자
night terror : x, (어린애의)야경증
nighttide : n, 밤(nighttime), 밤의 밀물
nighttime : n, 야간, 밤
nightviewer : n, 암시 장치(어둠속에서 사물을 식별할수 있는)
nightvision : a, 암시의
night vision goggles : x, 암시장치, 야간명시장치(nightviewer)
nightwalker : n, 몽유병자, 밤에 돌아다니는 사람(매춘부, 도둑등)큰지렁이 (밤에 기어다니는)
nightwalking : n, 몽중 보행, 몽유병
night watch : x, 야경(시간)야경꾼, 야경교대시간(밤을 3분 또는 4분한), 잠못이루는 시간
night watchman : x, 야경꾼
nightwear : n, 잠옷(nightclothes)
night work : x, 밤일, 야간작업
nightynight : int, good night
nigrescence : n, 검음, 검게 물들음, (안색, 피부, 눈 등이)거무스름함
nigrescent : a, 거무스름한
nigrify : vt, 검게 하다, nigrification()n, 
nigritude : n, 검음, 암흑, 검은것, 악명
NIH : x, National Institutesof Health(미)국립보건원
nihil : n, 무, 허무, 공허, 무가치한 것
nihil ad rem : a, 아주 부적절한.잘못 짚은, 예상에 어긋난
nihilism : n, 허무주의, 니할리즘, 무정부주의, 19세기 러시아의 허무주의
nihilist : n, 허무주의자, 니힐리스트
nihilistic[n'ai~h5l'istk허무 무정부부의의, 
nihility : n, 허무 무가치
nik : 무엇인가에 몰두 하거나 관심을 가지는 사람, 
Nike : n, 승리의 여신, 나이키(지대공유도탄의 일종)
nil : n, 무(nothing), 영
nil admirari : n, 그 무엇에도 마음이 움직이지 않음, 무감동
Nile : n, 나일강(아프리카 동부의 강)
Nile blue : x, 초록빛을 띤 엷은 파랑
Nile green : x, 청색을 띤 담록색
nilgai : n, 닐가이(인도산의 말 비슷한 영양의 일종)
nill : vi, 좋아하지 않다
nil norm : x, 정부가 정하는 임금 및 물가 상승의 최저 기준
Nilometer : n, (특히 홍수때의)나일강의 수위계
Nilotic : a, 나일강(유역)의, 나일강 유역 주민의
nim : vt, 훔치다
nimbi : n, NIMBUS의 복수
nimble : a, 민첩한, 재빠른, 재치있는, 영리한, 빈틈없는, 융통성있는, 재주있는, 잘 생각해 낸, 잘된, 현명한, nimbleness()n, nimbly()ad, 
nimblewitted : a, 재치있는, 영리한
nimbostratus : n, 난층운
nimbus : n, (종교화등의)후광, (사람, 물건을 둘러싼) 분위기, 매력, 난운, 비구름
nimiety : n, 과도, 과잉, 잉여
niminypiminy : a, 점잔빼는, 얌전빼는, 새침한, 유약한
nimious : a, 과잉의, 과다한
nimonic : a, 내열, 내압의니켈 크롬 합금의
Nimrod : n, 대수렵기(창세기 10:8-9)수렵애호가, 수렵광
Nina : n, 여자이름
nincomerery : a, pron, 9, 9자, 9개 한벌, 9인조, 야구팀, 9번째의 사람(물건, (골프)9개의 구멍, (문예미술을 맡은 )뮤즈의 아홉여식
nincompoop : n, 바보 멍청이(simpleton)
nine : n, a, 아홉(의), 9명(개)이 1조, 야구팀, a ~ days' wonder 한때의 소문, ~ times(in ~ cases)n, a, out of ten 십중팔구
nineball : 나인볼:n, 
nine day' wonder : (사건)
nineeightfour : n, 1984, 완전히 자유를 잃은 미래의 전체주의 사회의 상징으로서의 1984년
ninefold : a, ad, 아홉배의(로), 9겹의(으로)
nineninenine : n, (구분)구급전화 변호(겨경찰, 구급지.소방소를 부를 번호
ninepence : (영)9펜스(의 값) 16세기 아일랜드의 1실링경화(잉글랜드에서는 9펜스에 상당)
ninepin : n, 나인핀즈, 구주회, (9개의 핀을 사용하는 볼링)(cf.skittles, tenpins)나인핀즈용 핀
ninepins : n, 9주회
nineteen : n, a, 19(의), 19개 사람의, 19세기의, 19달러(파운드, 센트, 펜스(등)
nineteenth : n, a, 제 19의, 19분의 1의, 달의 19일
nineteenth hole : x, 19번 홀(18홀 후에 골퍼가 쉬는 시간), 골프장내의 바(클럽 하우스등)
ninetenths : n, pl, 10분의 9, 비유적 거의 전부
ninetieth : n, a, 제 90의 90분으 1
ninetofive, 9-to 5 : a, n, vi, 봉급생활자의 회사원의, 일상적인일, (지루하고)규칙적인 작업(근무)을 하다
ninetofiver : n, 사무원 월급쟁이, 신뢰할수 있는(책임감이 강한)사람, 규칙적인일
ninety : a, 90의, 90개(사람, 세)의, 90개 사람, 90, 90의 기호, 90세, 90달러(파운드, 센트, 펜스(등), (세기의)90년대, (특히 문학에서 19세기말 10년을  말함, 대문자로 시작), (연령등의)90대, (온도계 등의), 90도대, (성적의)90점대
ninetyday wonder : x, 3개월 훈련받고 임관한 간부 후보생 출신장교
ninety weight : x, 독한 알코올 음료, 독한술(hard liquor)
Nineveh : n, 니네베(Assyria의 수도)
Ninevite : n, 니네베 사람
ninny(hammer) : n, 바보, 멍청이
ninon : n, 얇은 비단
ninth : a, n, 제 9의, 9분의 1의, 아홉번째로(에), 제 9, (달의)9일, 9번의 1, 9도, 9도 음정
ninth cranial nerve : x, 설인 신경
ninthly : ad, 아홉번째로
Niobe : n, 니오베(자랑스럽던 14명의 아이들이 피살되고 Zeus 신에 의하여 돌로 변한 여자)자식을 잃고 비탄속에 지내는 여자, (식)나리의 일종
niobium : n, 니오브(금속원소의 하나)
NIOSH : x, National Institute for Occupational Safety and Health(미)국립 직업 안전건강 연구소(Department of Health and Human Services(후생성)에 속하는 연구기관)
nip : v, 집다, 물다, 꼬집다, 따다, 잘라내다, (바람, 서리등이)시들게 하다, 얼게하다, 상하게하다, (진행, 달성등을)좌절시키다, 기세를 꺾다, 잡아채다, 훔치다, (상대를)근소한 차로 이기다
nip : vi, (바람, 추위 등이)살을에다, 달리다, 서두르다
nip : n, 꼬집음(pinch), 꽉깨물음, 한조각, 근소, 살을에는 듯한 추위, 상해, 흑평, 풍자, (치즈의)강한 맛, (선측에 미치는)결빙의 강압, 밧줄의 꽉죄인 부분, NIPPY
nip : n, vi, vt, (위스키등의)소량, 한모금, 잘금잘금 마시다
Nip : n, a, 일본인
nipa : n, 니파야자(동인도 등지의 물가에 남), 니파술
nipper : n, pl, 꼬집는(따는)사람, 집는(무는)물건, 못뽑이, 집게, 니퍼, (치과의사용의)이빨 빼는 집게(forceps), 수갑, (말의)니, (게등의)집게, 코안경(pincenez), (영 구)소년, 부랑아, (행상을 거드는)꼬마둥이
nipping : a, 살을 에는 듯한, 통렬한
nipple : n, 젖꼭지, (젖병의)고무 젖꼭지, 젖꼭지 모양으로 생긴것, (기)그리스 주입구, 파이프 이음쇠
nipplewort : n, (식)박조가리 나물(국화과)
nippy : a, 호된, 살을에는 듯한, 민첩한, 니피, 싸구려 식당의 여급, nippily()ad, nippiness()n, 
nipup : n, (누운자세에서)똑바로 뛰어 일어남, 묘기 , 곡예
nirvana : n, 열반, 해탈
nisi : a, (영법)일정기간 당사자가 이의를 신청하지 않으면 절대적 효력을 발생하는, 가-
NISI : x, National Institute of Scientific Investigation국립 과학 수사 연구소
nisi prius : n, (미)배심원이 딸린 제 1심 재판, (영)순회판사의 배심 재판
Nissenhut : x, 영국의 광산기사의 이름에서)퀀셋 병사, 조립식 주택(Quonsethut)
nisus : n, (목적을 달성키 위한)노력, 분발
nit : n, (이 등 기생충의)알, 서캐, 멍청이
nit : n, (물)니트(휘도의 단위)
nit : n, napierian digit, 니트(정보량의 단위)
nit : int, n, (사람이)왔다, 조심해, 없음, 무
NIT : ㅌ, National Intelligence Test, National Invitational Tournament, negativ incometax
Nita : n, 여자이름
niter : n, 질산칼륨, 칠레초석, 질산소다, nitre
nitery : n, nightclub
nitid : a, 반짝거리는, 밝은 윤나는
nitinol : n, 니티놀(티탄과 니켈의 비자성 합금)
niton : n, 니톤(radon의 옛이름)
nitpick : vi, vt, 하찮은 일에 끙끙 앓다, 별것 아닌트집(흠)을 잡다, 자잘한 일에 까지 간섭하다, (별것 아닌것을)꼬치꼬치캐다, ..의 흠을 잡다, nitpicker
nitpicking : n, a, (미구)사소한 것을 문제시하는(함), 남의 흠을 잡아내는(냄)
nitr(o)- : (연결형)질산 질소의 뜻
nitrate : n, vt, 질산염, 질산칼륨(소다), 질산비료, 질산(염)으로 포화, 처리하다, 질산(염)으로 바꾸다
nitration : n, 질화
nitre : n, NITER
nitric : a, 질소의, 질소를 함유하는, 초석의
nitric acid : x, 질산
nitric oxide[(화)일 산화 질소
nitride : n, 질화물
nitrification : n, 질화
nitrify : vt, vi, 질소와 화합시키다, 질화하다
nitrite : n, 아질산염
nitro : a, n, 니트로의, 니트로키(니트로 화합물)의, 니트로글리세린, (특히 금고 폭파용의)니트로, 니트로메탄(nitromethane)
nitrobacteria : n, pl, 질산 박테리아
nitrobenzene : n, 니트로 벤젠
nitrocellulose : n, 니트로셀룰로오스
nitrochalk : n, 니트로초크(질산 암모늄과 탄산 칼슘의 혼합비료)
nitrocotton : n, 면화약
nitro explosive : x, 니트로폭발물
nitrogen : n, 질소(기체원소, 기호N, 번호7)
nitrogenase : n, 니트로게나아제(효소의 일종으로 분자상 질소를 환원하여 암모니아 화함)
nitrogen chlorid : x, 염화질소
nitrogen cycle : x, 질소 순환
nitrogen dioxide : x, 이산화 질소
nitrogen fixation : x, 공중 질소고정(법)
nitrogen mustard : x, 질소머스터드(독가스, 악성종양의 치료약)
nitrogen narcosis : x, 질소 중독, 잠함병, 케이슨병(잠수시 고압력하에서 일어하는 혈중 질소 과다로 인한 인사 불성), 질소 마취
nitrogenous : a, 질소의 (를 함유한)
nitrogen oxide : x, 산화질소, 질소산 화물
nitroglycerin : n, 니트로글리세린
nitrosamine : n, 니트로사민(발암물질의 하나)
nitrotoluene : n, 니트로 톨루엔(톨루엔을 진한 질산과 황산으로 처리한 화합물)
nitrous : a, 질소의, 초석의
nitrous acid : x, 아질산
nitrous oxide : x, 일산화질소(마취용, 맡으면 명랑해짐)
nitty : a, 서캐 투성이의
nittygritty : n, (문제의)핵심, (사물의)본질, 기본적인 사실
nitwit : n, 바보, 멍텅구리
nival : a, 눈이 많은, 눈속에서 자라는
niveous : a, 눈의, 눈같은
nix : n, (게르만민화의) 물의 요정
nix : n, 없음, 무(nothing), 거부, 금지
nix : ad, 결코..않다(never), 아니(no)
nix : int, (...이) 왔다!
nix : vt, 금지하다, 거부하다, 취소하다
nixie, nixy : n, (수취인 불명의)배달 불능 우편물
Nixon : n, 미국의 37대 대통령
Nixon Doctrine : x, 닉슨 독트린(국방은 자국에 맡기고 미군을 철수하려는 정책)
Nixonomics : n, pl, 닉슨식 경제정책
Nizam : n, 인도 Hyderabad의 군주의 칭호
NKVD : x, Narodnyi Komissariat Vnutrennikh Del(Russ.= People's Commissariat for Internal Affairs)내부인민위원부(소련의 비밀 경찰, MVD의 구칭)
NLETS : n, (National Law Enforcement Tleltype System)전 미국법 집행 텔레타이프(미법무성 관할에 있는 범죄자에 대해 정보 제공 시스템)
NLF : x, National Liberation Front(of South Vietnam)
NLP : x, (미)neighborhood loan program
NLRA : x, National Libor Relations Act(미)전국 노동 관계법
NLT : x, night letter
NM : x, New Mexico
NMC : x, National Medical Center국립 의료원
NMR : x, nuclear magnetic resonance핵자기 공명 진단장치
NNA : x, neutral and nonaligned중립 및 비동맹국
NNASC : x, Neutral Nations Armistice Supervisory Commission(한국 정전위원회)중립국 휴전 감시 위원단
NNE : x, north northeast
NNK : x, non nuclear kill핵을 사용치 않는 살육
NNNN : X, 전보의 끝을 나타내는 기호(국제 전보에서)
NNP : x, net national product
NNW : x, net national welfare 순 국민 복지, 국민복지 지표, northnorthwest
no : , 
No : x, nobelium
No. : x, north, northern
No. : n, 번, 제..호..번지(미국에서는 숫자만 사용)
No.1 : x, NUMBER ONE
NOAA : n, 미국립 해양 대기권국 (상무성의)노아(1에 소속된 기상위성)
noaccount : a, n, (미)쓸모없는 (사람)무능한 (사람)
Noachain : a, 노아시대의, 먼 옛날의
Noah : n, 남자의 이름, 노아(Hebrew 사람의 족장)
Noah's Ark : x, 노아의 방주, 노아의 방주를 본따 동물을 넣은 장난감 배, 구식의 대형 트렁크, MOCCASIN FLOWER, 앵무조개, 배 모양으로 생긴 구름 조각
Noah's boy : x, (식탁위에 내놓은)햄
Noah's nightcap : x, 캐리포니아 포피(양귀비꽃과의 일종)
nob : n, vt, 머리, 머리에 가하는 일격, 흑, (카드)뗀패와 같은 짝의 잭(이패를 가진 자는 한점을 얻음, 머리를 치다
nob : n, 고관, 귀인, 명사
noball : n, vt, (크리켓)반칙 투구(라고 선언하다)(상대에게 1점을 줌)
nobble : n, 
nobby : a, 귀족다운, 멋진, 말쑥한, 화려한, 일류의, nobbily()ad, 
nobeing : n, 실재하지 않음
Nobel : n, 노벨, 스웨덴의 화학자, 다이너마이트의 발명자, 노밸상 창시자
Nobel Foundation : x, 노벨재단
nobelist : n, 노벨상 수상자
nobelium : n, 노벨륨(인공 방사성원소 기호No번호 102)
nobel man : x, NOBELIST
Nobel prize : x, 노벨상(노벨의 유언에 의한 세계의 문예 학술 평화에 공헌한 사람에게 수여되는 상)
nobiliary : a, 귀족의
nobiliary prefix(particle) : x, 성과 이름상이에 붙여서 귀족임을 나타내는 말(프랑스의 de 독일의von등)
nobility : n, 고결함, 숭고, 고귀한 태생(신분), 귀족(사회)상원의원과 그집안, 계급이 있음, 공작, 후작, 백작, 대륙에서는, 자작, 남작
noble : a, n, (집안등이)귀족의, 고귀한, (사상, 성격등이)숭고한, 고결한, 고매한, (외관이)당당한, 웅장대한, 유명한, 훌륭한, 뛰어난, (광물, 금속이)값비싼, 귀중한(precious)(특히)부식하지 않는, 귀족, 노블금화(영국의엣 금화)파업 파괴지도자, 독선가
noble art(science) : x, 권투
noble fir : x, (식)전나무의 일종(미국 서부산)
noble gas : x, 희가스
nobleman : n, 귀족(peer)
noble metal : x, 귀금속
nobleminded : a, (마음이)숭고한, 도량이 넓은, noblemindly()ad, noblemindness
nobleness : n, 고결, 고상, 고귀, 고매, 당당함, 웅장
noble savage : x, 고결한 야인(낭만주의 문학중의 이상적인 인물상)
noblesse : n, (특히 프랑스의)귀족(사회)고귀한 신분
noblesse oblige : x, (F, )높은 신분에 따르는 (도의상의)의무
noblewoman : n, 귀족의 여성
nobly : ad, 고귀하게, 훌륭하게, 당당히, 귀족으로서, 귀족답게
nobody : pron, 아무도 ... 않다
nobody : n, 보잘것 없는 사람, 무명인(cf.SOMEBODY)
nobra : a, 노브라의, 브래지어를 하지않은(without wearing brassieres)
nobrand : a, 노브랜드의, 상표가 붙어있지 않은(상품)
nobuy : a, 불매의(boycotting)
NOC : x, National Olympic Committe각국 올림픽 위원회
nocent : a, 해로운(harmful, hurtful)유죄의
nociceptive : a, 아픔을 주는 (자극), (감각기관등이)아픈 자극에 반응하는, 침해 수용의
nock : n, vt, 활고자, 오늬, 돛의 쪽 위끝, 활고자(오늬)를 만들다, (화살을)시위에 메우다
noclaim(s) bonus : x, 보험료의 할인(자동차의 상해 보험에서 일정 기간 무사고일때 피보험자에게 적용되는)
nocolor : a, 눈에 잘 안띄는 중간색의
noconfidence : n, 불신임
nocount : a, n, NOACCOUNT
nocover action : x, 노동쟁의 중인 조합원 몫의 일을 하지 않음
noct(i) : x, 밤의 뜻
noctambulant : a, 밤에 걷는 몽유의
noctambulation : n, 몽유병(sleepwalking)
noctambulism : n, 몽중보행, 몽유병
noctambulist : n, 몽유병자
noctiluca : n, 야광층
noctilucence : n, 밤의 인광
noctilucent : a, 밤에 빛나는
noctiphobia : n, 어둠공포증
noctivagant : a, 밤에 돌아다니는, 야행성의, noctivagous()a, 
noctovision : n, 암시장치(전자 망원경과 TV를 합한것)
noctuary : n, 야간 사건의 기록
noctuid : n, a, 밤나방과의
noctule : n, 집박쥐, 양박쥐(영국산)
nocturn : n, (카톨릭)저녁기도, NOCTURNE
nocturnal : a, n, 밤의, 야간의, 야간에 활동하는, 야행성의, 밤에피는, 야상곡 같은, 야간 시각 측정기(별의위치로)
nocturnal emission : x, (생리)몽정
nocturnal enuresis : x, (의)야뇨증
nocturnally : ad, 야간에, 매일밤
nocturne : n, 야상곡, 야경화
nocuous : a, 유해한
nocure : a, 불치의
nocut contract : x, (미캐나다)(프로스포츠의)무해고 보증 계약
nod : vi, 끄덕이다, 끄덕여 승낙(명령)하다, 인사하다, (꾸벅꾸벅)졸다, 잠들다, 방심하다, 깜빡 실수하다, 흔들거리다, 나부끼다, 기울다
nod : vt, (머리를) 끄덕이다, (승낙등을)끄덕여 표시하다, 고갯짓을 하여 부르다(보내다), 급히다, 휘다 , 흔들다, 나부끼게하다
nod : n, 끄덕임(동의, 인사, 신호, 명령)목례, 명령, 꾸벅임, 졸기, (마취에 의한)도취상태, 흔들림, 으로 쏠림, 판정승
nodal : a, node의(같은), nodally()ad, 
no date : x, (책의)발행 연도(날짜)없음(불명)
noddle : n, vt, vi, 머리, (머리를)흔들다, 끄덕이다
noddy : n, 바보, 얼간이, 검은제비갈매기(열대지방의 해조)
node : n, 마디(줄기의 가지 , 잎이 생기는 곳), 혹, 매듭, 결절, 교점, 결절점, 파절(정상파에 있어서 진동이 없거나 극히 작은 부분)복자반 조직의 중심점, (이야기 줄거리등의)얽힘
nodefault : a, 채무불이행을 허용치 않는
nodi : n, NODUS의 복수
nodical : a, 교점의
nodose : a, 결절성의, 마디많은(knotty), nodous()a, 
nodosity : n, 마디, 혹, 다절성, 결절성
nodrip : a, (액체 용기의 주둥이 등)으로 (겉으로)흐르지 않게 된
nodular : a, 마디(흑)가 있는, 결절성의, (지질)덩어리가 있는
nodulated : a, 
nodulation : n, 근립착생, NODULE
nodule : n, 작은혹(마디), (지질)유괴, 단괴, (식)결절, nodulose()a, 
nodulous : a, NODULAR
nodus : n, 결절, (이야기 줄거리등의)난국, 뒤얽힌 상황, 분규점, 난점
noel : n, 크리스마스(를 축하하는 함성), 크리스마스의 축가(Christmas carol)
Noel : n, 남자(여자)이름
noesis : n, (철)순수지성(이성)의 인식 작용, 인식(cognition)
noetic : a, n, (철, 심)지력의, 순수지성에 입각한, 지식인, 순수 지성론
nofault : a, 무과실 손해 배상제도의, (법)(이혼법에서)쌍방이 이혼에 책임이 없는 , 파탄주의의
nofirstuse : a, 핵무기를 먼저 쓰지 않는, 핵무기 선제 사용 포기의(정책)
nofrills : a, 여분이 없는, 가외의 서비스를 제공치 않는, 실질 본위의
nofrost : n, (자동 서리 장치가 달린)냉장고, 냉동고
nog : n, vt, 나무못, 나무마개, 나무벽돌, 나무의 마디(흑), 나무틀 사이에 벽돌을 쟁이다
nog : n, 노그(영국의 Norfoik 지방산의 독한맥주), (미)계란술(eggnog)
noggin : n, 작은 맥주잔, 노긴(액량단위)소량(의술)(미)머리, 두뇌
nogging : n, 마개 벽돌(목골사이에 넣는)마개 벽돌 쌓기
nogo : a, 진행준비가 되있지 않은, (영)접근(출입)금지의, 통행제한의
nogood : a, n, (미속)나쁜(것)쓸모없는 (녀석, 물건)
no great shakes : x, 범인, 대수롭지 않은일
nogrowth : n, a, 제로 성장의
nohands : a, 손을 사용하지 않는, 손으로 들지 않아도 되는
nohit : a, (야구)무안타의
nohitter : n, 무안타 경기
NoHo : n, 노호(New York시 Manhattan 북부의 지역, 전위예술, 패션의 중심지)
noholdsbarred : a, 그 어떤 수단도 허용되는, 어떤 수단을 써도 상관없는, 무제한의 철저한, 전면적인
nohoper : n, (오스속)게으름뱅이, 무능한(쓸모없는)사내, 승산(성공할 가망)이 없는 말(사람)
nohow : ad, a, 결코(조금도)..않다(not at all), 기분이 좋지 않은, 탈이 난, 혼란한(confused)
noil : n, (양모등의)짧은 털(방모사용의), noily()a, 
noise : n, (특히 불쾌하고비음악적인)소음, 소리(sound), 소란, 야단, 시끄러움, (라디오 TV의)잡음, 잡담, 헛소리, 엉터리말, 잡음, 평판
noise : vt, 소문을 퍼뜨리다, 소문을 내다
noise : vi, 소리를 내다, 지껄이다
noise factor(figure) : x, (증폭기에서의)잡음지수
noiseless : a, 소음(잡음)이 없는(적은)조용한, noiseness()n, 
noiselessly : ad, 소리나지 않도록, 조용히
noisemaker : n, 소리를 내는 물건(사람), 뿔피리(horn), 딸랑이, 딱다기
noise margin : x, (전자)잡음 여유
noise music : x, 노이즈 뮤직(전자 악기의 잡음을 음악에 도입시켜 강조한 록 음악)
noise pollution : x, (자동차, 제트기, 전기용품등의)소음공해
noiseproof : a, 소음방지의, 방음의
noisette : n, 개암나무 열매가 든, 느와제트(고기 요리의 일종)
noisily : ad, 요란하게, 시끄럽게
noisiness : n, 시끄러움, 요란함
noisome : a, 해로운, 싫은, 악취가나는, 불쾌한, noisomely()ad, noisomeness()n, 
noisy : a, 떠들썩한, 시끄러운, 요란한, (색체, 복장, 문체등이)화려한, 난한
noisy minority : x, 소수 과격분자, 떠들어대는 소수 분자, 몇안되는 반발파(cf.SILENT MAJORITY)
noknock : a, n, 예고 없이 가택수색을 할수 있는, 긴급가택 수색권을 가진, 무단가택수색
noknock entry : x, (범인 용의자 거주 장소에 대한 경찰의 )무단 출입, 예고 없이 행하는 출입
nolens volens : ad, 싫든 좋든
noli me tangere : n, 접촉(간섭)을 금하는경고, 접촉(간섭)해서는 안되는 사람, (물건), 부활한 예수가 막달라 마리아와 만나는 그림, 악성궤양, 쌀쌀한(가까이 할수 없는)태도
noll : n, (영방)머리꼭대기
nolle prosequi : n, (법)소송중지의 동의, 그 법정 기록
noload : a, (증권)판매 수수료 없이 매출되는 (투자 신탁)
nolo contendere : n, (법) 형사 소송에서 피고인의, 불항쟁의 답변
nolo episcopari : n, 책임있는 지위에의 취임사퇴
nolpros : vi, (미)(원고가)소송중지에 동의하다
nom. : x, nomenclature, nominal, nominative
noma : n, 수암(회저성구내염)
nomad : n, 유목민, 유목민족, 방랑자, 유목하는, 방랑의(wanderihg)
nomadic : a, 유목의, 방랑의, nomadically()ad, 
nomadism : n, 유목생활, 방랑(생활)
nomadize : vi, vt, 유목행활을 하다, 방랑하다, 방랑하게 만들다
noman : n, 동조하지 않는 사람
no man'sland : n, 무인지대, 임자 없는 땅, (양군이 대치하고 있는)최전선 사이의 무인지대, 위험지대, 이도저도 아닌(모호한)분야 (입장, 생활)(미여군막사)
nomarch : n, (고대 이집트의)주지사, (현대 그리스의)주지사
nombril : n, 방패 무늬바탕의 하반부 중간점
nom de guerre : n, (원래 프랑스의 병사가 본명외에 사용한 이름)가명, 예명
nom de plume : n, (영국제 프랑스어)필명, 아호
Nome : n, 놈
nomen : n, (옛 로마)둘째이름, 족명
nomenclator : n, (학명의)명명자, 용어집, (속명의)명칭일람, 손님의 이름을 호명하는 역할을 맡는 사람, (옛로마)손님의 이름을 주인에게 알리는 하인, 연회의 좌석안내인
nomenclature : n, (조직적인)명명법, 학명, 술어, (집합적)(일반적으로)명칭, 목록, nomenclatural()a, 
nomic : a, 재래(보통)의 자연법에 알맞는
nomin. : x, nominal, nominative
nomina : n, NOMEN의 복수
nominal : a, n, 이름만의, 명목(명의)상의, 아주적은, 근소한(slight), 이름의, 명칭상의, 공칭의, (증권이)기명의, (문법)명사의, 명사적인, (미)만족한, 계획대로, 명사 상당어, 명사류, nominally()ad, 
nominal GNP : x, 명목국민 총생산(그기간의 화폐액으로 표시된 국민 총생산)
nominalism : n, (철)유명론, 명목론
nominalist : n, 유명론자, 명목론자
nominalistic : a, (철)유명론자의, 명목(유명)론적인
nominal value : x, (증권따위의) 액면가격
nominal wages : x, 명목임금
nominate : vt, (선거, 임명의 후보자로서)지명하다, 지명천거하다, 임명하다, 이름을 들다, (회합날짜등을)지정하다, (경마)말의 출장등록을 하다
nomination : n, 지명, 추천(권)(특히)(관직의)임명(권), (경마)말의 출장등록
nominatival : a, (문법)NOMINATIVE
nominative : n, a, (문법)주격의, 지명(임명)의, 주격, 주어
nominative absolute : x, (분사의)독립 주격
nominator : n, 지명, 임명, 추천자
nominee : n, 임명(지명)된 사람, 수령명의자
nomo : x, (연결형)법, 법칙의뜻
nomogram : n, 계산도표, 노모 그램
nomography : n, 계산 도표학
nomothetic : a, 입법의, 법에 입각한
nomy : x, (연결형)..학, ..법의 뜻
non- : ad, 않다, 아니다
non- : pref, (자유로이 명사, 형용사, 부사에 붙여서), 비, 불, 무의 뜻을 나타냄
Nona : n, 여자이름
nona-[n'1n(5)(연결형)9번째의 뜻
nonability : n, 불능, 무능(inability)
nonabstainer : n, 음주가, 무절제한 사람
nonacceptance : n, 불승낙, 어음인수거절
nonaccess : n, (남편의 출정, 항해등으로 인한 부부의)성교불능, 무교접
nonachiver : n, 낙제생, 목표 달성을 못한 사람
nonactin : n, 노낵틴(스트렙토마이신 등에서 유도한 항생물질)
nonaddict : n, (중독이 안되어 있는 마약사용자)
nonaddicting : a, 중독성을 초래치 않는, 비중독성의(약)
nonaddictive : a, 중독성을 초래치 않는, 비중성의(약)
nonadmission : n, 입장(입회)거절
nonaerosol : a, 분무 추진제(특히 불화탄소)를 쓰지 않은, (스프레이가)프론가스를 쓰지 않은
nonage : n, (법률상의)미성년(minority), 유치, 미발달, 미숙, 발달초기
nonagenarian : a, n, 90대의 사람
nonaggression : n, 불침략
nonagon : n, 9각(변)형, 9각형
nonalcoholic : a, (음료가)알코올을 함유하지 않은
nonalign : vt, vi, 제휴하지 않다, 중립을지키다
nonaligned : a, 중립을 지키는, 비동맹의
nonalignment : n, 비동맹
nonappearance : n, 불참, (법)(법정에의)불출두
nonary : a, n, (수)9진법의, 9개의 한쌍
nonassertive : a, (문법)(문장절이)비단정적인(의문, 부정 조건문등)
nonassignable : a, 양도할수 없는
non assumpsit : n, (법)인수소송(assumpsit)에서피고의 계약 부인의 답변
nonattendance : n, 불참 , 결석, (의무 교육의 )불취학
nonbank : a, 은행이외의, 은행이 아닌 금융기관의, 비 은행계의
nonbeing : n, NONEXISTENCE
nonbellingerent : n, a, 비 교전국의
nonbook : a, n, 책이 아닌(마이크로필름등), (미)책이라고 할수 없는 책, 가치 없는 책
nonbook materials : x, 비도서 자료 (시청각 자료등)
nonbreathing : a, 공기가 통하지 않는, 통기성이 없는
noncandidate : n, 비입후보자, 불출마 표명자, noncandidacy()n, 
noncaptive : (사내 소비 목적이 아니라)외판용의
nonce : n, a, 목하, 당장, 우선, 당면의 목적, 일회만의, 임시의
noncertifiable : a, 정신병자라는 증명을 할수 없는, (익살)맑은 정신의
nonce word : x, 임시어 (특별히 만들어 그자리에서만 쓰는)
nonchalance : n, 아랑곳하지 않음, 냉담
nonchalant : a, 아랑곳하지 않는, 무관심한, nonchalantly()ad, 
nonclaim : n, 청구해태(기한내에 청구를 하지 않아 권리를 상실함)
noncollegiate : a, n, (학문이)대학 정도가 아닌, (영)(학생이)대학(학부)에 속하지 않는, (태학이 학부제도가 아닌, 대학 교육을 받지 않은 사람, college에 속하지 않는 대학생
noncom : n, 하사관
noncombat : a, 비전투의, 전투를 필요로 하지 않는
noncombatant : n, a, 비전투원의
noncombustible : a, 타지 않는
noncommercial : a, 비영리적인
noncommissioned : a, 위임장이 없는, 임관되지 않은
noncommissioned officer : x, 하사관
noncommitment : n, 자신의 입장을 분명히 밝히지 않음
noncommittal : a, 언질을 주지 않는 뜻, (성격)이 애매한, 막연한, 특징이 없는
noncommitted : a, (투표자등이)태도를 밝히지 않은, 태도보류의, 중립의, 비동맹의
noncommunicant : a, n, 성찬을 받지 않은(사람)
nonCommunist : a, 공산당원이 아닌, 비공산주의의
NonCommunist Affidavit : x, (미)공산주의자 배척서약서
noncompliance : n, (명령, 요구등에)응하지 않음, 불복종
noncompliant : a, (요구, 명령등에)순종(순응)하지 않는
non compos(mentis) : a, 옳은 정신이 아닌, 정신이상의(insane)
noncon : n, NONCONFORMIST, NONCONTENT
noncondensing : a, (증기 기관이)불응식의
nonconducting : a, 부전도의
nonconductor : n, 부도체, 절연체
nonconfidence : n, 불신임
nonconformance : n, 불복종, 국교불신봉
nonconformant : n, 비순응(비순종)주의자, 비국교도(dissenter)
nonconforming : a, 따르지 않는, 국교를 신봉하지 않은
nonconformism : n, NONCONFORMITY
nonconformist : n, 
nonconformity : n, 불일치, (습관, 여론등에의)비추종(주의), 국교 불신봉, 비국교도
nonconsumptive : a, 자연을 파괴하지 않는, 천연자원을 낭비하지 않는
noncontact : a, (시합에서)몸의 접촉이 없는(육상, 테니스등)
noncontent : n, (상원의)반대 투표(자)
noncontentious : a, 논쟁(논의)의 여지가 없는
noncontradiction : n, 모순이 없음
nonconvertible : a, 금화로 바꿀수 없는
noncooperation : n, 비협력, 대정부 비협력(운동)(특히 인도의 간디파의)대영 비협력 운동), noncooperatist()n, noncooperative()a, 
noncooperativity : n, 비협력, 비협조
noncooperator : n, 비협력자, 비협력운동실천자, (인도의)비협력 정책주의자
noncountry : n, 비국가, 국가로서 인정되지 못하는 나라
nondairy : a, 우유(유제품)을 함유하지 않음
nondelivery : n, 인도 불능, 배달불능, 불착
nondescript : a, n, 정체를 알수 없는, 특징이 없는 , 막연한, 정체를 알수 없는 사람(물건)
nondestructive : a, 비파괴적인, (검사등에서 그 대상 물질을)파괴하지 않는
nondestructly : ad, 
nondffective : 효과없는, 전투력이 없는, 전투력이 없는 군인:a, n, 
nondiabetic : a, n, 당뇨병에 걸려 있지 않은(사람)
nondirective counseling : x, 비지시적 충고
nondiscrimination : n, 차별이 없음, 차별하지 않음
nondiscriminatory : a, 
nondistinctive : a, 비변별적인
nondrinker : n, 술을 마시지 않는 사람, 금주자(가)
nondrinking : n, 금주의 술을 마시지 않는, 금주
nondurable goods : x, NONDURABLES
nondurables : n, pl, 비내구재(의류, 식품 따위)
none : n, NONES
nonearthly : a, 지구밖의(extraterrestrial)(우주공간을 말함)
noneconomic : a, 경제의, (특히)경제적 가치가 없는
nonego : n, 비아(주관에 대한)객관
nonentity : n, 실재하지 않음, 실재(존재)하지 않는것, 상상의 산물, 지어낸 것, 보잘것 없는(변변치 않은)사람(물건)
nones : n, pl, 제 9시과(고대 로마에서 오후 3시지금은 정오에 드리는 기도)
nonessential : a, n, 비본질적인, (것, 사물), 중요치 않은(것, 사람)
non est : a, 존재하지 않는, 부재의
non est inventus : n, 본인소재 불명
nonesuch : n, 둘도 없는것, 일품
nonet : n, 9중주 창곡, 9중주창단
nonetheless : ad, 그럼에도 불구하고, 그래도, 역시(none the less)
non Euclidean : a, 비 유클리드의
nonevent : n, 용두사미격인(기대밖의)사건, 실제로는 일어나지 않은일
nonexistence : n, 존재 실재하지 않음, 비존재물
nonexistent : a, 존재(실재)하지 않는
nonfamily : n, 비가족(혈연 관계는 없으나 함께 사는 사람들)
nonfat : a, 탈지한(우유)
nonfeasance : n, 의무 불이행
nonferrous : a, 철을 함유하지 않은
nonfiction : n, 논픽션, 소설, 이야기외의 산문, 문학(역사, 전기, 기행문, 수필등)
nonfictional : a, 논픽션의
nonfigurative : a, NONOBJECTIVE
nonfinite : a, 비정형의
nonflammable : a, 불연성의
nonfluency : n, 눌변
nonfreezing : a, 얼지 않는, 부동성의
nonfulfillment : n, 불이행
nong : n, (오스속)바보, 얼간이
nongradable : a, 비교 변화를 하지 않는
nongraded : a, 등급 없는, 학년별로 나누지 않는
nongreen : a, 녹색이 아닌, 엽록소가 없는
nonhero : n, ANTIHERO
nonhuman : a, 인간이 아닌, 인간이외의(cf.INHUMAN)
nonidentical : a, 다른 같지 않은(different)2란성의 (쌍생아)
nonillion : n, (영.독일)100만의 아홉, 제곱(미, 프랑스)천의 열 제곱
nonimmune : a, 면역성이 없는
nonimpact printer : x, 무소음을 목표로 개발된 복사기의 일종
nonimportation : n, 수입거부
noninductive : a, 불유도의
noninflammable : a, NONFLAMMABLE
noninsecticidal : a, 살충력이 없는, 살충제를 쓰지 않는
noninterference : n, (특히 정치상의)불간섭
nonintervention : n, 불간섭, 내정불간섭, noninterventist()n, 
nonintrusion : n, (스코틀랜드 교회)성직 임명자는 신도가 싫어하는 목사를 임명해서는 안된다고 하는 주의
noniron : a, 다림질이 필요없는
nonjoinder : n, 공동 원고(피고)의 불병합
nonjudgmental : a, (특히 도덕문제에서)개인적 판단을 피하는
nonjuring : a, (신하로서의 복종서약을 거부하는)
nonjuror : n, 선서 거부자, (신종의 선서 거부자 1688년의 혁명 후 William iii및 Mary에 대한 신종의 서약을 거부한 국교의 성직자)
nonjury : a, 배심을 요하지 않는
nonleaded : a, (휴발유가)무연의
nonlegal : a, 비법률적인, 법률 범위 밖의, 법률적 성질을 갖지 않은(cf.ILLEGAL)
nonlethal : a, 치명적이 아닌
non liquet : n, 재판 연기의 배심평결
nonlogiacal : a, 논리이외의 방법에 의한(cf.ILLOGICAL)
nonmainstreamer : n, 비주류파
nonmarket : a, 노동시장에 포함되지 않은
nonmaterial : a, 비물질적인, 정신적인, 문화적인
nonmember : n, 비회원, nonmembership()n, 
nonmetal : n, 비금속(원소)
nonmetallic : a, 비금속성(의)
nonmoral : a, 도덕에 관계없는(cf.IMMORAL)
nonmother : n, 피임여성
nonmotile : a, 자동력없는
nonnatural : a, 자연에 의지하지 않는(cf.UNNATURAL)
nonneoplastic : a, (병리)신생물(종양)이 아닌, 비신생물이 원인이 아닌
nonnuclear : a, n, 핵무기 이외의 , 비핵의, 핵무기를 안가진, 비핵보유국
nonnumerical : a, 비수치의
nono : n, 해서는(말해서는, 써서는)안되는 일(것), 금물, 금지사항
nonobjevtive : a, 비객관적인, 추상적인, 비구상적인
non obs(t). : x, non obstante
nonobservance : n, 불준수, 위반
non obstante : prep, ..에도 불구하고
nonoccurrence : n, 사건등이 일어나지 않음, 불발
nonofficial : a, 비공식의
nonoil : a, 석유제품을 수입하는, 석유이외의
nononsense : a, 진지한, 농담이 아닌, 현실(실제)적인, 사무적인
nonorgasmic : a, n, 오르가즘을 느끼지 못하는(사람), 불감증인(사람)
nonpareil : a, n, 비길데없는 사람(것)의, 둘도 없는, 극상품, 일품, 초콜릿의일종, 오색멧세
nonparous : a, 출산경험이 없는
nonparticisan, -tisan : a, 당파에 속하지 않은, 무소속의
nonparticpating : a, 이익배당이 없는
nonparticpation : n, 불관여, 불참
nonparty : a, 당파심이 없는, 불편부당의
nonpayment : n, 지불하지 않음, 미불, 미납
nonperformance : n, 불이행
nonperishable : a, 잘부패하지 않는, 보존할수 있는(식품)
nonpermissive : a, (유전물질, 바이러스등의)복제를 저해하는
nonpersistent : a, 지속성이 없는(약품)비영속형의(바이러스)
nonperson : n, 사람 취급 못받는 사람, 법(사회)적 약자, 실각한 지도자
nonpersonal : a, 개인적이 아닌
non placet : n, (교회, 대학의 집회에서)이의, 반대투표
nonplacet : vt, 거부하다..에 반대 투표를 하다
nonplaying : a, (특히 팀의 주장이)경기(시합)에 참가하지 않는
nonplus : n, vt, 어찌할 바를 모름, 곤란한 입장, 궁지, 어찌할 바를 모르게 하다, 난처하게(당황하게)만들다
non plus ultra : n, NE PLUS ULTRA
nonpolitical : a, 비정치적인, 정치에 관심이 없는
nonpolluting : a, 오염시키지 않는, 무공해성의, 공해없는
non possumus : x, 무능력(불능)의 신청
nonprint : a, (정보, 자료가)인쇄물이 아닌(테이프, 필름등)
nonpro : n, a, NONPROFESSIONAL
nonproductive : a, 비생산적인, 생산직이 아닌(사원등), nonproductiveness()n, 
nonprofessional : a, n, 비직업적인, 포로가 아닌, 직업의식을 떠난(cf.UNPROFESSIONAL), 직업적이 아닌사람, 비전문가
nonprofit : a, 비영리적인, (사회가)자본주의에 의하지 않는
nonprofitmaking : a, NONPROFIT
nonproliferation : n, 번식하지 않음, (핵무기의)확산 방지, 비확산
nonpros : vt, 소송절차를 태만히 하는 원고에게, 패소를 언도하다
nonpros. : x, non prodequitur
non prosequitur : n, (소송절차를 태만히 하는 원고에 대한)패소판결
nonprovided : a, (영)비공립의(국민학교)
nonrenewable : a, 재생불가능한 자원
nonrepresentational : a, 비 구상적인, 비구상파(주의)의, nonrepresentationism()n, 
nonresidence, -dency : n, (임지등에)거주하지 않음, 비거주자임(의 신분)
nonresident : a, n, (임지등에)거주하지 않은, 부재의, 비거주자, 부재지주
nonresistance : n, (권력, 법률등에 대한)무저항(주의)
nonresistant : a, n, 무저항(주의)의, 무저항주의자
nonrestrictive : a, 비제한적인
nonrevenue passenger : x, 무상여객
nonriged : a, 연식의
nonscheduled : a, 부정기 운항의(항공사등)예정에 없는 , 임시의
nonsectarian : a, 파별성이 없는, 어느 종파에도 속하지 않는
nonsense : n, a, int, 무의미한 말, 허튼소리, 어리석은 생각, 어리석은 행위(짓)넌센스, 시시한(가치없는) 것(일), 넌센스시, 의시, 무의미한, 어리석은, 무의미한 유전함호의, 되지 않은 소리
nonsensical : a, 되지 못한, 터무니 없는
nonsensically : ad, 
non seq. : x, non sequitur
non sequitur : n, 그릇된 결론
nonsexist : a, 남녀 차별을 하지 않는, 여자를 멸시하지 않는
nonsexual : a, 남녀(암수)구별이 없는, 무성의(sexless)
nonsked : a, n, NONSCHEDULED, 부정기 운항회사, 부정기편(수송기)
nonskid : a, 미끄러지지 않는(타이어등)
nonsmoker : n, 담배를 피우지 않는 사람, (영)(기차등의)금연실
nonsmoker's rights : x, 혐연권, 비흡연자의 권리
nonsmoking : a, 금연의(차량등)
nonsocial : a, 사회성이 없는, 사회적 관련이 없는(cf.UNSOCIAL)
nonsociety : a, 조합(단체)에 가입하지 않은(노동자)
nonsolvent : n, 비용제, (법)지불능력이 없음
nonspecific : a, 일반적인
nonstandard : a, 표준(기준)에 맞지 않는, (제품, 언어, 발음), 표준어가 아닌
nonstandard analysis : x, 초준해석
nonstarter : n, (경마에서)출발못하는 말, 성공할 가망이 없는 사람(생각등)
nonstick : a, (프라이팬등이)요리도중 눌어 붙지 않게 되어있는
nonstop : ad, a, n, 도중에서 정거하지 않는, 직행의(으로)도중 무착륙의(으로)연속적인(으로)휴식없는(없이)직행열차(버스)등 직행운행
nonstore marketing : x, 무점포 판매방식(통신, 방문, 자동판매등)
nonstore retailing : x, 무점포 판매(점포 판매와 대립되는 개념)
nonsuch : n, =Nonesuch
nonsuit : n, vi, 소송 각하, 취하(하다), (원고의)소송을 취하하다, 각하하다
nonsupport : n, 지지하지 않음, 부양 의무불이행
nonsyllabic : a, 음절을 이루지 않는
nonsystem : n, (충분히)조직화되지 않은제도, 비제도
nontarget : a, 목표(대상)가 되어 있지 않은, 목표(대상)밖의
nontariff barrier : a, 비관세 장벽
nonthing : n, 존재하지 않은것, 무(nothing), 무의미한것
non troppo : ad, 지나치지 않게 , 알맞게
nonU : a, n, 상류계급 답지 않은(말씨, 예법등), 비상류인
nonunion : a, 노동조합에 가입하지 않은, 노동조합을 인정하지 않는, 노동조합불가입자가 만든
nonunionism : n, 노동조합 불가입, 반노동조합(이론, 행동, 주의)
nonunionist : n, 비조합원(노동자)
nonunion shop : x, 반 노조기업(노조와 관계없이 고용주가 고용조건을 정하는
nonuse : n, 사용하지 않음, 포기
nonuser : n, 권리불행사, 권리포기, 기권, 비사용(이용)자
nonvector : n, (병원균, 병원체)을 매개하지 않는, 비매개 동물
nonverbal : a, 말을 사용(필요로)하지 않는, 말이 서투른
nonviable : a, 생존할수 없는, 생활(생육)불능의, 발전 불가능한
nonviolence : n, 비폭력(주의), 비폭력데모
nonviolent : a, 비폭력의
nonvocoid : n, CONTOID
nonvolatile memory : n, (전자)불휘발성 기억장치(전원이 끊겨도 소멸되지 않는)
nonvoter : n, 투표하지 않는 사람(투표)기권자, 투표권이 없는 사람
nonvoting : a, 투표하지 않는, 투표권 없는, (주식이)의결권없는
nonwhite : a, n, 백인이 아닌(사람)
nonwoven : a, n, 짠것이 아닌, 부직포의, 부직포
nonyl : n, 노닐기
noodle : n, (미)밀가루와 달걀로 만든 국수(수프용)면류
noodle : n, vi, 바보, (미속)머리, (즉흥적으로)악기를 타다, 곰곰생각하다
nook : n, 구석(corner)구석진 곳, 외딴(후미진)곳, 숨는 곳, 피난처
nooky, nookie : a, 구석(모퉁이)이 많은 구석같은
nooky, nookie, nookey : n, (성교대상의)여자, 성교, 질(vagina)
noon : n, a, vi, 정오, 한낮(midday), 한밤중, 야반, 전성기, 결정, 정오의, 정오에 하는, 점심을 먹다, 낮 휴식을 취하다(cf.NOONING)절정에 달하다
noonbasket : n, (미)도시락
noonday : n, a, 정오, 한낮, 정오의, 한낮의
no one, noone : pron, 아무도..않다(nobody)
noonflower : n, 사철 채송화속(번행과)
nooning : n, 정오, 낮의 휴식, 점심
noontide : n, a, NOONDAY, 전성기, 절정, 정오의
noontime : n, =Noonday
noose : n, vt, (올가미 처럼)고를 내어 묶음, 올가미(snare), (교수형의)목매는 밧줄, 교수형, (부부등의)유대, 굴레(bond), 올가미를 치다(로 잡다)교살하다, 덫에 걸다, (밧줄에)올가미 고를 만들다
noosphere : n, (생태)인지권(인간활동으로 변화가 현저한)
Nootka : n, 누트카족(캐나다의 vancouver섬에 사는 북미 인디언), 누트카 말
nopal : n, 노팔선인장
nopar : a, 액면 가격을 명기하지 않은
nope : ad, no(cf.YEP)
NOPEC : n, 비OPEC 석유 수출국
no place : x, 아무데도 없다(nowhere), 중요하지 않은 장소, 보잘것 없는 곳
nor : conj, ...도 또한 ...않다, ..도 아니다(하지 않다)neither..nor
nor : conj, 보다도(than)
nor : n, a, ad, =North
NOR : n, 부정논리화(NOT와 OR의 결합논리)
nor'easter : x, NORTHEASTER
Nora : n, 여자이름(Eleanor, Honora, Leonora의 애칭)
NORAD : x, North American Air Defense Command 북미 대공 방위 사령부
noradrenergic : a, (생리)노르아드레날린(부신 분비 호르몬)에 의해 활성화된
Nordic : n, a, 북유럽인(의), 스칸디나비아 사람, 북구 게르만계 제민족의, 북방인종(형의)(스키)노르딕 경기의(거리와 점프등)
Nordic Council : x, 북구 이사회(Iceland, Norway, Denmark, Sweden, Finland의 국제 협의 기구)
norepinephrine : n, (생화)노르에피네프린(부신수질 호르몬)
norethindrone : n, 노르에티노드렐(황체 호르몬, 경구 피임약)
norethynodrel : n, 노르에티노드렐(황체 호르몬, 경구 피임약, 월경 조정약등)
noreturn : a, 쓰고 버리는(병)(회수해서 재이용하지 않는)
Norf. : x, Norfolk
norfloxacin : n, 노르플록사신(신형항생물질)
Norfolk : n, 노퍽(영국동부의주)
Norfolk dumpling : x, 노퍽 찐만두, 노퍽 사람
Norfork jacket(coat) : x, 허리에 벨트가 달린, 느슨한 주름이 있는 재킷
Norge : n, Norway
noria : n, (스페인, 중동의)양동이가 달린 물방아
norland : n, 북쪽나라(northland)
norlander : n, 북쪽나라 사람
norm : n, 표준, 일반수준, 노르마(노동기준량), 평균성적(학력)규범, 노르마
norm. : x, normal
Norm. : x, Norman
norma : n, 직각자리
Norma : n, 여자이름
normal : a, 표준의, 규격대로의, 정규의, 전형적인, 정상의, 상태의, 보통의, 평균의, (사람이)정상적으로 발달하고 있는, 수직의, (용액이)규정의, (실험동물이)정상의, (면역등)자연의
normal : n, 상태, 전형, 표준, 평균, 평온, 법선, 수직선, 평균량, normalness()n, 
normalcy : n, 정상, 상태, 규정도
normal distribution : x, 정상분포
normality : n, 
normalization : n, 표준화, 정상화
normalize : 표준화하다(국교등을)정상화하다, (표기를)일정한 절차법으로 통일한, 표준화(정상화)되다:vt, vi, 
normalizer : n, 표준(정상)화하는 것(사람), 정규화군
normally : ad, 정상적으로, 순리적으로, 정상상태로는, 정규로, 보통은
normal school : x, 사범학교(현재는 teachers college로 개칭
normal solution : x, 규정액
normal temperature : x, 평상체온
Norman : a, n, 노르만사람의, 노르만디 사람, 노르만 사람과 프랑스 사람의 혼합민족, 노르만(프랑스)말, 노르망디 사람의, 노르만족의
Norman : x, 남자이름
Norman architecure : x, 노르만 건축(간소, 장엄이 특색인 로마네스크 건축양식)
Norman Conquest : x, 노르만 정복(노르만 사람의 영국정복)
Normandy : n, 노르망디(영국 해협에 면한 프랑스의 북서 지방)
Norman English : x, 노르만 영어(Norman French 에 영향 받은 영어)
Normanescque : a, 노르만식(풍)의
Norman French : x, 노르만 프랑스 말(노르만 사람이 사용한 프랑스말)
NormanFrench : a, 노르만 프랑스 말의
Normanism : n, 노르만식(주의)노르만 사람 편들기
Normanization : n, 노르만화
Normanize : vt, vi, 노르만식으로 하다(되다)
Norman style : x, 노르만 양식
normative : a, 기준을 세우는, 표준의, 기준에 따르는, 규범적인
normotensive : a, n, 정상 혈압의(사람)
normothermia : n, 정상체온, 평열
Norn : n, 노른(운명을 맡아 보는 3여신의 하나)
Norse : (고대)노르웨이 사람, 노르웨이 말, 북구의, 노르웨이(사람, 말)의:n, a, 
Norseland : x, NORWAY
Norseman : x, NORTHMAN
north : n, 북, 북쪽, 북부, 북부지방, 영국북부, 북부제주, 북반구, 북극지방, (남북전쟁때의)북군
north : a, ad, 북(부)의, 북쪽에 있는, 북향의, 북부의, 북국의, 북으로 부터의, 북으로(에), 북쪽(북부)에(으로)
North Africa : n, 북아프리카(열대 대륙)
North African : x, 북아프리카의(사람)
North America : x, 북아메리카(열대 이북)
North American : a, n, 북미의 (사람)
Northamption(shire) : n, 노샘프턴(셔)(영국 중부의 주)
Northants. : x, Northamptonshire
North Atlantic Treaty Organization : x, 북대서양 조약 기구(NATO)
northbound : a, 북행의
North Britain : x, 북영, 스코틀랜드(의 별칭)
North Briton : x, 스코틀랜드 사람
North Calolina : x, 미국남대서양 연안의 주, North Carolinian()a, n, 
North Cape : n, 노르곶(노르웨이의 북단), 뉴질랜드의 북단
North Channel : n, 노스 해협코틀랜드와 북아일랜드 사이)
north Country : n, (영)잉글랜드(대 브리튼)의 북부, (미)알래스카와(개나다의)Yukon을 포함한 지역
North Dakota : n, 북미 인디언 말(동맹)의뜻에 North를 붙인것, 노스다코타 (미국 중서부의 주), North Dakotan()a, n, 
northeast : n, 동북
northeast : a, 동북의(에 있는, 에 면한), 동북에서 온
northeast : ad, 동북에(으로, 으로부터)
northeaster : n, 동북(의 강)풍
northeasterly : a, ad, 동북의(으로), 동북으로 부터의
northeastern : a, 동북(부)의, (미)동북부(특유의)(바람이)동북에서 부는
Northeast Passage : x, 북동 항로(유럽 및 아시아의 북해안을 따라 북대서양에서 태평양으로 나오는)
northeastward : a, ad, n, 동북에 있는(면한), 동북쪽으로(에)동북쪽
northeastwardly : ad, a, NORTHEASTERLY
northeastwards : ad, 동북쪽에(으로)
norther : n, (미)강한 북풍
northerly : a, ad, n, 북쪽에 위치한, 북으로 부터의, 북쪽으로(부터)북풍
northern : a, n, 북의, 북에있는, 북향의, 북부지방에 사는, 북부 태생의, 북부 독자적인, 북부지방특유의, 북에서 불어오는, 북으로 향한, 북진의, 북부 각주의, (미국의)북부 방언
Northern Cross : n, 북십자성(백조자리)
Northerner : n, 북부사람, 북부지방 사람, (미)북부지방제주의 사람
Northern Hemisphere : x, 북반구
Northern Ireland : n, 북아일랜드(영국의 일부)
Northern lights : x, AURORABOREALIS
northernmost : a, 가장북쪽의
Northern Rhodesia : n, 북로디지아(Zambia의 영국 식민지 시대의 명칭)
Northern Territories : n, 서아프리카 옛 영국 보호령(현Ghana의 일부)
Northern Territory : n, 오스트레일리아 중북부의 연방 직할지
North Germanic : x, 북게르만어(군)
northing : n, 북거(전에 측정한 지점에서 더 북쪽에 있는 어떤 한 지점까지의 위도차), 북편, 북진, 북항
North Island : x, (뉴질랜드의)북쪽섬
North Korea : n, 북한
northland : n, (지구상의)북지, 스칸디나비아 반도
northlander : n, 북국사람, 북부의 주민
north light : x, 북광(을 받는 채광창)
Northman : n, 고대 스칸디나비아 사람(Norseman), 북유럽 해적(Viking), (현재의)북유럽 사람
northmost : a, NORTHERNMOST
northnortheast : n, a, ad, 북북동(에, 의)
northnorthwest : n, a, ad, 북북서(의에)
north polar : x, (지구의)북극, (하늘의)북극, (자석의)북극, N극
North Riding : n, 노스라이딩(옛 Yorkshire의 한구, 현재 North Yorkshire의 대부분)
North River : x, 노스리버(뉴욕의 Hudson강 하류의 별칭)
North Sea : n, 북해(유럽 대륙과 영국 사이의 얕은 바다)
northsouth : a, 남북의
NorthSouth problem : x, 남북문제(북반구의 선진 부국과 남반구의 저개발 빈국 간의 경제적 격차 문제)
North Star : x, 북극성
North Star State : x, Minnesota주의 속칭
northumb : x, Northumberland
Northumberland : n, 잉글랜드 북쪽 끝의 주
Northumbria : x, (험버)강의 북쪽의 뜻에서 노섬브리아(영국 북부의 옛왕국)
Northumbrian : n, Northumbria(영국 북부의 고대 왕국)의 사투리, Northumbria사람, Northumbria사투리, Northumberland주의 주민
North Vietnam : n, 북베트남(통일전의)
northward : ad, a, n, 북을 향하여, 북쪽으로, 북을향한, 북쪽으로의, 북, 북방, northwardly()ad, a, 
northwards : ad, NORTHWARD
northwest : n, 북서(지방), 서북부, (미국의)서북부, (캐나다)의 서북부
northwest : a, ad, 북서의, 서북부의, (바람이)서북에서 부는, 서북에(으로), 서북쪽에(으로)
northwester : n, 북서풍, 북서의 강풍, ~ly ad, a, 북서로(의)
northwesterly : ad, a, 서북으로(의), 서북으로부터(불어오는)
northwestern : a, 서북의, 서북부(특유)의, (바람이)서북에서 부는
Northwest Passage : x, 서북 항로(북대서양에서 캐나다 북극해를 빠져서 태평양으로 나가는)
Northwest Territories : n, 캐나다 북서부의 연방직할시
Northwest Territory : n, 미국 Ohio강 이북의 오대호에 걸친 지역의 옛이름
northwestward : ad, a, n, 서북쪽으로(에), 서북으로의, 서북에 있는, 서북쪽, northwestwardly()ad, a, 
northwestwards : ad, NORTHWESTWARD
North Yorkshire : n, 노스요크셔(잉글랜드 북동부주)
nor triptyline : n, 노르트립티린(정신안정제)
Norvic. : x, Norviciensis, bishop of Norwich의 서명에 쓰임
Norw. : x, Norway, Norwegian
norward(s) : ad, a, n, NORTHWARD
Norway : n, 노르웨이(스칸디나비아 반도 서부의 왕국, 수도Oslo
Norwegian : a, n, 노르웨이(사람, 말)이
norwester : n, =Northwester, 유포모자, 유포코트, 한잔의 독주
Norwitch : n, 노리치(잉글랜드 Norfolk주의 주도)
Nos., nos, nos. : x, numbers
nose : n, vt, 코, 후각(기관), 직각적 식별력, 돌출부, (관등의)끝, 총부리, 총구, 뱃머리, (비행기의)기수, (수뢰, 자동차등의)선단, (경찰의)정보원, 잡이, 냄새 맡다, 냄새맡아내다, 찾아내다, 코를 비벼(눌러)대다, (배등이)(조심스럽게)전진하다, 반대하다, 콧소리로 말하다(노래하다)
nose : vi, 냄새맡다, 찾다, 맡아내다, 꼬치꼬치 파고들다, 캐다, 간섭하다, (배등이)(조심스럽게)전진하다, 아래로 기울어지다, 내리다, 꺾다
nose ape : x, 코원숭이
nose bag : x, (말목에 채우는)꼴주머니(망태), (소풍등의)도시락, 방독 마스크
noseband : n, (말의)코에 대는 장식띠, 재갈끈
nosebleed(ing) : n, 코피가 남, 비출혈
nose bob : x, NOSE JOB
nose candy : 코카인(cocaine)
nose cone : x, (로켓등의)원추형 두부)
nose count : x, 인원수 세기, 다수결
nosed : a, (보통 복합어를 이루어)..한 (같은)코의
nose dive : x, 급강하, 가격의 폭락(하다)
nosedive : x, 급강하하다, (가격 등이) 폭락하다
nose down : x, 기수를 아래로 돌린
nose drops : x, 점비제
nose flute : x, 코피리(말레이 토인등의)
nosegay : n, (옷에 다는) 작은 꽃다발
nose gear : x, 기수밑의 바퀴
nose glasses : x, 코안경pincenez)
nose job : x, 코의 미용성형
nosemonkey : x, NOSE APE
nose ornament : x, 코에 다는 장식물
nosepiece : n, (투구의)코싸개, (안경의)브리지, (현미경의)대물경을 끼우는 부분, (파이프, 풀무등의)주둥이
nosepipe : n, (용광로의)배기관의 주둥이
noser : n, (권투등에서)코쥐어박기, 세찬 맞바람, 참견 잘하는 사람
noserag : n, 손수건
noseride : vi, (속도를 늘리기 위해)파도타기(서핑)판의 끝에 타다, 파도타기 판위에서 곡예 서핑하다
nose ring : x, (소의) 코뚜레, (야만인의) 코걸이
nosetackle : x, 노즈태클(수비의 위치중의하나, 3인을 배치한 수비선의 중앙)
nosethumbing : n, 비웃는 몸짓, 조롱하는 몸짓
nose warmer : x, 짧은 물부리
nosewheel : n, NOSE GEAR
nose wheelie : x, (스케이트 보드)체중을 앞에 실리고 뒷바퀴를 뜨게 하는 기술
nosey : a, =Nosy
nosh : a, vi, vt, (간단한)식사, (영)음식, 식사하다, 간식하다
noshery : x, 식당, 경양식점
noshow : n, (좌석을 예약하고)나타나지 않는 손님, 불참객
noshup : n, 훌륭한 식사, 진수성찬
no side : x, 럭비 경기끝(심판용어)
nosing : n, 디딤판 코(충계의 끝)
nosleep : a, 불면의
noso- : x, (연결형)질병의 뜻
nosography : n, 질병기술학
nosology : n, 질병분류학(표)
nostalgia : n, 과거를 그리워함, 향수, 회향병, nostalgist()n, 
nostalgic : a, 고향(과거)을 그리는, nostalgically()ad, 
Nostradamus : n, 노스트라다무스, 프랑스의 점성학자, 점쟁이, 애매한 예언을 하는 사람
nostril : n, 콧구멍
nostrings : a, 무조건의, 부대조건이 없는
nostrum : n, (가짜)특효약, 만병통치약, (문제해결의) 묘안
nosy : a, 참견잘하는, 코가 큰사람, 냄새가 고약한, nosily()ad, nosiness
Nosy Parker : x, 참견잘하는 사람, 잔소리꾼, 야유꾼
not : n, (전산)나트, 역논리(부정을 만드는 논리 연산자)
notabene : x, 주의하라
notabilia : n, pl, 주의사항, 저명한 사물
notability : n, 유명함
notable : a, 주목할 만한, 저명한
notable : a, n, 주목할 만한, 뛰어난, 두드러진, 유명한, 지각할수 있는, (주부가)살림잘하는, ..으로서 유명하다, 명사, 명망가, 유명한것, 프랑스 비상시 의회의 명사의원
notably : ad, 현저하게, 두드러지게, 명백한, 뚜렷하게, 특히, 그중에서도
NOTAM : x, notice to airman(안전운항을 위한) 항공정보
notandum : n, 주의사항, 각서
notaphily : n, 취미로서의은행권 수집, 지폐수집가
notarial : a, 공증(인)의
notarially : 공증인에 의하여:ad, 
notarize : vt, (공증인이)인증, 증명하다
notary(public) : n, 공증인
notate : vt, 기록하다, 적어두다, 악보에 기보하다
notation : n, 특수한 문자, 부호등에 의한 표시법, 기수법, 기보법, 표기, 표시, 주석, 기록
notational : a, 기호법의, 표시법의
notbeing : n, 비존재
notch : n, (v자형의) 새긴 금, 벤자리, (활의)오늬, (미)(산골짜기 등의)애로, 좁은길, 단, 급, 득점
notch : vt, 금을 긋다(새기다)(경기의 득점등을)올리다, 기록하다, (화살을)재다, 꿰다, (승리 지위 등을)얻게(차지하게 )하다
notchback : n, 후보가턱이 진 자동차(스타일)
notchboard : n, 사닥다리의 디딤판
notched : a, 
notchwing : n, 잎말이 나방의 일종
notchy : a, 금(새긴 눈)이 있는, 톱니모양의
note : (짧은)기록, 각서, 수기, 비망록, 원(초)고, 문안, 주(해), 통첩, 각서, 짧은 편지, 단신, 주의, 주목, 유의, (새의)울음소리, 음성, 어조, (악기)음, 음조, 음색, 음률, 곡조, 선율, 악보, 음표, (피아노등의)키, 표, 부호, 기호, 특징, 유명함, 명성, 중요함, 지폐, 어음, 약속어음, 진정하다는 증거
note : vt, 적어두다, 주목(주의)하다, 주를 달다, 유념하다, 특별히 언급하다, 알아차리다, 음표로 쓰다(붙이다)
notebook : n, 노트, 공책, 필기장, 수첩, 잡기장, 어음첩
notecase : n, (영)지갑(wallet)
noted : a, 유명한, 저명한, 악보가 붙은
notedly : ad, 현저히, 두드러지게, 눈에띄게, notedness()n, 
noteless : a, 눈에 띄지 않는, 평범한, 이름없는, 음조가 나쁜, 비음악적인, 목소리(소리)가 없는
notelet : n, 짧은 편지
note pad : x, 메모장, 메모지철
note paper : x, 편지지
note shaver : x, 미 고리 대금업자
notetaking : n, 적어둠, 필기
note verbale : n, 외교상의 구상서, (상대국에게 제출하는 외교문서)
noteworthy : a, 주목할만한, 현저한, noteworthily()ad, noteworthiness()n, 
notforprofit : a, (미)비영리 목적의(nonprofit)
nothing : pron, n, 아무일도 ... 아님, 무가치의, 무의미, 무, 영, 존재하지 않는 것, 하찮은 사람(일, 물건)
nothing : ad, 조금도 ...이 아니다(...않다), ..도 아무것도 아니다
nothingarian : a, 신앙을 가지지 않는 사람
nothingness : n, 무, 존재하지 않음, 무가치, 소용없음, 하찮은것, 실신(상태)죽음
notice : n, 통지, 통보, 고지, 정식의 통고, (미)성적 불량의 통지, 주의, 주목, 인지, (해고, 해약의)예고, 경고, 고시, 게시, 벽보, 삐라, (신문의)신간소개, (연극 영화의)비평, 비평함, 후대, 총애, 정중함
notice : vt, 알아채다, 인지하다, 주의하다, 주목하다, 아는체하다, 인사(눈인사)하다, ..에게 호의적인(정중한)배려를 하다, 언급하다, 지저고하다, 잠깐다루다, 신문지상에서(신간책을)소개하다, 논평하다, 통지(통고, 예고)하다
noticeable : a, 눈에 띄는 현저한, 두드러진, 주목할 만한, 중요한
noticeably : ad, 눈에 띄게, 두드러지게
notice board : x, 게시판, 고시판, 공고판
notifiable : a, 통지해야 할 신고해야할(전염병등)
notification : n, 통지(서), 공고, 고시, 통지서, 공고문, 계출서신고서
notify : vt, 통지하다, 통보하다, 공고하다, 신고하다, 계출하다, 발표하다, 공시하다, notifier()n, 
notion : n, 관념, 개념, (막연한)생각, 의견, 견해, 의향, 의지, 하고픈생각, , 이해력, 능력, 잡화, 방물, notionless()a, 
notional : a, 개념적인, 관념상의, 추상적인, 순리적인, 상상의, 비현실적인, 변덕스런, 개념을 나타내는, 개념어의, notionally()ad, 
notochord : n, 척삭
Notogaea : n, 남계(오스트레일리아, 뉴질랜드, 서남태평양제도를 포함한 동물지리구의 한 단위)
notoriety : n, (나쁜 뜻의)평판, 악명높은 사람, 유명한 사람, 유명(함)화제의 인물
notorious : a, (보통 나쁜 의미로) 유명한, 이름난(유의어famous)악명높은, notoriously()ad, notoriousness()n, 
notouch : a, (무균 상태가 아닌 환경에서)상처와 붕대의 어느 쪽에도 접촉하지 않고 행하는 붕대법에 관한
Notre Dame : x, 성모 마리아, 성모(노틀담)성당
notrump : a, n, (브리지에서)으뜸패 없이 하는, 으뜸패 없는 선언(승부, 수)
notself : n, (철)비아(nonego)
not sufficient : x, 예금 부족(어음등을 지불할 잔고가 없는 상태)
Nottingham : n, 노팅엄 Nottinghamshire의 주도
Nottinghamshire : n, 노팅엄셔, (영국중북부에 있는 주, 주도Nottingham)
Notts. : x, Nottinghamshire
notwithstanding : prep, ad, conj, ...에도 불구하고, 그런데도 불구하고(nevertheless), ...에도 불구하고, ...할지라도(although)
Nouakchott : n, 누악쇼트(아프리카 서부Mauritania의 수도)
nougat : n, 누가(당과)등으로 만든 과자
nought : n, Naught, 무, (영)영(zero), 보잘것 없는 사람(물건)
nought : ad, 조금도 ...않다
noumenal : a, (철)본체의
noumenalism : n, 본체론
noumenon : n, (철)본체, 물자체
noun : n, a, 명사(의), 상당어구, 명사의, 명사용법의
nourish : vt, 기르다, ..에게 자양분을 주다, (땅에)거름(비뇨)을 주다, 키우다, 조장하다, (감싸)보호하다, (희망, 노여움, 원한을)품다, nourisher()n, 
nourishing : a, 자양(영양)이 되는, 자양분이 많은
nourishment : n, 자양물, 음식, 자양분 공급, 영양상태(정신적)양식, 조성, 육성
nous : n, (철)마음, 지성, 지혜, 상식
nouveau pauvre : n, 최근에 가난하게 된 사람, 갑자기 곤궁하게 된 사람, 사양족의 사람
nouveau riche : x, 벼락부자
nouveau roman : x, 누보 로망(프랑스의 신소설)
nouvelle cuisine : n, (F.)누벨퀴진(새로운 저칼로리의 프랑스 요리
nouvelle vague : n, 새물결, 누벨바그, 최근 프랑스에 나타난 영화등의 전위적 경향
Nov, November : x, 
nova : x, 신성
Nova Scotia : n, 노바스코샤(캐나다 동부의 반도 및 그 주)주도Halifax, 옛이름Acadia)
Nova scotian : a, n, 노바스코샤의 (사람)
novation : n, (채무 계약등의)갱신
novel : a, 신기한, 새로운(new), 진기한, 잘 알려져 있지 않은, 색다른
novel : n, (장편)소설, 로마법 신법
novelese : n, (저급한)소설적 문체
novelette : n, 중편 소설(short story보다 긴 것)(종종 경멸)(가벼운내용의)삼문 소설, 소품 피아노곡
novelettish : a, 중편, 단편소설 양식의(특히)감상적인, 눈물을 짜내는 식의
novelist : n, 소설가
novelistic : a, 소설(적)인, 소설에 흔히나오는
novelization : n, 
novelize : vt, 소설에 쓰다, 소설화 하다
novella : n, 중편소설, 소품얘기
novelty : n, 진기함, 신기로움, 새로운(신기한)물건(일, 경험), 신고안품, 신형
November : n, 11월
novena : n, (카톨릭) 9일기도
novercal : a, 계모의(다운)
novice : n, 무경험자, 풋내기, 수련수사(수녀)초신자, (경주에) 처음 출장하는 말(개)
novitiate : n, 수련수사(수녀)의 , 견습기간, 초심자, 풋내기 수련원
novocain : n, 노보카인(치과용국부마취제)
now : ad, 지금, 오늘날, 지금은(벌써), 현재 실정으로는, (지금)당장에 즉시, 방금, 막, 조금 아까, 한데, 그런대, 그렇다면, 자 어서, 이런, 허
now : a, 지금의, 현재의, (속)최첨단의, 최신 감각의 유행하는
now : conj, ...이니까, ...인 이상은
now : n, 지금, 현재
NOW : x, National Organization for Women(미)전 미국 여성연맹
NOW account : x, negotiable order of withdrawal, (미)당좌 예금식 저축예금 구좌, (이자가 붙는)
nowaday : a, 오늘날의, 요즈음의
nowadays : n, ad, 오늘날에는, 요즈음에는, 오늘날, 현대, 요즈음
noway : ad, 조금도(결코) ... 하지 않다, (절대로)안되다, 싫다
noways : ad, NOWAY
nowcasting : x, 현재 예보(2-6시간 범위로 한 지역의 현재 날씨 예보)
nowel : n, NOEL
Now Generation : x, 나우세대(1960년대 후반의 젊은이 세대)
nowhere : ad, a, n, 어디에도 ... 없다, 어딘지 모르는 곳, 이름도 없는 존재, 무명, 별볼일 없는, 시시한 
nowhither : ad, 아무데도 없다(않다)
nowin : a, 승산이 없는, 승패를 겨루지 않는
nowitcanbetold : a, 이제야 말할수 있는
nowt : n, (스코)축우, 굼벵이, 얼뜨기
nowt : n, NOTHING
Nox : n, 밤의 여신
NOx : n, 질소 산화물, 광화학 스모그의 발생원인)
noxious : a, 유해(독)한, 불건전한, noxiously()ad, noxiousness()n, 
noyau : n, 브랜디를 복숭아씨 속으로 맛을 돋운리큐어 술
nozzle : n, 노즐, (대롱, 파이프 등의) 주둥이, 끌, 취구, 분출(분사, 발사)구, (티포트의)주둥이, 코
nozzleman : n, 노즐(호스끝)을 잡는 사람, 소방원
Np : x, (화)neptunium, (물)neper
NP : x, National Police국립경찰neuropsychiatric, noun phrase, nurse practitioner견습간호사
NPBW : x, neutral particle beam weapon 중성자 빔 병기
NPH : x, neutral protamine Hagedorn신 인슐린
NPN : x, nonprotein nitrogen
NPT : x, nuclear nonproliferation treaty핵확산 금지 조약
NQL : x, National Quarantine Laboratory중앙 방역 연구소
nr. : x, near
NRA, N.R.A. : x, National Recovery Administration, National Recovery Administration, National Rifle Association
Nrays : x, N선(1903년 프랑스의 RBlondlot가 발견한 초자외선)
NRC, N.R.C. : x, National Research Council(미)국가 조사 위원회(오스)Not Recommended for Children, Nuclear Regulatory Commission
Ns : x, nimbostratus
NS, N.S. : x, National Society, New school, New Series, New Side, New Style, Nova Scotia, nuclear ship
NSA, N.S.A. : x, National Security Agency 국가 안보국, National Standards Association, National Students Association, National Shipping Authority, National Skating Association
NSC : x, National Security Council(미)국가 안전 보장회의
nsec : x, nanosecond(s)
NSF, N.S.F. : x, National Science Foundation, not sufficient funds
NSRB : x, National Security Resources Board(미)국방자원 위원회
NSTL : x, National Space Technology Laboratories(미)국립 우주 기술연구소
Nt : x, niton
NT, N.T. : x, New Testament
nt.wt. : x, net weight
NTB : x, nontariff barrier비관세 장벽
nth : a, n번째의 n배의
Nthmb. : x, Northumberland
nthn, Nthn. : x, northern
Nthptn. : x, Northampton(shire)
NTSC : x, National Television System committee(미)텔레비전 방송규격심의회
nu : n, 그리스어 알파벳의 13째글자
NU : x, name unknown
nuance : n, vt, 뉘앙스, 빛깔의 엷고 짙은 정도, 음영, (표현 감정 의미 색채 음색등의)미묘한 차이, (문어)..에 뉴앙스를 주다
nub : n, NUBBLE 요점 핵심(GIST)
nubbin : n, 발육이 좋지 않은, 옥수수 이삭, 작은 덩이, 동강이(연필등의)요점, 핵심
nubble : n, (특히 석탄의)작은 덩어리, 혹 매듭
nubbly : a, NUBBY
nubby : a, 혹 투성이의, 작은 덩이 모양의
nubia : n, 부드러운 털실로 짠 여성용 스카프
Nubia : n, 누비다(아프리카 수단북부지방)
Nubian : a, n, Nubia의 누비아 흑인(말), 누비아 말
nubiform : a, 구름 모양(형상)의
nubile : a, (여자가) 나이찬, 혼기의
nubility : n, 혼기, 방년
nubilous : a, 구름(안개)같은 애매한
nubody : x, (생화)nucleosome
nucleal : x, NUCLEAR
nuclear : a, n, (생)세포핵의, 핵을 형성하는, 원자핵력의, 원자무기의, 핵무기의, 핵보유의, 핵심의, 주요한, 핵무기, 핵보유국
nucleararmed : a, 핵무장 하고 있는
nuclear bomb : x, 핵폭탄
nuclear chemistry : x, 핵화학
nuclear disarmament : x, 핵군축
nuclear energy : x, 핵 에너지
nuclear failout : x, 핵 폭발에 의한 방사능 낙진
nuclear family : x, 핵가족
nuclear fission : x, 핵분열
nuclear force : x, 핵력
nuclearfreezone : x, 비핵(무장)지대
nuclear fuel : x, 핵연료
nuclear fusion : x, 핵융합
nuclear grapeshot : x, (군)소형 전술핵무기
nuclearism : n, 핵무기 중심(이용)주의
nuclearist : n, 
nuclear magnetic resonance : x, (물)핵자기 공명
nuclear medicine : x, (의)핵의학(방사선 핵종을 이용하는 임상의학)
nuclear membrane : x, (생)핵막
nuclear molecule : x, (물)원자핵 분자
nuclear nonproliferation : x, 핵확산 방지
nuclear physicist : x, 원자 물리학자
nuclear physics : x, (원자)핵 물리학
nuclear plant : x, 원자력 발전소
nuclear power : x, (동력으로서의)원자력, 핵무기 보유국
nuclear powered : a, 원자력을 동력으로 하는(잠수함등)
nuclearpropelled : a, 원자력 추진의
nuclear reaction : x, 핵반응
nuclear reactor : x, 원자로
Nuclear Regulatory Commission : x, 미국의 원자력 규제 위원회
nuclear resonance : x, 핵공명
nuclear shelter : x, 핵대피소
nuclear test : x, 핵실험
nuclear test ban treaty : x, 핵실험 금지 조약
nucleartipped : a, 핵탄두를 장비한
nuclear umbrella : x, 핵우산
nuclear warhead : x, 핵탄두
nuclear winter : x, 핵의 겨울(핵전쟁으로 인한 전지구적인 한랭현상
nuclease : (생화)뉴클레아제 (핵산에 작용하는 효소):n, 
nucleat : vt, vi, a, 핵이 있는, 핵주위에 모으다, 응집하다, ..의 핵을 이루다, 핵(모양)을 이루다, 음집되다
nucleated : a, 
nucleation : n, 핵형성, (인공 강우을 위한)빙정 형성(작용)
nuclei : x, NUCLEUS의 복수
nucleic acid : x, (생화)핵산
nucleo- : x, (연결형)핵, 핵의, 핵산의 뜻
nucleochronology : n, (천)원자핵 연대법
nucleochronometer : n, 핵연대 측정물질 (원자핵 연대를 결정하는 기준이 되는 화학원소, 아이소토프)
nucleocosmochronology : n, (천)핵우주 연대학
nucleogenesis : n, NUCLEOSYNTHESIS
nucleolonema : n, 핵소체계, 인사(세포의 인구성물)
nucleolus : n, (생)세포핵 속의 인, 핵소체
nucleon : n, 핵 입자, (양자와 중성자의 총칭), nucleonic()a, 
nucleonics : n, (원자)핵 공학
nucleophile : n, (물)구핵원자(분자)
nucleoplasm : n, (생)핵질
nucleoprotein : n, 핵 단백질
nucleosome : n, (생)뉴클레오솜(염색체의 기본 단위)
nucleosynthesis : n, (우주에서의)핵합성
nucleotide : n, 뉴클레오티드(핵산의 구성성분)
nucleotide sequence : x, (생화)뉴클레오티드 배열
nucleus : n, 핵, 심, 핵심, 중축, 토대, 기점, 세포핵, 원자핵, 혜성의 핵
nuclide : n, 핵종
nuddy : n, 나체 벌거숭이로
nude : a, 발가벗은, 나체의, 걸친 것이 없는, 장식(가구)이 없는, 초목이 없는, 있는 그대로의, 적나라한, 무상의, 무효의, 살색의 양말, 잎이 없는, 비늘(날개 털)등이 없는
nude : n, vt, 나체(상태), 숨김없이, 발거벗기다, nudely()ad, 
nude mouse : x, 누드마우스(돌연변이에 의해 털이 없는 실험용 쥐)
nudge : vt, vi, n, (주의를 끌기 위해 팔꿈치)슬쩍 찌르다, 주의를 환기시키다, (물건을)조금씩(슬쩍)움직이다, (팔꿈치로)슬쩍 찌르다, (밀다), 팔꿈치로 슬쩍찌르기
nudge : n, v, NUDZH
nudie : n, a, (싸구려)누드영화, 누드를 다룬(내세우는)
nudism : n, 나체주의
nudist : a, n, 나체주의자, 누디스트, 나체주의(자의)누디스트의
nudity : n, 벌거숭이, 나체(상태)꾸밈없음, 가림없는 물건, 나체화(상)
nudnick, -nik : n, (미속)따분한 귀찮은 사람
nudzh : n, vt, vi, 귀찮은 사람, 항상 신경질나게 하다, 항상 투덜투덜 불평하다
nuff : n, ENOUGH
nugatory : a, 하찮은, 쓸모없는(trifling), 무효의
nuggar : n, (Nile강 상류에서 사용하는)폭이 넓은 짐 배
nugget : n, (천연귀금속의)덩어리(lump), 귀중한 것, 돈
nuggety : a, 덩어리진, 땅딸막한
nuisance : n, 남에게 폐를 끼치는 행위(것), 성가신 (해로운)물건, 불쾌한 물건, 딱한 사정, 불쾌한(성가신, 귀찮은)사람, 방해
nuisance tax : x, 소액 소비세(소비자가 부담하는)
nuisance value : x, 골탕먹이는 가치(효과), (소규모 폭격등의)방해 효과
nuke : n, 핵무기, 원자력 잠수함, 원자력 발전소
nuke : vt,  핵무기로 공격하다
nukein : n, (속)원자(수소)탄 반대운동(의 집회), 원자력 발전반대(의 집회)
nukenik : n, (속)경멸 원자(수소)탄 반대족, 원자력발전 반대 운동(항의 집회)
nukespeak : n, 핵용어, 핵문제의 용어, 핵의 완곡어
null : a, n, vt, 무효의, 무익한, 가치없는, 특성(개성)없는, 무표정의, 존재하지 않는, 하나도 없는, 영, 제로, 영도, 영으로하다
nulla bona : n, 부존재 보고
nullah : n, (인도)(자주 물이 마르는 수로 협곡
nullification : n, 무효, 파기, 취소
nullify : vt, 법적으로 무효로 하다, 파기하다(destroy), 취소하다(cancel), 무로하다
nulliparous : a, 아이를 낳지 않은
nullity : n, 무효, 무효, 무효의 행위(문서), 무가치, 무, 쓸데없는 사람(것)
null set : x, 공집합(원소를 하나도 포함치 않는 집합)
Num. : x, Numbers 
numb : a, vt, (얼어서)곱은, 언(손가락등), (슬픔, 피로등으로)마비된, 감각을 잃은, 무딘, 둔한, 감각을 잃게하다, 저리게(얼게)하다, (사람, 마음을) 마비시키다, 망연자실케하다, (약 등이 고통을)완화시키다
numb : vt, Numbers 민수기
numbbrained : a, 어리석은, 바보스러운
number : n, 수, 수효, 총수, 수량, 인원수, 번호(표), 다수, 약간, 동료, 패, 산수, 음율, 운율(문법)수, 시구, 운문, 음표의 무리, 악보, 직업활동일
number : vt, vi, 번호를 매기다, 페이지수를 적어넣다, 세다 계산하다, 세어넣다, ..의 수를 제한하다, 살고있다, , 총계..이되다, 들다, 포함되다
number cruncher : x, 복잡한 계산을 행하는 대형 컴퓨터
numbered account : x, 번호 계산을 대신 번호로 등록되는 은행 당좌 구좌)
numberer : n, 번호 매기는 사람, 세는 사람
numbering machine : x, 번호찍는 기계
numbering system : x, 숫자를 사용하여 클레이를 나타내는 방식(각 선수의 위치, 선수간의 지역에 번호를 붙임)
numberless : a, 셀수 없이 많은, 무수한(innumerable), 번호없는
number line : x, 수직선
number nine : (No.9)(pill)(영군속)제 9호 환약(만능약)
number one : (No.1)제 1호(번)제 1인자, 중심인물, 자기, 자기의 이해, 오줌, 소변, 제1의 일류의 최고의
number one boy : x, (미구)권력자, 사장, 믿을수 있는 보좌역, YES MEN
number plate : x, (자동차의) 번호판, (가옥의) 번지표
number pool(game, racker) : x, (소액의 손을 거는 불법의) 숫자 복권
Numbers : n, pl, 민수기
Number Ten[No. 10)(Downing street)영국 수상관저(런던Downing가 10번지에 있는)
number two : x, 제 2인자 보좌역, 똥, 대변
number work : x, 산수
numbfish : n, 시끈가오리(electric ray)
numb grenade : x, 감각 마비 수류탄(큰 음향과 섬광으로 6초간 감각을 마비시킴)
numb hand : x, 서투른 사람
numbing : a, 마비시키는 , 멍하게 하는, numbingly()ad, 
numbly : ad, 곱아서, numbness()n, 
numbskull : n, NUMSKULL
numdah : n, 일종의 펠트 천(안장 방석등에 쓰는)
numen : n, 수호신, 신령, 근원력, 창조력
numerable : a, 셀 수 있는, 계산할수 있는
numeracy : x, 수리적 지식(사고 능력)(cf.NUMERATE)
numeraire : n, 통화교환 비율기준
numeral : n, 숫자, 수사, 학교의 졸업연도의 숫자(우수 운동선수등에게 주어짐)
numeral : a, 수의, 수를 나타내는
numerary : a, 수의, 수에 관한
numerate : vt, a, 세다, 계산하다, 식을 읽다, 수리적 지식이 있는 사고를 하는
numeration : n, 세는 법, 계산(법), (인구등의)계산통계 , 숫자읽기, 명수법
numerator : n, (분수의) 분자, 계산하는 사람, 계산기
numeric : n, 수, 분수(진분수 또는 가분수)(cf.FRACTION)서로 약분할수 없는 것
numerical : a, 수의(에 관한)숫자로 나타낸, 수적인, numerically()ad, 
numerical control : (전산)수치제어(디지탈 계산기에 의한 공작 기계의 제어)
numericallycontrolled : a, (전산)수치제어된
numerical taxonomy : x, (생)수량 분류학
numerology : n, 수비학, 수점
numerouno : n, (미 캐나다구)최고의 것, 자기
numerous : a, 다수의, 수많은, 셀수 없이 많은, 곡조가 아름다운
numerously : ad, 다수로 수없이 많은, numerousness()n, 
Numidia : n, 누미디아(아프리카 북부에 있던 옛 왕국)
Numidian : a, n, 누미디아(사람)의, 누미디아 사람, 고대 누미디아 말
numina : n, numen의 복수
numinous : a, 신령(numen)의 신비적인, 신성한, 엄숙한
numis. : x, numismatic(al), numismatics
numismatic : a, 화폐의, 고전학의, numismatical()a, numismatically()ad, 
numismatics : n, 화폐(고전)학(지폐 메달류 포함)
numismatist : n, 고전학자
numismatology : n, 고전(화폐)학, 화폐(메달류의)연구수집
nummary : a, 화폐의
nummular : a, 주화 모양의, 원형의 동전 모양의 습진
nummulary : a, NUMMARY
nummulite : n, (고생)화폐석
numnah : n, 안장깔개
numskull : n, 바보, 돌대가리
nun : n, 수녀(cf.MONK)집비둘기의 일종, 독나방의 일종
nun's veiling(cloth) : x, 얇은 평직의 모직견직 옷감
nunatak : n, (지질)빙화로 완전히 둘러싸인 암봉, 언덕
nun buoy : x, 마름모꼴 부표
Nunc Dimittis : n, 시므온의 노래(누가복음2:29-32), 고별(departure), 별세
nunchaku : n, 쌍절곤(동양 무술용 무기)
nunciature : n, NUNCIO의 직(임기)
nuncio : n, 로마교황 사절
nuncle : x, UNCLE
nuncupate : vt, (유언등을)구술하다
nuncupation : n, 구두 유언
nuncupative : a, (유언등이)구두의(로하는)
nunnery : n, 수녀원(cf.MONASTERY)수녀사회
nuoc man : n, 누옥 맴(베트남의 생선젓 국물, 조미료의 하나)
nuplex : n, 원자력 콤비나트
nuptial : a, 결혼(식)의
nuptial : n, 결혼(식)의, 혼인의, 결혼식, 혼례
nuptial flight : x, 혼인 비행(개미등의 암수컷이 교미하며 날기)
nurd : N, (미.캐나다 속)NERD
Nuremberg : n, 뉘른베르크(독일 남부의 도시)
Nuremberg trials : x, 뉘른베르크 재판(나치스 전범에 대한(1945-46))
nurse : n, 유모, 보모, 애보는 사람, 간호사(인)길러(조성해)주는 사람(것), 양성소, 보호목, (어린나무 등을 보호하기 위한)새끼 벌레를 보호하는 곤충(일벌, 일개미등)영양세포, 공을 모아놓기, 상어의 일종
nurse : 젖 먹이다, (식물등을 )기르다, 배양하다, (문예등을)육성하다, 보호장려하다, (재능을 키우다)신장하다, 간호하다, 병구완하다, 고치려애쓰다, 다스리다(어린아이를 )보아주다, 돌보다, (희망등을)품다, (재산등을)소중히 관리하다, (자원, 정력등을)절약하다, 소중히 하다, (술등을)짤금짤금 마시다, 비위를 맞추다, 애무하다, 안다, 모으다
nurse : vi, (유모가)젖을 먹이다, (젖먹이다)젖을 먹다, (젖을) 빨다, 간호사로서 근무하다, 간호하다
nurse's aide : x, 보조간호사, 간호조수
nurse child : x, 기른아이, 수양 아이
nursehound : n, 돔발상어
nurseling : n, NURSLING
nursemaid : n, 애보는 여자
nurser : n, 유모, 길러주는 사람, 양성하는 사람
nursery : n, 육아실, 아이방, 묘상, 종묘장(양어, 양식)장, 양성소, (범죄등의)온상, 보육학교(어린아이들의 교육시설)모아치기
nursery cannon : x, 모인공의 캐넌
nursery garden : x, 묘상, 종묘원
nursery governess : x, 보모겸 가정교사
nurserymaid : n, NURSEMAID
nurseryman : n, 종묘원 주인, 묘목상
nursery rhyme : x, 동요, 자장가
nursery room : x, 아이방
nursery school : x, 보육원(5세 이하의 유아를 교육)
nursery slopes : x, (스키)초보자용 활강코스)
nursery stakes : x, 2세된 말의 경주
nursery tale : x, 동화
nurse ship : x, 영모함
nurse tree : x, 보호수(어린 나무를 보호하는)
nursey, nursie : n, 아줌마
nursing : a, (맡은 아이를)양육하는, (수양아이로서)양육받는, 간호하는
nursing : n, 병구완(직업으로서의)간호, 간호사의일, 육아, 보육, 젖먹이기
nursing bottle : x, 포유병
nursing father : x, 수양아버지
nursing home : x, (사립의) 요양소, 소규모의 사립병원
nursing mother : x, 양모 아이를 모유로 기르는 어머니
nursing school : x, 간호학교, 간호사 양성소
nursling : n, 특히 유모가 기르는 유아, 젖먹이, 소중히 길러진 사람(것), 귀염둥이, 어린나무(풀)
nurturance : n, 애정어린 돌봄과 배려 양육
nurture : vt, (아이를)기르다, 양육하다, 양성하다, 가르쳐 길들이다, 영양물을 공급하다, 
nurture : n, 양육, 양성, 교육, (자양)음식물
nut : n, vi, 견과, 나무열매(껍질이 단단한 호두, 개암, 밤등)너트, 어미나사 , (바이올린등의)현침, 어려운 문제, 어려운 사업, 다루기 힘드는 사람, 머리 괴짜 바보, 미치광이, 열렬한 애호가, 석탄의 작은 덩이, 멋쟁이 , 총경비, 즐거움을 주는 것, 나무열매을 줍다, 성교하다
nut : vt, ..에게 박치기하다, nutlike()a, 
nutant : a, 꽃등이 고개를 숙이는 성질의
nutation : n, 머리를 숙임, 내려다봄, 장동(자축의미동)(줄기의)회전성
nutbrown : a, 개암밤색(의)
nutbutter : n, 나무열매로 만든 대용버터
nutcake : n, DOUGHNUT
nutcase : n, 미치광이, 괴짜
nut college : x, 정신병원
nutcracker : n, 호두까는 연장, 턱과 코가 맞붙다시피한 얼굴, 잣까마귀
nutfactory : x, NUT HOUSE
nutgall : n, 오배자(물감으로 씀)
nuthatch : n, 동고비
nuthouse : x, 정신병원
nutlet : n, 작은 견과(마디풀 소엽등의 열매)(매실 복숭아등의)씨
nutmeat : x, 견과의 핵
nutmeg : n, 육두구, (열대산 상록수)육두구의 씨(향신료 약용)
nutmeg apple : x, 육두구의 열매)
Nutmeg state : x, 미국 Connecticut주의 속칭
nut oil : x, 견과유(개암, 땅콩 기름등)
nut pick : n, 호두 알맹이를 파내는 송곳 모양의 식탁용품
nut pine : x, (열매를 먹는 각종)소나무, 잣나무
nutria : n, (남미산)수서, 그 모피
nutrient : a, n, NUTRITIOUS, 영양물
nutriment : n, 자양물, 영양물, 음식물
nutrimental : a, NUTRITIOUS
nutrition : n, 영양물, 섭취, 영양(작용)영양물, 음식물, 영양학, nutritional()a, nutritionally()ad, 
nutritionist : n, 영양학자
nutritious : a, 자양분이있는, 영양이 되는(많은), nutritiously()ad, nutritiousness()n, 
nutritive : a, n, 영양에 관한, 영양물, nutritively()ad, 
nutriture : n, 영양 양호상태
nuts : a, int, 미친 바보의, 열중하여, 제기랄, 시시해
nuts and bolts : x, (기계의)작동부(분), 운전, 경영, (사물의)기본 요점
nutsandbolts : 실제적인, 기본적인, 세밀한(검사등):a, 
nutshell : n, vt, 견과의 껍질, 아주 작은 그릇(집), 작은(적은, 짧은)것, 요약하다, 간결하게 하다, 요약하여 말하다
nutter : n, 나무 열매를 줍는(따는)사람, NUT BUTTER
nutting : n, 나무열매(견과) 줍기
nuttree : n, 견과가 열리는 나무, (특히)개암나무(hazel)
nutty : a, 나무 열매가 많은, 나무 열매 향기가 나는, 견과 맛이 있는, 미친(crazy)홀딱 반하여, 열중하여, 멋진, 화려한, nuttily()ad, nuttiness()n, 
nutwood : n, 견과 나무(호두나무등)그 목재
nux vomica : x, 마전자, (유독, 약용)마전(인도산 상록 교목)
Nuyorican : a, n, NEORICAN
nuzzle : vi, n, vt, (짐승이)코로 구멍을 파다, 코를 비벼(문질러)대다, 코로 냄새맡다, 기분좋게 자다, 붙어 자다, 코로 파다, 코로 문지르다(스치다)(머리 얼굴등을)디밀다, 밀어대다, ..에게 붙어자다, 포옹
NV : x, Nevada, nonvoting
NW, N.W. : x, North Wales, Northwest(ern)
NWA : x, National Wrestling Alliance, Northwest Airlines
NWBN : x, NORTHWEST by north
NWBW : x, northwest by north
nxm : x, nonexistent memory(미속)실념
NY : x, New York
NYA : x, National Youth Administration
Nyasaland : n, 니아실랜드(아프리카 남동부의 옛 영국 보로령, Malawi로 독립)
nyct- : x, 
nyctalopia : n, 야맹증, 주맹증
nycti- : x, (연결형)밤의 뜻(모음 앞에서는nyct)
nyctitropic : a, 야간에 방향을 바꾸는 성질이 있는
nycto- : x, 
nyctophobia : n, (어둠 야간 공포증)
Nydrazid : n, 나이드라짓(결핵, 치료약, 상표명)
nyet : ad, n, 거부, 거부권, 반대
nylghau : n, NILGAI
nylon : n, a, 나일론, 나일론 제품, 나일론 양말, 낭일론(제)의
nymph : n, (그, 로신)님프(산, 강, 연못.숲등에 사는 예쁜 소녀 모습의 정령, 요정, 아름다운 소녀, , 애벌레(nympha)(낚시 애벌레 같은 제물낚시
nympha : n, 어린벌레, 애벌레(번데기의 다음 발육 단계, 소음순, nymphal()a, 
nymphean : a, 님프의(같은)
nymphet : n, 성적 매력있는 소녀
nymphlike : a, 님프같은
nympho : n, NYMPHOMANIAC
nympholepsy : n, 황홀, 광희, 광기, 광란
nympholept : n, 광희하는 사람
nymphomania : n, (여자)색정증
nymphomaniac : n.a, (여자)색정증 환자, 색정증의 여자
Nynorsk : n, 뉘노르스크(노르웨이의 두 공용어 중의 하나)
nystagmus : n, 안진증, nystagmic()a, 
Nyx : 그신 닉스, 밤벗이 없이
